#-#-#-#-#-#-#-#-#-#-
--------------------
#-#-#-#-#-#-#-#-#-#-
--------------------
#-#-#-#-#-#-#-#-#-#-
--------------------
#-#-#-#-#-#-#-#-#-#-
--------------------
#-#-#-#-#-#-#-#-#-#-
--------------------
#-#-#-#-#-#-#-#-#-#-
--------------------
#-#-#-#-#-#-#-#-#-#-
--------------------
#-#-#-#-#-#-#-#-#-#-
-------------S------
#-#-#-#-#-#-#-#-#-#-
-----------------E--
#-#-#-#-#-#-#-#-#-#-
--------------------
