------------S-------
-#-#-#-#-#-#-#-#-#-#
--------------------
-#-#-#-#-#-#-#-#-#-#
--------------------
-#-#-#-#-#-#-#-#-#-#
--------------------
-#-#-#-#-#-#-#-#-#-#
--------------------
-#-#-#-#-#-#-#-#-#-#
------E-------------
-#-#-#-#-#-#-#-#-#-#
--------------------
-#-#-#-#-#-#-#-#-#-#
--------------------
-#-#-#-#-#-#-#-#-#-#
--------------------
-#-#-#-#-#-#-#-#-#-#
--------------------
-#-#-#-#-#-#-#-#-#-#
