-##--#----#---#--##-
###--#-#-------#-#-#
--#--##--#---#-##-##
#-#--#---------#----
-------#----#-#-#-#-
--------------------
###-#--#-----#-#---#
-#------------#-#---
--#----#--#####-----
-------#-#####-#---#
##-#---------##-----
---------#----------
----#----##-#----#E#
-###--#-----####----
---#-##-#-##-###---#
-#-#-#-----#-##--S-#
-##-----#-#-#-#-##--
##--#----------#-#-#
-#---#-#--#-##---#--
----------##----#---
