-###-#---------#----
-#-#---------#-#---#
---#-#--#--------#--
------#----#---###-#
-#-#-##--#--#----##-
-#----#-##-###----#-
--##-#--#--#-#------
#------#---#--#-#---
--#-#--##---#-------
-#---#-###---##-----
--#--#-##---#------#
--#---S#-------#--#-
--#---#-#-#-#-#-#---
-#-#-##-#-#---#--##-
--#-#-#----##---#-#-
-##-#--##--#----#--#
--#----#-#-E#--###--
--------#----#-#-#-#
------#-#----#-#----
-----#---#--------##
