-----##-####-----#--
--#-#-#-------###---
-------#-#--#-----##
---#--------#--#----
------#-------#-----
-----####-------##--
##---#---#-----###--
-#-----#--###-------
---#--#-#-#-###-----
##--##-##-------#-##
-#---#-#--#####--##-
E---##-----S--#-----
-#--------##-#-###-#
--#-#-#-#--##-##---#
--##---#--#-###-----
-#----#---#-##-#---#
--#----##---------##
--#---------#-#-#-#-
---------##--#------
#----------##--#--##
