-#------##--E-####--
---#-----#---##-####
--#---------#-----#-
------###-#--####--#
--#-#------####-##--
-#--#--#--#-#--#---#
#-#----#-#---#------
----#--#---#-#------
##---------#--------
#-#-----##-#------##
--#---------#--##---
##-#--------------#-
-#--##-#S--------##-
-#-#-##--------##-#-
----##--###-#-#-#---
-####--------##--#--
###-----###-----###-
--##----#------##---
#--#-###--#--------#
-#---------#--------
