-------#-#-#------##
#--##---##----##--#-
--#---##-#--#----##-
--#------#---#-#--#-
-#---#-------#----#-
-#-#--#--#----####-#
--#-----E--#--------
##---##-#---#-------
#----#-----#----#---
##--##-------###----
##-#------#----#--##
--#--#-----S------#-
#--------------###--
--------#-#---####-#
-#-#####-#-##--#-#--
#---#-##--#--#---##-
-#--------#----#-#-#
--#-#-----##----###-
-#----#-----###----#
#---#--#-------#-#--
