-#-#-##-#--###-#-##-
-#-#-#-####-#-#----#
------#-----#------#
------#---####----#-
#--#---#-##---#-----
-####-##-###--#--#-#
-#-##---###---------
#----#-----##---#--#
#----#--##----#-----
#----------#-#--#---
------#---###-#-----
#---#--#-#------#---
--#---------#----#-#
#-##E----------#--##
---#--#-----------#-
-###----#-----#-##--
#-#---#------###----
#--#--#--#-#-#-----#
--S---#----##-------
#-------##---#---#--
