-#---#--#-------#-##
#------##-##--#-##--
#-#-----#---#----#--
----#-------------#-
--#-###--#--#--#--##
#------#--------##--
--#-#---#--#----##--
S----#-----#-#----##
----#--#-###-###----
--#---#-##---#-#----
-----#-#--##---#-#--
-#-----#-----#-#--#-
##-#-##-#-----#--#--
----##------#-------
-#---##-##----###-##
----###-#---##--##--
#------#-#---E#--##-
###-------#-----#---
#-------#-#-#-#---#-
-#-------#-#----#---
