###-##--#--#-----#--
##-#-----#-------#--
#--##-------#-#-#---
#----#---#----#-----
---#--##-##-#-#----#
-------#----#-S#----
----##----------###-
--------#-#----#--##
---#####------##-#--
#--##-#--#-##---#---
---#-#--#-----------
##------#--#-#--##--
#--#---#---#--###-#-
-----------#---#---#
-##--##--#------#-#-
E----#-##-------##--
###--#-#----#-##----
---##------######-#-
-#--------#--#-#-#--
##---#-------#-#----
