--#-#---#-#-#---#---
###-#E#----#--##----
-###-#---#--##--#-##
-#-##--#--------#---
#--#-##---##-----#-#
#---------#--#-##---
#---------#------#-#
-#-------#-#--#-----
---#----#----#-##---
----##-#-----##-----
##--#------#--##--##
--##--S#-###--##---#
-#--#------------#-#
##----#------#--#---
---##--#--#---##--#-
-----#--#-#-#------#
#----#--###---#-#--#
---------#--#-------
---#---##-#------#--
------#-##--##---#-#
