#----#-##-------#-#-
-##--#-----#------#-
##------#--##--#--#-
-##-------#-##----#-
-----###----#-#-#---
#--#-#--#---------#-
#--##-----#----##--#
------#--##-------#-
-#---#---#----##-##-
-----#---##----#--#-
----#-----##-------#
-##---#-#S----#-##--
##--------##-----##-
------##--#-#-#----#
#---#-----#-----##--
-###--#-#----#----#-
#-#-#-#------#####--
------E-#-#-##---#--
#--#-#----#--#--#--#
--#----#--#----#-##-
