---#-------####--#-#
--#--####--#-#-#----
---#-#-##--#--------
--#-##-----S--------
-##-------#-#--#-#--
#-----#-##-#--#-----
-#-##----------##--#
------#---#---#--###
##--#----##----#----
#---------#-##-----#
#--------#----#---#-
----#-#----E-#-##-##
--#-#--#--#----#--##
#----#--#-##--#--#--
#-##----#----##-----
--#-#-#----#-#-----#
-#---#-----#-#---#--
-#---##-#-----#-##--
--#----####-#-###-#-
-#----#------------#
