---#----#------#----
----##------##--###-
--#-#-#----#------#-
#-------#---#-##---#
----#----------#-#-#
#--#-#--#-----#--#-#
---#-#---###---#----
#-#---------#-#-#-##
--#--#-----##--#--#-
------##----#---#---
---#--#-#-------#---
--##-###--##----#---
#-S#--#----##--#-##-
--#-##---##---###--E
##-###-#-#-------##-
---##------------#-#
#-#----#------#--##-
--#-#--##-------#-#-
--#------#-###--##-#
------#-----#--##---
