----#---##---#---##-
---#-#------###-----
---#---------##---##
----##---#-##-##----
-#--#---#-#--#---###
----#-#----##-------
--###--##---#-##-###
---#--#---S--#----#-
#---------#--------#
-#------###----#--#-
--##----####---##-##
---##-#---#---------
##-#----#-----###-#-
##-#-####--#-E---#-#
---###-#----------#-
#--------#-------#-#
-##-------------#--#
#------#--##---#-##-
---#-#---###--##----
----------#----#----
