---#-#-##--------#--
-###---#-#---##--#--
#---##---##-#-----##
--------##---#-#-#--
--#------###----#-#-
##---#-##----#--##-#
--#--#--------#---#-
--#--------#--------
#------##-##-##-----
-#------##----#-#---
------#-------#-----
#---#------##-----#-
#--#---#--#-S------#
--##-#-----#-------#
--#---##---##-#-#---
-#-##--##-#---#---#-
##--#--###------#--#
-----#--#--##-##---#
#--##-#E-###--------
-#-##--#-#--#---#---
