---#---##------#----
----##---#----------
#---#----##--#-#-#--
#-###-#-------##-#--
-#--##--##---#----#-
#------------##--##-
----##-----#-------#
-#---#---##--#-#-##-
------#----------#-#
-###----#-#-#--##---
#----##-------------
#-#----#---#------#E
#----#-#--#--------#
-##-----##--#-#---##
--#----####--##-#--S
-#----#-------#---#-
---##--##-----#-#---
---###------------#-
-#-##-----#-##--##--
#--######----#-####-
