#--#--#---##-##-----
----#-#-#--##-#-#---
#--##---------#--#--
E-#---#-#----###----
-----#--------#-#---
---##----#-#-------#
-#-------#####-#--#-
-###--#--#-#--------
###-------#------#--
----#----#--##-##-##
---#-#-#---#--------
#-#-#------#--#--#-#
#----#---##----#--##
--------##---#-#----
---#--#-------#-----
-----#--#---#--##-##
-#-S---#--###-##----
---#-#--#-###----##-
-#---#---##--------#
--###-#-#-----##--#-
