##-#---------##-#---
--------#-#--####---
-#-#----#-#E#-#S---#
#-----------#---#---
--#-----#---#-----##
--#------#-#-#-#-#--
##----##--##--------
#----#---##--##-#--#
--#--------##----#--
-#---------#----#---
#--#-#------#-#-#---
-#-#-#-#--#--#--#---
--#-#--#------------
#--------#----#-#--#
#---------##-#---###
----#-##-#--#--#-##-
#-####-#-##-----#-##
#-----##-##---#-##-#
-#------#---#-------
--#---#-#-#---#---##
