--------#-#-----#---
#--#--##-#-###-#-#--
##-##--S--#-#-#-##--
-#--------#--#------
-#---#--------#-----
#-#####-#---#--##--#
-------#---#----#---
#-##--###---##---#--
#-#---##--#---#-----
-###--------------##
-----#-#--#E#-------
-#------###-----##--
--#--#-----#--#-#---
---####-#---##-##-#-
#----#--#--##--#----
-#---#--#-#-----#--#
--#---#--#-#---#--#-
--###------##-------
#-#-#---------------
--##--####---------#
