--##-##---##-------#
----#-#---#-#-------
---##-##-#-#----S---
-----#-#-----#--#---
-#-#--##----#-##----
----##---#--##----##
#--#-------#----###-
--#-----#---#---#---
--#--#-##-#-#-##--#-
#-###--#-#--##-#----
---##----#-#---#----
------#--#---#---##-
#-#---##------#-#--#
---#--#-------###---
--##---#--#-##-#--#-
#-----##--------#-E-
--#-#-#-----#----##-
#-----##------#-----
--#---#-#---#--##--#
#---#-##---#---#----
