---#-#-#-----#--#-#-
-#-#---#-----##-#--#
-----------#---#----
---#-----#----#---#-
------###-##----#---
---##-----#---#-----
----#-#--#-###--#---
###-#-##---#-#--#--#
--#--------#-#-----#
#-#-##--##----###---
-#--------#-#---##--
#------E-----#-#---#
------#####-##------
---##---#----##---##
--##-----###-#-#---#
#-#--#---##----#--#-
-#----------#-#-##--
-#-#-##---#--#---##-
-----#-#--S###----#-
--##--#---------#---
