-#-#--#--#-##-#----#
#------#-#--#-#----#
#-##---#--#------#-#
-#----------#-----##
##---#------#-#----#
--#-------###---#-#-
#-#--#------#--##--#
-------#----#-#-#-##
-----##---#-##-#---#
------#--#---#--##--
#-#----S-#--#-##-#--
---#---###----#---##
#-------------#-#---
---#-#---#-#-#-#---#
-----------#-----#--
-##----#--#-#---#---
#--#---#--#-#---###-
#-#---####-----E----
#-#---#-#--#-#-----#
----#-#-------###---
