-----#---#####-##--#
#S#-##-#--#------#--
--#------#-#-#--#-#-
#--#---#--------##--
-#--#####-##--------
-##-----#------#--#-
##--#----------##--#
#--#--#-###-##------
-#--#-#----#--------
-#--#--#####----#---
---###--#---#------#
---#-#---#-----##-#-
-#-#---#--###-#-----
#---#----#--------#-
--#-#-##--E#---#--#-
-##----###--#--#-#-#
---#-----------##---
#-#-#--------#-----#
-----#--#---------#-
#--#--#----#--------
