-##-##-#-------#-#-#
-#--##-#-#---##-----
--##-------#--#---#S
#-#----#-##------#--
-----#-##-#---#-----
-----##---#------#-#
--#------E---#---##-
----#-----#-###--#-#
-##---#-#--#-----##-
#---##------###--#-#
#--#--##--#---##----
-#--##---##--------#
--#--------#---#----
---#---------#---##-
##-#-#-#---------###
-----#---#----------
#-##-#----##----#-##
#--------#------#---
#----##----###-##---
##-##-#--#----#--#--
