--#---------#-E-----
-##-#--##-#----#----
--#-#-------#---#---
--####---#---#-#----
--#----#-###-#--#---
-----------#---#----
#---#--##---#-####--
-##-#-##-##-#--S-#-#
---##--##----------#
#-#-#-------#--#--#-
#--#---#----#-------
------#--#--###---#-
-#-###--#-----##---#
#---##-#--###----#--
------#-#-#####--#--
-#---#-##-----------
##-###-----##----#-#
--#--#--#--#------#-
------#--#-#-##-----
----#-#-#----------#
