---##-----#---##--#-
---#-####-#---#--###
#-#-##----------#---
---------##---S-##--
--##----#-###--#----
--#--#--#-###--#-###
##---------E-#---#--
----#-#-#-##-###-#--
-#--##----#----#--#-
-----#-#-###--------
--#--##---#---##--#-
#--#-----#-----#---#
---#-##-###-----#-##
-------#----#-------
#--------------#----
##----#---#-----#--#
-#---##------#-#----
-#-#----#------#-#-#
#--#####--#-------#-
#--------###--------
