---#-#---#--------#-
-#---#---#---#-#----
##--#-#--####-----#-
----------#---##----
S#----##--#-----#-#-
-#---#--#-----#----#
-##-----#-##---##-#-
---#-##--#---#-####-
-----#----------#---
-###---#-#-#---##--#
-------#-#--#----#-#
#---#---E--#---#-#--
#--#-###-##-#--#----
-#-#-#------#--#----
#--#-------#-#---###
--#---###-----#--#-#
--##-##---#---------
--#-------##--####--
-##---------------#-
###-#--#---#-#------
