-##--##----#-----#--
####-----#-#-##-----
--#--#-##-####-#----
#--#-##-----##-##--#
--#-#-#---#--##-----
---##-#------##-#-#-
--#----#-##-#-#----#
---#---#-------#--#-
--#----S#----#----#-
-##E---##--##---#---
#----#---##---#-----
---##--##-----------
------#------##--#--
----------------#---
-#-#----#-------#-#-
---#--#-#-#-#-##--#-
-##--#-#-----#--#-#-
----#----#------##--
-------#--###-#-#--#
##-#---##----#-##---
