---#-##-#-----------
----####-#----#---S-
#--#---####---##-##-
--#--##----#####----
-#----##-#----#-##--
------##---##----#-#
#-#--#-----#--------
##--#--------#----#-
---#-#--#---#-------
---#------#---------
-#--##---------#-###
---###--##-#-------#
---#---#-#-----#----
#--#-----##---#-###-
----###-#------#####
---E-------#-----#-#
---##----#-#-###---#
#--##-#--#-#--##--#-
##-#----#--#----#---
--------#--#-------#
