-#----#-###-----#-##
##-#--#####-#-----#-
-#-#-###---#---####-
--#-#----#-------#-#
--#------#####-#----
--#----#-#----#-----
-#-#----------------
---#---#-#----------
-#-###----##-#----#-
--#-----#-#---#--#--
------#-#E---#-#----
-##-##------#-#--#--
----S----#####----##
-#-###----##----#---
---##----#--#-------
##---###--#-#--#--#-
-##---------------#-
-####--##--#-------#
#----#-------#-#----
----------###--##---
