---#--#----###-#--#-
--#-------###------#
-#-------#---#-----E
-##---#-#-#----##-#-
--#--###-#---##--#--
-------##--#---#-#--
##-#--------#-----##
#-####-##-##-----#-#
-##-#---#----#-#-##-
-----#-#-----##--##-
#---------------#-#-
-----#-#--#--------#
-#-#--#-------#-#-#-
-#----#-------#-#-##
--#---##-#-----S--#-
--------###------##-
-#--#---#--#-------#
---####---#--#-###--
-----#--#---#-------
-#---#------##-#-##-
