#---#---#--#---#----
##---##----#--#-----
-#--##--#----###----
#-----#---#--###E---
##-----#-#------#---
---###------#--#-##-
-#-#---------#------
-#-S------##--#-#---
--#-#---#---###-####
--#------#---##-----
###--##-----#------#
-#-#-##-##-##---#--#
-----##----##----##-
#--#-##----------##-
##---#-#--------##-#
#-------#-----#-#--#
--#----------------#
--#-----#------##-#-
-#-#--#----#----###-
--#-----#-#-##----##
