--###--------#----##
-#--#---------##-#-#
-#-#---#-#-##-#--#--
#-##-#-#-#--#-#-##--
#--#--#-##---#--##--
--#-#---------#---##
#----#--#--------##-
#-E---##---#--------
#--#--#-#-------#-##
#--#--####--------#-
---------#-#---#-#--
-#-#-#----#----#---#
#---#-#-##--#-------
----#----#-#-#------
--------------##--#-
--#--##--##--##----#
--------#-#--#-----#
##--##----#--#-----#
#--##---#--#--#-----
------#----S#-####--
