-##-#------#------##
#-----------#-#--#--
#---------#-#--#----
#--#####-###------#-
-----#-#----#-----##
----------#-#-##---#
#------#-#----------
--------E#--------#-
---#-#-#-#----#-----
#--#---#-#-----#--#-
------##-#----#---#-
#------#-#----#-###-
---#-S#-#------#-#-#
###-#-----#---##-#--
-#-#-#-#---##---###-
---#--#--#-------#--
------##-----####---
--#--#-#-##---#####-
##--#----#--##----##
--#----#--####---#--
