#-#-#-#-#-#-#-#-#-#-
--------------------
#-#-#-#-#-#-#-#-#-#-
----------E--S------
#-#-#-#-#-#-#-#-#-#-
--------------------
#-#-#-#-#-#-#-#-#-#-
--------------------
#-#-#-#-#-#-#-#-#-#-
--------------------
#-#-#-#-#-#-#-#-#-#-
--------------------
#-#-#-#-#-#-#-#-#-#-
--------------------
#-#-#-#-#-#-#-#-#-#-
--------------------
#-#-#-#-#-#-#-#-#-#-
--------------------
#-#-#-#-#-#-#-#-#-#-
--------------------
