-##----#---#-#--##-##-----#----#---#---##----------#------##-------#-------#-----#--#-----#-#-####--
##--####-#---#-------##----#-#--####-#------#----#----#-##--##--#----###--#---------#--#----##--#---
-#------------#----#----##-------##-#--------#-##--##-----#---##---#----#----##--#-##----------#--#-
#--#--#------#--#----------##---------#----------#-#---#----#-###---------#-#--###-#--#----#--#-----
-#-#-#------#--#------#-##-#-##---##--#-------#--##-------##----#----#------------#------#--------##
#-#-#----#-----#--#-----#-###-----#------------##-----#---#-------#-------##-#--###--##--#---##----#
-#--#-#------#---#-##-----#----------#--###----####--------E--------#-#-####---#-#-----##---------#-
---------#-#--#--##------#-###---##----##-----###-#--------##-##-#-###-###-#-#-#-#--------#----###--
----#--#--#-----#-----###--#-###----#---#---##----#------#-#-#--#---#--###---#--------------------#-
-#--##---##--#-#---#----#-#--------#-#---------#-##-#-#-###---#--#---#-----##----###--#-#-------##-#
#-#-------##-##----#-----#------###-##--#-##-----------#----#----##--#----#-##--#-------#-----------
----#---##-#-#--##---#---#------#-##--#----#-#--#----#--###--------#--##-------#---#------##--------
-------###-###-#-----##-------##-----#--#-#----#-----###-##----#---##--#----#####-#--------#-#--#---
-##---------#----#-#--------------#---#--##--#-##--#--#-----#-#-----------------#---#--#--#--####-#-
--------------#------#-#-####-##----#----------------#--#-------#-##-##---#--#-#---#-#----#-#---##--
----##-#-------#--#---#----#--#-#-----#-#-##-##----##----------##--##----#------------#-#####---###-
-#-#-##----##-##--###-#-#--##-#-#---##----#---#-----#-##-##-#----##------##---#---#---------#-#-----
#-#--#----###----###---##-#--#-#----#----#-#--#-#-#----##-----##--#-------####-----#--#-#-#-#---##-#
##-##-##------#-#----###--#--#---#---#---##-#----##-#-##--#---#--##-##-------#-#---#---------#--##--
--#-#--##-#-##-###----##------##---###-####--#---###--#--#-##-#-#------#---------##-------#---#---#-
-##--#----#---------#------##----------#-------#-#-#-##---#-##-#----#-##-----#--#----#---#-#-------#
---#----------#--#--#-#-#-#--##--####-----##--##--#--#-----------#---#-----#-##---------##-#--------
--#---#----##-#------###--##----##-##--##---------#-#--#-----#####-----#-##---#------#-##-##----#-##
--###--#--#-#-#--#-#--##-#--##------#----------#--#--#--##--#--------#--##-#-##---#-#-----#-#---##--
--#----#-------##--#-#--#---###---##--#-#-#--#--#-----#---#---###----#-#-##--#-------###----#--##-##
------##------#----##-##---#--#----##--#--##-#-#-------##-####-#-------##----#-#-#-#-##----##--#--##
----####-###-#---#--#-#---#--#-#-#----#------#-----#-------#--------#--#------#------------##--##-#-
----#---#-#--##-#--#------#-#--#---#---#---##-----#----#------####-##--##--#--#----#-#-----#------##
-#-----#----##-------#------#-----#---##---------#-##---#----#-#---#------#-----#---#-#-#----#-###-#
#--#------------##---------#--#-#--#---##-----------#-#-##---#--##-#--#-#----#--##---------#-------#
-------#-#--------##------#-------#---#---#----#-##---##-----#-#--#---#------##--#####---#-#--#---##
-#---#-##--##---------------#--#-####--#-#----------------#-----##--#-----##---------#--##----##-#--
-#---#---##--#--#-#-----##----#---#---#-----------#-##-#----#------#----#-#-#-----##-----####-##-#--
-#----#-#--#---#-----#---##-#--#-#----#-------#-#--#---##--#----#--#---##-----#--#---#-#------#-----
--#--##---##------#-##-------##---------#--##-##--#----#--##--###----#----#----##----###-#-#-#-#--#-
#--#----#---#--##--#------#---#--###-----#----#---###----#-#--#-#-###-----#--#--#----#--#-###---#-#-
#---------------#-----#---#------#-###---------#-#-#--###-#----------#-------#---#-##----------#----
-#-##-#--#---#-------#--#---#-----##---##----------#---#------##--#--#--##-##-##-----##---#-------##
#--###-----##--#-----###-----##--#--------#-------#------##--#--------#-------###-#----###-##---#-#-
---##----------#-#-##-----##--##-#----###-#----------##-#--#--#--##---------#--###----#---#--#-#--##
#----#---###-##-#----------#--#---#-#-----#------##-------#-#-----#--------#-----##--#----##-#-#----
---###-----------------#-#-#--#--##--#----####-###-------#-#-------#-#--#--#----#------#------#----#
#------#------#---##--#--#-#-#--------#------###-----#--#---#----##------#---##-##--##-##---#-#--#-#
----###-------#---#---##-------#-##-----#-#-#---#--------------#---#-##-#-#----------#-#-#-##----#--
--##---#--------#-----##--------#----#---#---#---#------#------#-#-###-##----------#-#--##--#--#-#-#
----#--#---#-------#-##------###--#--##-###-------------##--##--#-------#-##--#---#-#---###-#-------
#-#-#---#----#--##-#-----------##----###-----#-###-#---#--#-#---#---------#--#-#-----#-------#-#-#--
#-------#----#--#-----#-#-#------#------#---##--##-----#---------------##-#-----##-#--###------#----
#-####------------#--###---##-#-----###-----#-#----##----###--#--##--#-------------##----#-------#-#
----#-------------##--#---------------#--##--#----#-#-#-#----#-#------#---#---------###---#--##-----
---##---#----#--#--##--##--#--#-#-##--#---#--#---------#---#--#-----#--#----------#-##-#----##-#----
##------#--##--##---#--#-#--#--#-#####---#--#-##-------#---#----#---#--#-----------#------##-----#--
---##--#---##--##---##-#-#--#---###---##--#----#-#--#-----#-#-#-##----#--##--#-#-----#-----#-#------
--#-----#-----------###-------##-###-##-#--#---##--#-##-#-#-#-##-##-#--##----#--##-----##---------#-
##-###-----#-----#-#-##--#--#-#--#---##---##----#--------#-##-----#----##--#----#--##-#--#--#-#-##--
-#-#---#------#--##-##-#----#-#--#---#-##-----###-------#--#-------#-----#------#----------#--#--#--
-------#-#---#--#-----#---##--#-#-----##-###--------------##-#------####--##--#--##----#---#--#----#
#-------#---#-#---###-##--#-#-#-#--#-#-#--###------#--##-#-##-#--#--#-#------#-#-------#--#-#-------
-#-----##----##-#-#----#---##---##--#-------#-##--#------#-----#--#--#---#---#---#-#-##----------#--
-#---##---------###-###-#----------#S-#---#------------#--#--###-#---#-----#---##----#--#-#-------#-
#-----#-----###---#---#----##---#----##---------#----#-#####-----#----#-#--##----------#-#-#--#--#--
#---#-----#--#----#----------#-##-#--------##-----##------##--###-#------#----#--##----#--#-----#---
-----------#-#-#-----#-#--#-#-##--#----#--------------#-#-#--#-------#--##--#--##--#--#-#-##-#-#--##
-#--##------##-#--#-----------#--###------#---#--##-----#----##-#--#---#-#--#-#-#--####-#-----------
--#--#----#-#--##----####----#----#----#-----#--##---##------------#-----#---##-------------#---#---
#--##--#-#-#----#----#-------#-#-#-#----##-##-#---####-#---#-----#---#-#----#-----#-----###--##-----
-#--#-#-#----#----#---#-----#----##---###---#----#----#----#-----##-#--###-#-------#----##-------#-#
#-#-#-##---###--#-------#---#######---------#----#####------#-###---#-#-----##-----#----####-------#
#----##----------#--#--------#-###--#-#-----#-#--###----#-#--#-#-#-#----####----##-------#--#----#-#
--##-----#---#----------#---####---#-#-#--#-##------#-####-----#-----##--#------------#----#--------
-#-#--#-#-#--##-#------#--------#-#-#--#-#--#--------#--##----#---###-----#--#-----#-#--#--#---##---
--#-#-------#-----#-#---##--#---##-#---------#-##---------#--------#-##--##-#----#-#------###-#-----
#--###-#------##--#-#-------#-#-----#--#---#---#--#-#--##--#----####-####---#-##---###--#-----------
----#-----###--------#--#--#-----#-##---#------###-##------#-##-#-#---###--#--------#-----##-----#--
#--------##-###-##-------#-#-#-##--##-----##-#-----##-----#-#---###-----#----#------##-#-#--##--#---
#---#----#--#-##----#-#-#-###------#-####----#--------#--##--#-------#-----##---#-------#-#-------#-
--##----#----#-###-####-#----##--##-#---#--##--##-#--#-#-------#----##-------#####-------#-#--#---#-
-----#-#--#-####-----#------#-------------#--#-#-#--#---#-----------###---###--#-##------#--#----##-
------#-#---------#----------#-###-####-------#---#---#---#-----#-##-###----##--#--#---#--#-##-#----
----#--#---#--#-#--------#-#--#-----#--------#--##---#----------##---#-----#----#----##---#----##---
#-###--#-#------#--##--------#---#-#-------#--###-#-#-#--#-#------#-##-----##--#-#----##-###--#----#
#-----#---#-#---#------#-#-#-#----#-#----#-#-----#---#--#-#--------------#---#-#---##--#--#-#-##-###
----#--#-#-#--#------###--#---#-#--#--##-#--#--##-#-#----#--##-##--------##-#-#-#-------#---#-##-#--
#-----##--#-----#--##---#--#-------##--#--#-#-#-----------#--##-#-#---#-#-##--------#--##------#----
--##--#--#----#-#-###-----#-----#-####-#------##---#--##----#----#-#----------#---##-------#-#---#-#
-#--#-##------#-##-----#--##-#---#-------#-#-#-##---------------#------##--#---##-----#--##---------
---##--#---#---#-#--#-####--###----##----###-----#-------#-----#--#-##----#----##-----------#-------
--#----###--##----#---#-#-#--##-------#####-#--#----###-#---###--------#-#-#---#-##-##---#----#-#-#-
-------#-----#--------#---##-------#-------#----#-------###------##--#--------#-##---###--###------#
#-#-#-----#--#####----#---#--------#---#---##-##---##-#-#-----##----#-###---#---#-------------#--##-
#---#-------#-####--#-#--#----#----#-----#--#####--#-#----#-#-#-###------##-#---#-#-#-##-##----#-##-
#--#-----##------##------#-#-----#--#-----#--#--#------#----------#----##------#----#-###--#----#---
---##-#---#---#-#---###----##----###----#-#-#-##---#-#-------###-----#-#-#--#-#-----##-#-#---##-----
---#-###---#---##-------##--#--##-##-#-----##------##-#-#-------#---#-##----#-#----#------#---#--###
--#-#----######-----------#---#-#-#-#--------#-----##-#----#-#--#-##-------#-----#-----#---#--######
#----##-----##-#--#-#--###-#---#---#------#-##-#-#-##----#------###---##-##-##----#-##--------###---
-#--#-#---#------#-#-#---##-#--##-------##------##--#---####-#------###--#-##----#--------##----##-#
-#-#--#-#----#--#-#-#------#----#-#------#-----#-##---##------######--#---------##----#---#-##-#--#-
----#-#---#--#---------------#-------#-#---#--##----###---#-#-###----##-#----#-----------------#--#-
##----#--#----##--#-----##----##----#---#--##--#------##-------#--#--##-----#----##---#-#-#-----###-
