--#-----#-#---#--#--#-----#----#--#--#-------#---------#-#---#--#----#---#-#----#----------#-#---#--
---#-----#----#-#----#--------##----##---#-#---#----#---#---##----##-------##--##--#-----###--##--#-
--------###-#-#----#-##--#--#---#-#-----#----------#-#---#---##------#-------#--#-----##----#-#-----
--------#----#-------#-#----#-----##--#------#----------#----#-##-#---#---#--#-#-#---#-----#--#-#---
#-#-#-----#-----####-#----#---#-----##-##--#-----##----##--#---#-#-##--#-#-#-###-##---#--#-#-###----
-#######------#-----#----#-#---#----##-----#------#----#-#--##-##-------##-##-##--#-#--------#-#---#
#--###--------##----#--#--#---#---#-###-##-----#-###-#-----#-##--#--------#-#-##-#-#-###-##---#-#-#-
------------#---##----##--#-#-#-#----#--#-------#--##---##----#-#-#-#--#------#---#--------#-----###
---#-------#-##-#-#------#-#-##---##--#-#-#--------#----###-#----###---#-#-#-#----#------#-#--------
--#-------#-###---------##-#-#-#---#-#----##----#--#------#-##---#----------#---#----#-#--###--##-##
--#-#--------#----#-##----##---#-##--##-------##---#--------#-----#-#---##-##--#--##-------#-------#
-----#----#-##-------#--#-------#--#-------#-----------###--#----#----#----###--------#---#-###-####
-#----#----#--#-#----#--#---#--#-#----#--##---##----------#----#--#-#-#--#--#--------#-##----#-##-#-
#-------#-#-#-##------#--###----#-#-----#-----##--#-----------#--##--#--#-##-#------#--#--#-------##
---#-------##-------#------#---#-##-#--#-###--#-#-##-------#--##----#--#-#-----------#------##--#--#
#---------#--#-###---#-#-##-##-----#-##-------#-#-----#------------#-#---#-##---####-#--#-#--#------
-##-#---------#----#-#--###-----##------#----##----#-#--##-#-----##-#-###----##--#---##-----#----##-
##-#--#-----#-#----#--#--#--#--##--##-##--------#---#-#----#---------###-#----#--###-#------#------#
##----#--##---###--####----###-----#-#--#-#----#--#--#------#----##-#----###--------#####---#----#--
##---##-##--#--#----#---#-##-#--#--###---##-#-----##---#-----#-----#---#---#-#---#------######---#--
---#---#----------#------##-#-#-##-#--##-##---##-----------------#--#-##-#---####---#---#---######--
--#-----#--------#-#-#-----#---#------##--##-#--#----#---------------###-####-#--------##--#--#---##
--###--------#-----#---##--#----##--#---#---#-#---##--##-####----###-------------#-##-------##------
--#------#-#-#--#--#---###----#--#-----#--------##----------------##-------#--#--#-#---##-----#---#-
--------##--##-#####--#-###---#--###-#-#####-#-#------#--#-----#-#----#--------#-#-------#--##-###--
###-#--#-------###--##-##---#-#-#-###---#-------#---#-##-#-##--#--#---##---##------#------##-#--#-#-
------##-#-##------#------------#----#-#-#---###-----#--#-----##----------#####------------#-#---#-#
#-##----#--#--#------###-#--#--##-#-#--##-----##-----#------###--#----#--#-#-#----#--------##-----#-
-----#---#-----##------##--#--###--------#--#----------#-#-----------#-#--###--##--------------##--#
--###---#-----##--###--------------#--#--#--------##--##-####----#-----##----#---#---##-------#--#-#
----------#--#-##---#-#---#--##-####-#----#---#-------##--##-##-##--##-#-#-#--#--#-#--##--------#--#
--##------#--#---#---#-#------###-##----#--#-------------##--------#--#-##----#---###----#-------#--
----------#--#---------##---#------#---#-#--#-----#-------####-----#--###--#---#-------###------#---
---------------#--#---#----#--#---#--#---#-##-###-------###---#--#--------#-#----#---##--###---#--#-
-##--#--#------#----#--------#-#-##-##-------------##---#------------#----##-##-##-----###--#-----##
----##-#-#-#-#----######---------#---##---#-#------#-------#---##----#--##--#----#-#------####------
###-#-#---#------#----#-------------#--#---##-----#####-#----#--#-####---#-#------#--#-##---#-###---
-##----#-----###------#--#-#-#----##---##--#--#-----------#---##---#-#--#-#------#-------##-------#-
-----#------##-----#----------#-----#-##-#---##-#--#--#---###-###--------#---#-----##---##-#-#--#-#-
--------#-#---#---##-#---#---#--------#------###-##-----#-#-##--#-#---#--#----#-#---#--##-#-#--###--
--####---###-----#-#-----#-#---------#--#---#-##---##------#---#-#----##-##-###--##---##-#-#---##--#
#---##-#-----#----##-------##--#---#-----#--####--#--##-#-#-#------#--##-#-------#--#-#-#-##-#------
#-#-#-#-#---------------#-----#-------#---##-##------#---###-##--------##-#--#---##-#-------##--#-#-
---####--#--##---#--#-#-#-#---##--##-#-#---#-###--#---##--#--#--#---#--##-#----------#---##-#---#---
--#----------#-#--#--#-#-##---####---#--#-----#--#----#-#-#---#-##-#--------#------------##-------#-
-#--#-##--#---#-----#---#--#-#-----##----#---#-#---#-#---##-#-#-------#--#-----#---##---#-#---------
---##--#--###-#-##-#-#----#------#---#---#-----###---#-#-#-#-#-##-##--------#--##--#-----#---#---#-#
-#-###----#---#--###-------##-------#----####---#----##----#----#--#-----#--#--#-#----##----#---##--
---#--###-#--#-#---------#----------###-------#---------#-#---------##-#-------#-###--#---#--#-#----
#-##--------#-#----#--#---#----#------##--------------#--###-#---##---#--------###---#----##-#--#--#
----#---#-####--#----#---#--------#--#-#-----##-#--#-#--#-#-#-##---#-#---#------#-##-#-#--------##--
#-----##---##----------###-#----#-----#---#-#----------------#--#-----#-###------####---#---------##
-#---#-#--#--#-#--------#-----#-#--#-----#---#-#-#-#----####--#----##-#-#------#---####-----------#-
----#-------#------------##---#----------------#----###--#-#--#-#--------#---####--###--##--#-------
----##-#--#----###------#-------------#-#-#--####-----#---##-#--#----#--#-#-#-###----#----#-#---#-##
-##------#--#-------##-##--#-----#---#-----#---------#-------#-----#-#----#-##---------#-#--------##
---###---#----##-#--#-###--#--------#--##---##--#---##-----##-----#-##-#-##----#-#####-##-##---#-#--
---#-------#----#---#-----#--#--#--#---###-##-###-----------##--#-#----#--#--#-##---##-##-#-#---##--
--##-#--##----#--#--#------------#---#--#-#------#-----#--#-----#----#-###---------#--#---###----##-
---------##-#--#------###----------##-##-----#-#---##---##--#----------#----#-#------#-----#-#-##---
##---#-----#-#--#-#----###---##--#----#--#-------##-#----#--#--##----#-----------##-##-----###-----#
-##------#-------##----#----------#-#-#--###--#---####-----------#--##---##-----#---##----#---#-#---
--#-##----#-#---#-##-----#--#----------#-------#-#--#----#----#-#--##-------#------------#----------
#----#----#---------##--##---##----------#---------####---#------#-#----------------#------#--#-#--#
#--#-#-----##-###--#-#-----#--#-------#-#----##-#--#-##---#-#-#-#------#---#-#---------#----#-----#-
####---###-####---##-------#--#-#-##--#---------#-----E##-#-#-----#-----#---#--#-#----#---#-###-----
-#-----------##--#---------#--##------####--#-#----#-#--###--#-#-#-#--##----##--------##--#----#---#
##--#----#---#--##-##-----#--#--#------###-#--#--#-#-#------#---###---#-#-#--------###-###--#--#---#
-----##---##-#--------#####--###-#--#-#---#--------#-#------------#---#------#--##------------------
-#----#--#------#------#-####----#-#-----##-##-#-----#--#----###-##------#---#-----#--##---##--#----
#---##-#-##--##---##---#----#--#-------##----#-------#-----##---##--#-##--------#---####-##----###--
----------##----#------#-#-#--###-##----##-##------##----##--------#--#---###--#---#----###----#---#
-#--#--#---##-------#---#--#---#--#-----#-#--#--#--#-----#--#-#-#------##----##----##--------##-#---
-###-#-##--#--#--###---#-##-#-------#-#------#--##--##----#--#------#----######--#---#-----#--------
-#--------#---#--#---##--#---#-#-------#-##---#----##-#--#-#------#--#------#---##--#-----#---------
----#--#-----------#-#--#--#-----##--#--#---#####--#---#-#-#---#-------###-#-##-----#------##--#-#-#
#------------#---##--#--##----##---#-#-----#--#-----#--#-###---####-#--#--#---------#----####-####--
##--#---#--#--#--#--#--#---------#-##------##---#---#-##-#-----#--#-------#--#-##-#--------#--#-----
---###------#---#-#-##-----###---###---##--#--##-##---#-#--------#---#--##----#---------##--##------
#-#-#-------#-------#-#-------#----#--####-#----#-#-----------------#--#----#--##---#----#----------
-##-#-#-#----#--####----#--###--####---#-#-----###----------##-#-------##-#---##--#-#--#-###---#---#
--#-##----#-##---------#---#-----------##-##---------#-----###-#---------##-#---#-#----#-----#----##
#-#--#-#-----#-#----#----##----###-#----#-##----#-------###--#-----###------#----###-#--#-----#-----
-------#--##--#--#---------##--#----#-------#-----#-----#-#--#-------#-#----#----###-#--#-##---#---#
---##-----#--#----#-#----#------####-----#----###-#-#-#-------#----###--#---------#----#--#-##-#--#-
----#-#---#------#--#----#--#--#-#--#---##-#-##-#-##----#---#-#-#---#--##-#####----#-#------#------#
-#----#-##----##------#-----#-#--------#--##--#---#-#-#----------####---##-----#--------#-----#---#-
--#----#--##-#----#---#---#----##--#---#-##--#-#-#---##---###-#--#---#-##------#-##---#--#------#---
--##-------#-##----##---##-#--#---#-#-----#------##----#--#---#----#----##---#-#--##---#------#-#---
#-------#---#--#--####--#---#----##----#--#----###-#--#----#---#---#---#---#-------##-----#--#--##--
----#-#----####--#--------#--###------#-##------##------##--#--#------#---#-#--#-#--------#----#-#--
---#------#-#----##-#----#---#-##-#-#-#--#---#----#-----#------#--#-#-----------####----#--##--#----
-#-#----#-##---#-----#---#---#-#----#-#-###--##--#---###--#--#------##-----#----##-#-#---#----#---#-
-##-#--#---##-#--------------##--#--#-----##---##----#--------#----##-#-#-#--#-------#-#-----#------
---#--------#-#-#----##--#------#---#--#-###-------#-#-----#-#S---#-#--##----#--#-#----#----#----#--
#--#-#-#--##-##-#-------####------#--##-----#-#-#---#-#----------#-------##---------##-##---###---#-
-#-#-#---#--##---------###---#----#----###--##-#-#------#------#-----#----#--#----#-----###-------#-
---#-#-----####---##----#--#--#-----#-#--###--###--#----#-#-##--##-##-----#---#--#-------#-#-#--#-##
---#--##-----##----#-#-#---#---#------#-#---#-#-#---#--##--#---###-#---#--------#-#-##----##--------
-#-#------#---------#----#-##--##------##------#-#--#-#-#------##-----###---#---#---#-#---#--####---
