-----#-----#-#------#--------#--#----#-#--#-#----------------##-------------#-#---#----------#-----#
--#-#-#----###-#-------##-#--------#---##----#----#--------------#---#------#-----#---#-#--#----#---
-#---##-#----#----------#--#-------##----##-#-##------#--#--####---#---#---#-----#-##-------#--#----
----#-#-#-----#-----###---##--#---#--##-#-#-####------#--###-##----------#--#--#-#--#------##--#--#-
-----------##---##-#---#-----##------#-#--#------#--------#-##----##-##-###--#---#-#--##------------
#--#---#-#---#---##----#--#--#--------###-#---#---------##-----##-------#--#-------------##------#--
-#--##----##----#--#--###----##---#-----------##---#-----#-#---#--#-###-#-----#--##--##--##---#----#
#-#----####--------#------#--------#-----#-#--#--###--#--#-#--------#-#-#####--#------#-----##--#---
-------##----#-#-#--#--#---#---#-##--#--#-#----#---#-##--#---#----####-#--#----##---#------------#--
---#-#---#--#####--##-#-----#-##-----#-#--#-#--#-------#--####-#---------#---#---##--#--#-------#--#
---##--------#-#--#-##--#--##-##---------#-#-#----#---##--------#----#-###---------##------------#--
----------###-#-------------#--##----#-#-##---#-###----#--#---#-#-----##------#--------#---##---##--
---------------#--#------------#--##-#-#---###-##-------------#--###--#-----#--------##------#-#-#--
------#----##--#--#--#------##--#--#---#--#-#---###----#--#-----#-#-#----#----#-###-#----##-----##-#
--#----#--##--#-#-##-#--#S-#-------#--#-#--#--------------#--##---##-#----------##------#-#---#----#
----#----#--#-###--###---#--#----#-------#-------#--##--###----------###-##--#-#---#--#-##-#-----##-
-#-###---------#-#-------#----#------#--#-#-#---#------------#-#-#----###----#-#---#----#-#-#------#
--#-####-##-###------#-#---#--------#-##--#--##--##-##-#----#--#---#-----##--#-----#-#-----###---##-
#----#--#---#-------#---#----------#-#--------#--#------#-#--#--#-##--#--#-------#-#--##----#-----#-
#-#--#--##-#-#-#---#--#-#---#-----#---##--#--##-##-#----#-#-----#------###-#-###--#-##-#---#--#-#---
----------#------------------#-#---#-#----#-###------#---------#--#--#--###----#--###-----#-#--#-#-#
----#----#-#-#-#-#----#-#--#--#--#---###--#---------##---#-##----#-------#----------#---#-##--###--#
#-#-------#----####-----------#---#---#-----------#---#-----#--#-#--##---#--#--#----#-#--#-#-#----##
-###---#---#------###---------#-#-----#---####--#-----#--#--##-----#-#-##---#-#-----#----------#----
###----#-##--#--##--#-#--#-------#-#----#-####----##---#-#-#-##----##----#--#-#--#--#----#-##--#----
-#---#----##---#----###--###--#-#-#-##-----##----#-#--#-##--#----##---#-#---------#-#-#-#-#--#--#-#-
--##-#----##-------#-------#--###------#--#-##-#-----#--#---#----#--------#--##------#---#-#---#-#--
-#-#---#--#----------#----#-----#---#--###-#--##------##---#---#-#--##---#-##-###-###-#--------###--
---------------------#-------------#---##--##---#-#-----#---#--------##--#-#-##-----#-#--------##---
------##-----#-#----#--##-#----------#----####-#------#-----#------#---#--#--------##-###---##---#--
----##------##--##--##-#------##-##--------#----#-#---#--------##-#----##-#-###-----#-----##---#---#
##---------------#-##-#-----#-###-###---#-#-##--##----#--------------#-----------#---##------#-#----
-##--##-#--#-#-##---##----#---#--#-----##---#-#--#--#-#-#----####-----#--------------------##---#---
--#-#--#-#-#-#--#-#-------#----#-#-#-#---#---##---##----#-----###---#--###-#---#------##-######-#---
----##------#-###-----#---------#-#--##-#----#-##-#---###--------#-------#-------#-##----###-------#
#-#--#-##-----#######-###-#-------#---#---#--#-#-#---##---------###-#--#-#-#---#-#-#-----#-#-#--#--#
-----#--#-#---#--------#-#---##--#------#----#-----#----#----##-----##-##-###--------##-#--##-E---#-
##-##----#-#---#----------#-##-#-----#----##---#-#---#----#-#--#---##-#---------#--#--------##-#--##
#--#------##----#-----------#-#-##----#-----#----#---#----#---##------##-----#-###-#-----#----#-##--
##-#--------#-#--##-#--##--#--#--#--#--##-#-##--#-----#--------#--##----#-#-#----####---------#--###
##---------------#--#-###--###---------#-----#--##-#-#----#--#---#---#-#--#-------------#--#-##----#
###-##-----###-----#-#-----##---##---#----#----##--------#-----#-------#-#--#-------#------#--------
----#-##---#-----------#--#--#--###--#------####----------#-##---#-----#-#----##-###--###--#---#---#
-----#---#---##-#--##-----#--#----##------------##--##-#-##----#---#-----#-----#---#-#------#---#---
#------#--#--#--#-------#--------#---##---#------------###--#------#--------#-#--------------#------
-#--#----#----#-----#-------###--#-##---------#---###----#--##-#--##---##-#--------#-##--#-#---#----
----#-#-###-###-----###--#-----###--#---#--##----##-###---#-#-##----#-#----------#-##-----##--##-#--
-----#----#---------#--##--#------#----##--#-###--#--------#-#------#---##-##-##-------#--##---##---
-----#-#####------#---#------#-#-----##-#-#-#--##-----#----#--##-##------------#--##--#----##----#--
-#--#------##--###-#---#----#--##-##----------------##--##--#---#-#---##--------###-#-----#---#---#-
-####----#----##--#--##------#---#-##--###--#-#--#-##-#-##--#--##-#-#-----#----#------#--#-##-------
-#----#-#-#-#---------##-#--##----------#---##----------#---#----#-#--#---------#---------#-#-------
--------#---###-##-----#--------#--#----#---#--#-------#--###----#--#####------#------#-------#---#-
#----#----####--#-#---#-----#-----------#---####-#----##--#------#---#--#---###----###----##--#---##
-------#----##--##-##-#-#----#-###---###--#----#-#--#-#----------#--#--##-----#--#----##------##----
#-#-#####-#----##---------#-#----#---#---#-----------------#-#---------------#-------#---#-#--#-----
----#---#-#-----------####---###-##------------------#----#--##------##---#--##------#-#--#---###---
-##-##--###-------###-----#-#-#-#----#-####-----##-##--------#--#--#-#--##------------#-------#-----
#--#----#####-##-##---------#-#--#--------#-#--##--##-##-#-#---#----#-#---#----------#-##-#---#####-
------##-------#-##--#--#-#--#--------------#-----###-#-----#--#---------##-#-#-----#--##---##-#--##
###----#--###---#-#---##-#---------##--#----#----#---#--##-##-----##-----#----#---#--#-#-#-#--#-----
--#-##-##--#-------#--------#--#---#----##-#------#--#---##--#####--#-#--####--##-------####-#--#---
-#--#-----##----#-###---#-----------#--#-#---#-#-#-#-##--#-------##--##-#--#---#---#--------##-#-#-#
-#--#-----------#--#------#----#--##-#-----##-----#--###--##--##-####--#-----#-----#--#-------------
#----##-----#-#-#-#-------#-----#--#-##-##------##-##--###------------#-#----------------#-##-#--#--
#-#-###--#---#---------#-###-##--##----#--#-###--##--------###-#----#--#---#------##------##-#--#---
--#--------------------#--#---##-#--##--#-#---#--#-#--#---#----#-----##-#---#-#-----------------#--#
#----##-#--------#--------##--##--##-#-#----#---#------##----------#-#-##-------------#--#------#---
#-##-#-----##---#---###----##-#---###----#-----------------#---#---##---###-#-#--#--#-#####----##--#
----#---##--##--##----#-###---#---#---##-###-------#--------------#-##---#-#-#-----###--#-##----#---
-##----#---#-###---##---###--#-----#-##--#-#-##-----##-----#-###---------#-----###---------#------##
---#---#---#---####-#--#-#--------#-------#-#-##-#--------#-##-#---#-#--------#-----#---#-----###-##
###---#---------##----###-#-##--#-##----#---#------####--#-#-#---#-#----#-#-------------##-#---#-##-
----####-----#--#--##--#---#-#-#--#------#----------#-#-##----##-------##------###-#---------#-#-##-
###-----#----##-#--#-##-#-##--#---#-------##-##-#-#-##-----#---#------------#--#-#--#-#---#-##-----#
---#-----#---#---##---#-#----#-##--------------##-#----#---------#--------##-#-##---##--#----#--##--
--#---#----#--#--#---#-------##-###--#---#------#----#---#-#--##-------#--##-##---------#-------##--
###-#---##-#--##------#--#-#--##----##--#-#-#--#--###-##-#---#-##-#-######---------#--#--#--##----#-
-#-###--#---###-#-------##----#--#----#-############----##-----#-#--#--####---###---##----#---###-#-
----##-----###--#----#-#-#-#-#---#-#-#----##-#-------#-#-#---------###-#---#------#-----#---#-#--#--
##-#-#-----------##-#--#--##--#-#---#-----##--###--#-##-##--#--#-----##---#--#-#------#--#----#-----
--###-----#-------#-##---#-##---#-#----##-##--------###---#-#-##------##-----------#--#---------#---
----#-#-#--#--------##-##---------#--#-#--#-#--##-#----#-###---#----#-###--#-#--#---------##--#-#---
#-#-###--##----#--##----##-#---#----------#-#-#-#------##-------#-##-###-#---#--#-#---##--##--#-----
##-##-##----#---#--#------#---#-#-----------#-##--##----##-----#---#-#-----###-----##--#--------#-#-
#-#---#-#-##-#----##--##----#---------#####---#-##------#---#--#----##--------#------#-#----#---#---
----#------#-----##--#--------#--#-#-#-#--##-#--#-##---#####-----#--#-#---#####--#---------#--#-#---
------------###-----#-----###-#-###-#--#--##--#-###----##------##--#-#----------#---#-##---#-#--##--
----###--##--#-#--#-----#--------#------#-#-##-#---#-#-#------------#--------#--------#---#-##--#--#
--#-----#----#----##--#--#--#-----------##---#--#--#-##-#-------#-------#--#--#-#--#-----##---###-#-
-#-##-##-#-###----#-----##----------#-#---###-#---##-#-####-------#--##-##-#-#--##-#-----#-----#----
#-#-----#---#--#-----#-#-#--#------##-----##----###---####---#-#---##---#----###---####---------#---
-#-#-------#--#-#--#--#----#-##---#--##---#-#-#--###--##-#--#---#--#-#------#-#-#---#-#-------#--#-#
-#---#--##-##--#--###---##-#--##--#---#-##----##--##-#--------#--#---------#-----#-----------------#
---#--------#---#-------#----###--#-##-##-#-#--#-##--###-#---#-------#------#-#-#-----#-#---#--#----
-#--#---#------#-#-------------#--#--#-##---###--#-#----#-#--#-----#-------#-#-#---#---------#----##
--#-#------#-#---##-#-#------#-----###---#-#--#------#--#--#---#----#---#--#-#-#-#-#-----#----#--##-
#--------------####----###---------#--#----------#-#--------------##--###-#---#--#-#-##-----#----##-
-------#---#-#-#-#-##----------#---------#--#----#------#-####---#--------###-#####---#-#--#-#--#--#
--#--###-##-#-#--#-----#-###--#----#---#-----------####---##----#---##-----#----------------###----#
