##-#--##---##----#---##----------#---#----#--##----#-##---##---#-###---#--#-#-------#--##---#--#-#--
###--##-#----##--#--------#--#-------#-------------##--#----#-##-#-----#-#---#-###---#----#-#-------
-#----#---#------##-#-#-##--#-------#-----#--#----#--##---##---##---#--#--#-###--#------##-#--#---#-
#--#---#---#---#-#-##---##-#--##-----#------#---#-#-#----##-#-#---###-----#------#-#----##--#------#
--------------###--#---#-----#----#-#-#-#------#-----#---#-#---##----------##-#----##----##-------#-
##-----##----#--#-###----###---#----##-#####------#-----##-##--#-#----#---#-----#--##-----##--#--##-
#-#----#---##-###--------#---------#---#--#--##----#-##----#-------#---##-#--##-----##----#---#---#-
--------#----#----#-#-#---#-#-#------#-----#--#--#-#-#-##-#------#--#------#-###---#-----#--#--####-
---###-#---##--#--#-------###--#--------#----------#----#-##-#---###---#--#------#----#--###----#-#-
-##----##-######----#-#-#----#--#-#-------#-##------------#-#-#-#-#####-------#-#-----##-#-#-###----
#-----##--#----##-#-----------#--#-----#-####------#-#--------#---#---#-#------------#--####--#-#---
------------#--#---#---------------#--##---#--#-##---#--##-#---##-#------##-#----####-------##-#----
--#-------##--#-----------#-------#-##-#--#----#-####-##--#-##-##----#---####----#-------##---##-##-
----#-##--#-#---#-##----#----#--#-#--#-#--#-###--##--#--#-------#-#-----#-----#--#--#---------##----
-#--#----#--#--##------##-#---#-##--####--#---#---#-#-----#-#-----#----#-------#--###-------#-##--#-
--#----#-#-----#--#--#--##-----#-----#----#---#----#---------------#-#-#--#-#--##---#-----##---#--##
--#-#----#-----------#---#-----##-#------##----#--#-----##---###--#---#---#---##-----#---##--##---#-
#---#---##---##---##-#-###--#-----#---#-#-###-#------##-###-----------##---#----#------###--#-#####-
-#-#-----#----------#-----##----##-#-##------#-#-----###---##-##-#--------###----#-###-----------###
-#-----#----#-#####-#--#-----#----#---#--#-----#-##-----#-----###---###-#-#-------##--##--####-#----
#---#-#--##-#---#---#-------#--#-###------------#------#-#-----#-#----#-------####-#--#--#---#--##-#
#----------#-#-----#-#-##-#----##------#--#-----------##--#--##-#--##--##------#-##----##-#--#------
---##---#-------#--#--#-##----#-----#-#----#---##---#----#-----#-######----#-#---------#------#----#
---###------##-----#--------##----#--#---#-#--------##--#--------------------#-------#--###--##---#-
----#--#--#-##-#--#---#--------#--##-##---#-#------#------##--#----#---#---###---#-#-#####---#--#---
------##--------#-----#------#----#-#---#--#-#---#--#-##---##----------#----#---#--------------##--#
-----#--------##-###--#---##-------#---#--#####--#-#------#----##-#----------#-#--#----##-#--#--#---
#--#-#-#---------#----#----#--#-#--##------#-##--#-----#---------#------#-#-#---------#-------#--##-
--#---##-#----##--#-#--------#----#--#-#-##------##-#--#-#-#-#---#---##----##-------##--#--------#-#
-#-##---------------#--#-#-##-#-------##-#-------#----#----###----#--#-----##-##--#----#--#-#---#---
--#-#------------##-#-----##--#-#-#-#---------#--##-#---#-----##------##---#-##------##-#--##----#--
---#-##--#------#-#-#--##--#-##--#--#--#-#--------#-#----#---##---##--#--##------##--##----------###
--##-----##-------------#-##-#-----#----------------##-#-#-#------#----#-#--------#--S##----#------#
#-#----#-#-#-##--#--#----#-##------##-#------##-##-#-#-------##--#------###-#-------#----#-#---#--##
#-#--####---#---#---------##-------#--#-##-------#-#---------##---#----###-#-#-#---#---##-##------##
---#-#--#---#-#--#----#--#--###-#-----#-#--#------#--#--#-----------##-----#-#-#-----#-----##-#---#-
-#---##------#---#--------##---#--#---#----#-#-#----#-#----------#--#---#---#####-#------#-#-----#--
---##------##-#-#-------#---#-------#----##--####-#--##--##--#--#---#-##------#-----###-#-----#-----
------##-#-----##---------##----------##-###----#----#-----#--#--##--#--##-##--#---#-------#####----
#--#-#------##---##-##-#-----------#--------#--#----#-#-##------#-##-##---#####-#---##-#-#-##----##-
##-#-##--#----##--#--#---#--##----#--#---#--#-#-----------##-#--##----#----#-#-#------#----------#--
---#-#--#---##----##-##------##------------------#-#-----#----------##---------#--#-#---#---##--#---
#------##--#-##-----#---##-#-#----#-----#-####-----------------#---#--###-----#--#-#-##--#-#----#---
#----------------##-##--#-##------#---------####-###--##----#---#-----##-----#---#-#-#-----#-----##-
--#----###------#--#-#----#---#---##--####---##----#----------##--#--##-#-----------#---#-#---------
#---#----#-#-------#-----###-------##---#---#--#------#-##----------#-#-#-#-##------#---###--#----##
##----#-##-#----------##------#-##------------#---#-#--#--------#----##----###-#--##-#-#-#-#--#----#
----#---#-#-----##--#--#-##----#---###-#----#--#--#------------#-#------#---#----##-#--#--#-----###-
---#--##--#--#--#----##------##-#----------#--#--#-####-----#-###--#--####-----##----#--------#---#-
--------###-#----------------------##-###------####--##-#--#--##--##-#--#-#-------###--#----#-#--#--
-#---------#--###----###---#####----#---#-##------#--#-##-#-#---#--------#--#-#------#--------####--
----#------#--##-##-#---#---#-##---#---------###-#----#--##-#--###-#--##--#---------#------------#--
--#-#-#-##---#-#-----------#--#-#--##----#-##---#--#------#---#---------#--#--#-----##---#--#-##----
-#--------##-------#---#-----#----#-####-----#-----#--#--##----##---##-##--##-#-####------#-#----##-
---#--#-----#--#--------##-######-----##---#---##-#-#--##-#----------#--##-#-#--#-##---##-#-----#-#-
--##-#--#-----#---#---------#-----#-#-----###-----#--#---------##---##--#---#------##--#-##-#-------
#-#---##---#---#-#-##--#---##---#--#--##--#-##---------####-----------##---#--#-----##-#----#-##----
-##-#--#--#-#-#--#----#-##---#--#---#--#-------#---#--#-#--#--#--------#-------##-#-------##---#-#-#
-#----#---##-----#---#------##---------------##-##----#---------##-#--#--#---##---#--##--#-##----#-#
----#------##---#-----##----#-##-#---#-#--####-#--#-#--#---#-#-#-###---#-##--##--#-#-#-----##---#--#
------#-#----#--------#---#--#---##-#-----#----##-#---##--#-#--##---#-#------#-----#-----#---------#
#--#-#--#---#-#----##--##-#---##------#--#---#-#--#--#----#--#-#--##-#-#-----#-#-#-#---#----####-#--
--------##---#--#-#--#-#-#----------##--#-#--##--------#--##-------#----#---##---#--#---------##--##
-------##-#----#--------##----##-----#----#-####--#-----#------##--#--#-##---#--------##---##-#---#-
-----##-#---#------##-#---##---------------##--------#---###-#---------#--##---#--#-#----#-#-##-----
##-----#----#-#----#---#-#----------#-#----------#--#------###------#####-#--#------###--#-----##--#
#---#--##---------##-#-------##-------#-----#--#---#----##--------------#----#--#----#-------#-#----
#-#--------###---#---#-#------#-#----#------#---#----#-#--#----###---##--#-----#--##----#--##-#-----
---#------#---##--#-#-#--#---------#-------#-#--#--###-#-###-#--##-##--##------#-#-#-------##--#---#
-#-##-----#-#-------#--#-#-#--##--------#----------#--#-#---#---####----#-#-----##----#----#-#---##-
-#-#-#-#---####------#----#-#------#-------#---###-#--#-#--#---#--------#-#--------#------#-##-##--#
#---##--------#--###-#----#-##---#---------###--------##---#------#####---#-------#---####--#-------
-#-#----#----#---#---##-------#---##----#-#-----#-#--#---#-----#-##----#-###---##-#-----#---###-----
#-------##-##-#--###--E--#-#--#-----##----------#---##----##-###-----#-----------#-#-##-#------#-#--
-----#------##---###------###-#----#---##---##------#-#----##-##-#------#-#--#--#-##---#-##--#-----#
----#-----#------##--##--#---#------##-#-####----##----#-------------#----###---##--#----#--#-#-#---
--------##-##--##--#----#--##--#-###-------#-#-#----##--#---#----#-#--##--#---###---##-#--#----#-##-
-#----#--#-------#--#-#-##-#-#---------##-----##---#-----###--##--------#---#---#-----------#--#----
---------------##--#-#--#-#-##--#-#----##-###-#------#----#-#--------------#---#---##----#---#-#---#
#---#-----##--------#----#--##--#----#---#--#----##-#-#------#---#-#---##-#---####-----#-#-#-#-###--
---##-----------##-#---#-##---#-#----##---#-#--###--#---#-----#----##---#-------#-##-#--#---#----#--
-#-#---#-#--#-------###--#--#-----#--#--#----#-##------#----#----####-###---#------##-##------##----
#-----#---------#-#---#--#--#----------------###----#----#-#---###-#-------------#--#-#----##-#-#--#
----------#-#####--#----###----##----#------#-----#---#-#-----------#-#---##-------#------#-#-#---#-
---#-----##-#--------#-#-#---------##-###----#--#---##--#----####-#---#----##-----------##--####----
--------###-#--####------------#-###--###--##---#-###-##---#---##-#-------#--#----##---------#---#--
--##-#----#--###--#--#-######-#--#-#--#-----##----##-#--------------##--#---#-#--#----#-#---#------#
-#--#--#---#--------#---#-#--#--#--#--#-----#--#-----------#-#-----#-#-------###-----####-#--------#
#----#-#-#-----#-#---#--#-#-----#--##--#------##-#------#----##--#---#---#--#-##--#--#-#--###-##-#--
------#----#-#------#-----#-#-----------#--#---###-#--###-####--------###---##-------#-##-----#----#
-#---##-----------##---###--#--------##--#----#-----#-#-------##----#--#----#--#-#-#----##---#-#--#-
#--#-#-----#--#-#--##-#----#-#----#-#-#--#------#-#-#--#-##----#-#-#-#--------#-##----##--#--#-#----
---#-------------#--#--#---#------#---#-----#-#-####-#--#--------#----####---#---#--##-------#------
---#----#-#------#---#-#---#----#--#------------#--#--#-#-----#-#-#--#---#--##-#-------#-----#----#-
#------#--##-#-#-##-#---#--###-------------##---##-##--#-#--#--------#-----#-#-##-###----#--#--###-#
-----#----#-------#-#---#-#--------#---#--#-#---#----#-##--###-#-#------#-#-------##--#-#----------#
-##---------##-##-------#---#-----#---##-###------##---#---#--#----#-#-----##-##-----#---#--#---#---
--#--#-#-#-###--####------#--#--#--#--##----##-##---#-#--#-###--#-#-----##-#--##-#---#-----#-###-#--
#---#-#-#-##---#-##----###-----###---#--#--#--#------#---#---------#------#----##-##-#-##--#---#----
-#--##-------#--#----#--##--##------#-##---##-#-##-#-#--#--##---#-#----##--#-#--##--#--------##-####
