#-----###---#---##-------#----#--##-------#-#--#----#-#-----#--#-##---#-------#---#---#---##---#--#-
-#-##-#--------#-#--#--###-####--#-#---#---#-#-#-##--#---------#---#--#----#----###---#----#-----#-#
-#-----#-#-####-#-------##---#----#-----#--##------###---#-#-##---------#--------#-###--##--#----#-#
-----#------#----#-##-#----#--##-------#---#------#-------##---#-#-------#------#------###---#---###
#####---##---#----#-##------#---#-##--#-##-#--#---#-------##------##-------#-------##---#----#-----#
#-----#-#--#-#-##----##-#----###-#-##----------#----#-#--#----##---#-#----##------###-#--#--##------
-#---------#-#-#---##--###-------#-----------#-##-#----#-##--#------#--##-------#--###-#-#-#-#-##---
#-#-------------#-----#-----#-----###----#--#------#--#--#---#--#----S--#----------#---#--#-#--##--#
---#----#--#-#---#----#---#-###--#---#-#---##---#---##--------##-----------#-----E-##-----#--#--#---
---#----##---#-#--##--#--#---###--#------#---##-#----#------#---#------#---------##----#--#-#-#---##
#-#--#-###----###---##------#---#--#-#----##-#---#----#--#----##-#-#---#---#---##----##------#-##---
-##-#---##-#-#-#-#-##-----#---#---##---####-##--#--#-###------#---#-#--------#---##--##-#----#-##---
-#---#----#--##----#--#---#---#--#--##-#-#----#---###--#-#-----##----#--------##-##-#-------##---#-#
#--#-#--#--#--#-------#-----#-----#-###---#-#---------------#-##-----##---------##-#--#-#--------###
--#-#--##--#-#----#--#--------------#-##--------#-##--------------#---------####-#--#--#-##---------
#--###-----#--------#--#-##--#-----#--##--#-#-#--#---#-------#--#--#--#-#-------###---#-#--#-------#
-###---#--##----#--##--------##-##-------#--#--##---#-#-#-#----#-#-#-#-#--#-----#--------##-#----##-
--#--###--#-#---##------#---###--##-------##-#---#--#---###----#----###---##-----#####--------##----
---##-##--##-#--------#----#------------#-#-#-###--###-#----##--#--###----------#--###---#-------#-#
#-------##--#--###-#-#----#########----##-###----#---#---#--###-#---------##---#--#--#--#---#####--#
-------#---------#----#-----#---#-#-----------#----#-----#-#----#---#--##---#-###---#---##---#--#-#-
--#--------#-------#--------#-------#---#--##-##----###-#----------#-####--#-----#-#----##----##----
#-#-----#-#-###-#--###-#------#---#-#-#---#-##--#-#--#-#-##-------#--#------#-#--#--###-----#-------
---##--#---------##-#--#----##--#---#---#--###--##--#----#---------------#-----#-------#---#-#------
------##--#---#-#-#-#----#--#---#-#--#-#-#-----#----#--##------#-#--------#-#--#-----#-----#--##----
----------#--------#--#-----#---#--###--#-----#-------#---#-#-#-#####----##-------------##-#---#-#--
-#-----##--#----------#---##-#----#---#---#---##--##-##------#-#--#--#--#--#-----#-#-------###-#--##
-----#-###--#-#-##-#-#-#------##----------#-##--##--#-##-#-------------#-#-##-##-#---------#---#---#
#-#----#-----##-#------#---#-##---#-##-#--##---------#--#-#-#-#-------#-----#--#--#---##----#----##-
-#-#-------#-------####-##------#--------#--##-------#---##-------------#------#--#--#---#-#--#----#
------#--#---##--#-----#-#--#------#-#-------##-##-------#-#------#--#----#------#------#-#----#---#
-##--#-#--##--#--#--------#---#--#---##----#--#-------#-------###--#--#--#-----#--##-#---#-#--------
----------#---#--##-##--###-#---#----#----------#-#------#-----#--------##-#----##-###---#------####
###---##----#---#-##----#---------#-#-----##-#--###-#-#-##---------#---------#-------#----##-##---##
--#--##---#------#-#-#-#--#----#-----#----#----#-#-------#---#--###-------------##----#--##---#-##--
-------#---#----#-#---##-------#-##-#----#--------#-#--#--#------##-#-##------------#----#---###-#--
--------#-----#--#-----#-#-#-#-#--###---#-#-##--###-#-----#----##---------#-#-#---------------###---
#-#--#-----#-##-----##-#-----#----##-----#--#--#-----##--#-----####-#-#----#----#-##------#--------#
-#####--#------#-----#-#-#----#---#---#-----#----#--#------#-----#--#-#--#---#-###--##-#-#---###-##-
----##---#-#------------##------#--#------##-------#-----#-#----###-#--#-#-----#-#--#---------#-----
-#-----#--------##-#--#-----#---###---####--#-#--####----##--------#-#--#---------#-----#-###--##-#-
-#-#-#--#-#---#---#-#-#------#---#-##-#----###---------------------##-#-#--##--##------#-----##-#---
#--#------##--#-##-###---------#--#-----#---#---##-------###------#-------#-#-##--#-----##-----###--
-##--------#----##-##-#---#-##-##--#-#--------------#---#-#------#-#-----#-----##-##--#-#-----------
--#--#--###-#--#--#-----#-##-#-##---##----#---##-#-#--------##-#-#--##----##-#-------#-#-##-#####---
-###------##-----##---####--#####---#-#-#-#-#-#-##------##---#---###-#-##------#-##--------#-----###
#-----#--##-##-#-#---#-----#-#---#----##--##--#-#------#-------#-------#-#-#-##--------#--#---#---#-
-#---------------##-----#------#-###--####---####-####---##---#-#--------#-#-#--------##--#--#--#-#-
--#------#-----#--#-------#------------#-----##-----#----#----#-##-#--#-###------#-#-----####-#-----
#-#-#--------#---##--#-##---------#----#--#--#-----###---#-#-##---##-----#----#-------#-------#--#--
--#--#--------#------##----------------#--#-------#--##-#----#------#--#-------##--#---#--#--#--#--#
---------#---#-#-----#-##----#-#---------#--#----##------#-#----##---#---#--#-#---#-#--#-#-#---##---
-#--------#--#--#--------#-#---#--#--##------#---#--###-----#------------##-##-#--------###-----#---
----#-#---##-----#---#---##-#---#-----#--#-#--#---------#-----#--#--------##-###--#---#----#--##----
--#-----#-----###--##----#-#-#-#-----##--#---#-----#--#---#-#-#----#---------#-#--#-------#----#---#
-----#----#--##-----#-#-#-#-##------#------##----#--#--####---#--#-#-#-#----###--#--#-----#-#--##-##
--#--------##--#--#---#---#------##----##---#--#------##-###---------#-###----##-#------#-###---###-
-##--#---###--##-#---#------#--#-#-##--#-##-##-##---##--#-##------#---##---#---#-###-#-####-#-#-###-
--#--#-#----#-#--#-----##-##-##-#--#--#---##----##-----#--#--#-#---##----#-#---#-#--##-##-#------#--
#--#---#-#-----------#--#----###-###---#----##----#--#-----#-#--#---#------##-###-###---#--#--------
-#--#-#--#----#-------#-#-#--##---#-###-#---###-----#---#-#--###------##-------#---------##-##--#--#
-#--#----#-#--#-##--#----#-----#-##-----------##-#-##--##---------##------#-#---#--#---#----------##
--#-##-----##-#--##------#-##-------#-#---#----##------#-#----#---#-----------#---#-##---##---#-----
####--##---#--###--#-----#--##--#-----#----#-#----#-##-##---##---------#-----#--------###---#-#--#--
-------##-#------#-------#----##--#---------------#-#--##--#--#-------------##-##---#--##-##--#-#--#
#---##------#--##---##---#----#--------#----##----#--#----#----------#---#-----#--#----#----###-----
-#---##--#--#-#--##--#-###-#----#-##--#----#---##---#----#-#-#-----#---####---#--##--#--#-#---------
-#---#------##-#-#-##---#---------#-#--##--##-#--#--#-#-####----#------###---##--#-----#--#------#--
-#---#------#----#-----##-#----#-#--------#--#----------#------##-#---#------##-#---#--------####-##
-###--------#----#-#---###---#---##--#------#---#---------#-#-----##-----#-----###--------------#--#
--#-##--#-##------#----##---#----###----#-------#----#---#-#--##---------###---#-------#---#-----#-#
-----#-----#-#-#-#-####----#------------------#------#------#-#-#------##-#----###-#--#--#--#-----##
--------#-#--#-#--##------#----#-#-#-#---#--##---#-----##--##-----#-#--##--#-#------#-#------#--##--
#-#-#-#-----#--#--##--###-##-----##-##-#-##-#---#-#---#-#---#-###-##-#-----##----##---------##----#-
#---#---------##--#--#---#####----#--#--##-##------###------#-#-------###--#----------###--#-----#--
-##--#-#------#-----#-##---#--##-----#---#--##---##-#--#------#-------#-######--#--#-#--------------
--#--------#-#-###-----#----####-#--#---#-##--#----##----##------#-------#--#--##-#-##--#-----------
#-----##-###-------#---#--#---#-----#----#--#------#--#-#-#--------------#-##-----#-#--------####---
-#--#----#---#----------#-----#-#------#-----##--#--##--#-#####---#-##-#-#--###--------##-------##--
---#------#-##--#---------#----#-----##-#-#-##---#-#--#--##-----------#-##--#---------##---#--------
----##----##--#-###-------##----#----##----#-#-###---#-#---#--#------#---#-#------#--#-#-##-###----#
#---#-#-#---###---------#-#--###--##-------##------##-#---#-----#---#---###----#--###---#-##----#---
-#---#-#-----#------#----##-##------#-#-------#----#-----##---#------#--#----#-##----#-#----##-----#
##-#----#-#------#--#---####-----#----#--#-#---#----#--#--#-----#-#-#----##-----------#-#--#---##--#
-----#--#-#---#---#------##-#---##-#----#-#-----------##----###----###-#---#--#-#---#--#-##-#-##-#--
#----------#-##----------------#-#---#-##-#-###-#-------###-#---#-#---####-#--#--#-----##--##-------
####-------#-#--#---##------#-#####-----#---#-##-#----#----##----##-##------#--#--#--#--##------#-##
--#------#---#-----#-###--##-------#----------#---#---#-###---------#-------##-#---##--#-#-#-#-#---#
----#-#-#--#--#----#-#-#-#---#----#---------##-#-----##--#-------#-------#-#-----#---##-#---##-#---#
---##--#-#-#-##------------##-#--###-##-#------#-###---#--------###---#--#----##-#-#--#-----#----##-
----#-#-----##-#--#---#-----#----#----##----#-#-----##--------##--#-#-#-----###-####-------------#-#
#--#-#--------#-----#-#--#--#-#------#-#--#-#------#----#-###---------#--#--#----#--#------#-#####-#
--##---#-------###---#-----------#---#--##---##-#---#-----------#-#--------#-----------##----#-----#
-#------#---#----#--#-#-####--#-##--##-----------##--##-##-------#----#--#--#--#-#--#-#--------#----
---###----#####--#--#-##------#-#--##----#-------##------#---#---#--##-#----#-----#-----#-##--------
#-#-----#--------##---#-#-#--##---##--##--#---###----##----###---#---##-#----#--##-----#---#---#-#-#
----#-----------#-#-###--------#-----##--#---#---#---#---#-##---#---#-#--##---#---#-#--#--###--##---
--------##-#####--#-#-#------#######-#--##-#---##---##--#----#--#---#-#----#-------#---#-------#--#-
#--##-##--##--#--#--#------#-#--#---#---#--###-#-------###----#----#-----#--#--------#--#----##--#-#
---#--------##---#-#---#--#---#-##--#----------#-###-----##-#--#----#-#--##--#####----#--##------#--
