----#-----##---#--#------#-##-#------##--##---#----##------#-#-#---#---#--#--#-##-#-#--#---#--#-#---
---#--#-----#-#--#-------#--#-##-###--------#-##-###-#-----#-----#-#---#######-#-----##-----#-#-#-#-
#---#-----------#-#--#---#---#------##---#---##-------#---#---#--##-##-#--#---#-#-##--#---#-#----#-#
-----#-------#--#---#-#--#--#----------#----------#####-###-#--#-#---#-----#---##-##-#----#--#----##
-----#----#----#-#---------##-----#----#-#--------------#------###---#--#--#-----------#----#---#---
##-----#-#-#----#---##--#-#--##---#-#-----------##-####---#-#--###-----#---#--#---------#-#----#-#--
------##---#--##-#---###-#--#--#----#-#---##-##------##-#--#-###------#-#--#---#-##---##-#----#---##
##--#-#---------#--#-#--#--#--#---#----##----#-#------#----#--##---#-------#---##-#--#-------#-###--
-##--#-----#-#--#---#------##-####------##---#-##-#---#--#-------######-##--------##-#----#-###--#-#
-##----#-------#--------##------#-----##------#-#--##--#-#-------#-#---#----##------#-----#----###--
-----##--------------#-#-#-#--#-##-#-#-#--#--#-----#-----#--##---#------#---------#-#---------#--#-#
------#---#-#--#-#-#--##-##-#---##--#---##--------#---------###--------#----##-##----#-#--#--##---#-
---##-#------------##-----##----#---#-#-##--------#----#---#------#-----#---------#--#--####----##--
--##-#-#------##-----#-#--##---#-#-#---###--##--------#---#--------####--###--#---#--##----##-#---#-
---#---###-#----####-#----#---##--##-#------#--#----#--#--#---#----##-##-------#-----#---#--------##
#-#------------#--##---#---#---#-##------##---#-------#---------#------#-#---#--##--#---#-#------#--
#-----#-##-----###--#----#-#--###--######----#-#----##----#---##--#----###-#---##---##--#--###--#-#-
----------##--#-##-##--#--##-#--#---##--##-##---#-----#--#-##-#-####--#--#--###-------------#--#-#--
-#--###-----#----#--##----#-#------#--#-#-#----##-#--#-##-#-#-#-----##-----#-#--------------#--###-#
##-------#--#-----#-#----#-##--#---------#-----------#--#------##-#--#---#----------##-#-------#-###
###-##---#---#---####---#-------#-##-----#-----------#-##--#---------##----##-##--#-##----##--####--
-#-##------#--------#--###-------#---#----##--####-----##------##-------------------#-#-##--#------#
#-----##----------#--#-----------#-#-#-----####----#-#----###-#---#------#-#-#-#-#-##-#-##-----#--#-
##--##-----#-#-#----#----#--##------#-#--#-##-#-#-##------#--#--------------#---#---#----#---#-#----
------#---#-#-#--##---------#-#--#--##-#-#---##---#---#-#-------------##----#--------#---#---#--#-#-
---#----#-#---##----#--#---###-##--#-----------#---#----#----#------##-------##--------#-#-----##---
#----##-#---#----------##--#--###-#--##-##------------###---##-------#-S---#-#---------#-##--#--#---
###-#--#---#-#--###-----#------------#-###-#-#-#-#--------#---#--#-----#----------#-###-----###--#--
-#-#--------#---##-#----#--#---#---------#------#---#-#-##--##---##---#-------#-#-#-------##---#---#
--#----#-#----####--#-##------#--------#---##-#-#-#-###--#--#-#---#-#-##---#--#-#--##--------##-----
--#-#--#-----#-#--#-#--------####--##---#--####------#---#----##-#----#------#--#----------#---##---
#-#----##-#----#-##-#-#----#--##---#-#------#---#---#---###------E#----------#------###--#-----#--#-
##---##--###---------#--###---#----###--##---##----#-#--#---#-#--#--#-#--#-----------#----#-##--###-
#---#--#-#-#-#-#----#--####-#-###----##--#-##-#-#-#-#--#-#-----##------###-#-#--#---#####--#--------
------#######--#-----###-#-#-----#-#-###--#-----##--#--#-#---#-----#----#----#--#-#----##--#-----#-#
#-#---#----#-##------#----#----#-##--#-#-------#----##-#---#--#-##-#--#---#--###---#---#--##-##-####
#--###-#-----#---##------#-------##--#-####------#-#--#-------##----------------##--#--####-##-#----
--#-##-------------#-#---#--#-#--#-#-#----#-##-#---#---##-#------#--#----------#----------#--###--##
#---#-#----#-#----###----##----##--#--#-------##----##---####-----#--------#--#-#-#------##--#-#----
--##---#--##--------#----#--------###--#----------------#---#-#---####--------##-#--#---#-#--#---##-
#-#----#-----------#---#-------#------#--##-----##--##----##----#-------#-#---##---#---##--#----###-
----#-###-#--#--#-#--------#---##-#-#---##--#----#-##---#-##--#--#--#-#---------##--##-#-------#---#
-#-----#--##---------#----#-#-----##-##-#------#--#-#--------###-----#-#-----##---##----#-#-##-#--##
#---####-#-#---#------##-#----#--#----###-#-#-#--##-#-#-------------------#--###-#--#---#-#-#-#-#---
-#-#----####------#-#-------------#-----#-#------##-#-#--------#-------#-----#-####-----##-##--#----
#--#-----#-#------#-#----#---##------###---#--#------#---#-###----##----#--#---#-#-----###-------#--
-----#---#-##-##----#----##----#--#----#--#---###-----###----#-##----#-----------##------------##--#
##-#-#--#---#--#----##---#-#--#-#----#--------##---###-#-#--##---##--#-----##--##-#-----#--##--#--##
----#---#--#-----##----#-#--#--#-##-##---#---------#---#--#-##---##---#-#-#-#--#-#####------#-#----#
-#-#-------#------#--#--#------------#--#-------##-##--#-------#---#---#-#------#--------##---#-#---
#---#-----#----------------#-----#-----##-#--#---#-#-----#-#----#-#------#--#------#--##--##-#-----#
#-#-#---#-#-#-----#-----###---#--#-#---#--#-----#-#-#---#-#--##------#-#-----#-#------##--#----#--#-
-#--######---#-#-#----#--#--##---#-#--#---#---#-----##---#--#-##---#-----#---##-----##------------#-
#--##-----------#-#---##----##--###-#------#-#-###-------------#--#--##----#-##--#-##--#---------#-#
#-----##----#------#--#-------#--#-#---#-##-----##-#-#--#--#---#--#-#--#--#----###--#-#------#------
---------##-#--##--##-#---#-------#-------#-----------#--###--#---##--#-#-----##-----#--#---#-#-##-#
--------#----##----#-#--#--#-#--#-##-#---##----#-#-#-###----#-##-------#-#--#------#---#-#---#------
---#----------------#---###--#-----#---#----#--#-##--#---#----#--#-#-##-----#-----#---#--#-#-----#-#
--#-###--###------#-------##-#-#-----##--#-#-##--#-##---#------------#-#---#--------#-##-#-#--#-----
---#---##-##---#---#-#-#--#---#-#----#####-#----------#####---#-#--#--#----------#--###-#-##--#-----
----#--#------#--#---------#-#----#---#-#---##---##--#-#----#-#--#-#------#-#------------#----#-#---
-#-------------##---#-##----##-------##--#-#---##--#--##--##----#----##----#-#------#----##----#---#
#--#----------#-----#-#-##---##--#----#-##-----#-#---#---###-----##-----#----------##---#-----##--#-
-##--------#---#--#-#----#-----###--#------#-----#--##--##----#-----#-#-----##-------##-#-----------
-#-#------#-##---#----------#---#-----##-#-#-#-##--##-#-------#--------##--#--#---#-#-------#-#---#-
----------#-----#-##------#--##-#-#-#####---#-#-##-###----##---#-#--#-----##--##---#--###----##-###-
---##----------#-#-----#---------#-------#--#-#-#---#----#-##--#----######--#---#--#-##-#---------##
-#------#---##--#--#-------##---####-----#---###-#--##--#--##-#-#-####--#--##-----#--##---#---------
-#----#----##--##-#--#------##---#---#-----#--#-#-#----#-#-##--#-#-#-##------------#-#--#--#--##--#-
--##-#-#-#-#----##---#---##-----##--------------##--#-#-#-------#--#-----#---##--#-#--###-----#-#-#-
#--------------##---###-------#-#--#-##-#---###-----#---------#-------#---#---#-#------------#--####
#-#---#-#-#-#-###------##-----##---#--#----------####-----#-##--###------###---#-####------------##-
-#---#--##--#-------####-#-#--#----#---#----##-#-------------#-----#---###-#--##-#---------#---#---#
------###-#--------#-#-#-#-#--#-#-#---####---#--###-----#--#-#-----##--------#--#-------#----#-#----
---#-#-#-##----##-##---#-#-#---#---####-##------#----#-----##--------#---------#----------##-------#
#--#-------###---#----------#-#--------------------###--#---------#-#------#-----#-#-#-----------#-#
##----#-#-#--#---#--######-#------#------###----#-#------#---##----#---#--##---#-#-#--#-----##-##---
--#-----#--##----#------#---#---------#-##----#-----####------###---#----#-#------#------##------#-#
-#-----##------#------#-#--#-------##-#--#-#-#--#----###-#---#----#-#-##--##--#-----#--#-##-#--#--#-
--------#-----#-----#---#----#--#-#----#---##---##------#####--#-#---##-##---#-#-----#-#---------#-#
--#--#-------#----##--#-#-#-----#-#-##-----###-#--#-#---------#--#----#--#-#---#-------#----#-----#-
---#---#-#---####-###--#-#-----#---------#-----#------#-------#-###--##-----###----------##-#---#-#-
-#-#-----#-#-##--##-##-#-##-#-------#----#------##--#-##--##--#--#--##----#----#----#-##-#---#-##-#-
--#---#-##----###-###------#--#--#---#---##-###------#----##-###----##---#--##-#--#--##------#-#--#-
#-----##-#---#-#-##-#----##---#-#-#------#-#--#--#--#--###----##-#--##----#-#---#-#--#----------#-##
--#----#---#-#-----#-----#--------#--#-#-------##-----------#-###-------#-#----##-#-----###--#-----#
------------###-####-#---#---#------#--#----------#--#----#--#-----------###--##----------##---##---
----#--#-#-----#----#--#-----#-----#--#-#--#-#---#-#-#---#-#---#-#----##-##-----#-##--------##------
------##-#---#--#----#-----##-###--#-#--#-##--#---#----#-##---#-----#---#------------#---#-#---#-##-
---#-------#-----#--##-#--##-----#----#---##--#-##-###-#-#---#----##-----------#--####-------###--##
#--#------#---#-----#--###--#-#---#-#------##----#--#--#-----------------#----------#--##-####------
--#-#-#-----#--####--#----------##---#--##-#-------------##-#-----##-#--------##-#-##-----#-#-------
----------#-#----------#---------#---------#----#-##----#-#-----------#---##---#--#---#--#-----#--#-
-------#-----#---#--###----##-----#----#-------#-#---------####------#----#-#-------#####--#--#--#--
-###------#--#-#--#-#-##-#-#---##---#----#-------###-###-#--#---###----#---#--#-##---#-##--#---##-#-
--#---#--##--#--#-#-###--------#--#----#-###-#---#--#---#-#-------#-------#------#---#----#---------
----------#-##--#------##----###--#-#-------###--#----#-#--#----##----------------#----------------#
#--#-##--#-------#-----#--#---###-----##-##---#--##---##----------#---#-----#-#------####------#---#
#-#--#--------#---##-##-------##-#------##---##--#-##---#-##----------#----##--#--##-------###-#-###
-----#-###----------#-#---#------##-------##--#-----#-##----#--#--#--------###----------#------#--##
