---#-#---#----------#----####--#####--##----#-----------#--##-#----##----#--##--#---##---#-#-#---###
#---#-#---#--###--##----#-#--#-##----##--##------##--##-##-#-#--#---##--#----#---##----#--#---#---#-
--------------#-----##-----##-----#----#-#--#-#--#----#-##----#------#-##---#--------#-------#------
-#-------#--##---#-#----#---#-----#-----#---#---#--------#----#----#--#---#------#--#----##--##----#
--------#--####---#-##----##-----------#-----##-#---------#-------##---------#----#---#---#-#--#---#
--#-###--##--------#----#--##-----#-------#--#-#---#--###-##---##----##--#--#-#-#---##------#----#--
#--#------#----#--#-##--#-#--##-###---#-###-------#####--#-------#-----##--###--##--#--#-##---#--#--
-#-#----###--#--##------#--------------#--#--------##-#--##-#-#----#--##---#-----##--#------#--##-#-
--#-#-#-----------##--#-#-------#---------#--#--####---#---#-#####-------------#-#--#-##-##--#------
-#---##---##-#-#--#-----#---###-#---#-#-#-------------#-#-------##--#---#------##--#-#-#--#-------#-
--###--------##-#-##-#----#--#--#---#--###---##--#----#------#-----------#-##--#-#---###---------#--
---------#-#--#---#-#-#-----#-------------####-----#---##--#-#---#---###-----#-#-----#-##----##--#--
--#-#----##---#--#---#--#----#-----#-#---#---#-#--#-###----#--#---#----#--#--##-##--#-##------------
###-##--#-###--------#--#-#---------##-##--##-##----#---#-#--------##---#-#--#-#--#-#----#-#--------
#-#--#--##--##---########--#---#-#-------------#----------#-#--------#-#-#-#----#---#-----#-#-###--#
----#------#-#--#---#----#---------#---##-#-#-------##--------##--------#---#---#------#--------#---
##-###-------##-#---#---#-###-#---#-#--#------#----##--#-#--#-----#-----#----#-##--#-------------#--
------#-##----##-#-----------#---#-#-------##---#--###-###-##--##----##----##-##-#---#--#---#--#----
----###--##-#--#-----#--#----#-#-------#-------##---#---##---###-----------------##--#------#--#--##
#--##-#-#----###-----#---#-----#--#---#-#--------###--------#-##----#---##-------#####----#-#--#-##-
-#--##---###-------------#---#-#---##-#----------#---#-#---------#--#--##-----#--##---#----#------#-
--#--#--#--------##--#----#-------###---#-##--#---#-#--##-#--#-#----##---#-#--#-----------#-##---#--
-##---##--#-##-#----#-#---#---#--#-#--#-##-#----#-#-##---#---#--##----##-##---#----#---#####------#-
-#--#---#--------------#-#----#-##--#-###-----#-------#--###--#--#----##---#-----#---##---#-------#-
-#--#-#-----#-#--#------#-#--##---#----#--#-##-#--#---###------##-#-#--#-##-----#-###---#-#-#----#--
-#--------#-------#--#---#-#-#---##--#----#---#-###--#---##---##----##-#--#-#--------##---#---------
---------------------#----------#--#----#-#-----#--##---#-#------#-----#-##-#--##--#------##-##-----
#------##-#-##----------#-------#-#-#-#-##----###------#-#-----#--###------#----##--#-#-#--##----##-
-----#-##---#-----##--#-#---#-#-##--#-#-#-#---#-##------------------##-----#--#--#----##--#---##-#--
----###--####-----###--#--#--#------##--###-#-----#--#--------------##-#----#---#-----###---#######-
##-#---##--##-----#-#-#-----##---#----##-------#--#-#####-----#-----#--#--##--#------#---#-##-#-#-#-
#-#----##--#---#-#---#--#-----#--#-#------##---##---------#----#--##---#----#--#---#----##--#--#-###
--#---####---##-#-#-#-#--##-#----#-#-----#----#--#--##-###--#---#-#-#--#---##------####-#-###---#-#-
#-#-#--#-------------#-##----#--#-#-##--#-#--##-###------###-#-##---###-----#--#---#----##------#-#-
##---#-#--##-#--------------#----#----#-#--#-#####-------#---#----##---------###--#---##-#--####--##
---#--------#-#---------##-#-#---###-------#----#---#---#-#-----##-#-#-#---------#---###-----------#
---#-#-----#-##-##-###--###-#####-##---##------#---#---##-----#---#--#------#-----#---#####-----##--
#--#-----------#-#-#-##-----------#-#---##-#-#----##---##-----#-##--##---#-#----#-#--##--#---#------
----###-#-#-#----#----##----#-----###----###---#--#-----#-##---#---#--#---#-----#-#-##-#--------#-#-
##--#--#---#---#---###--#------#---#-#-#-------#-----###-#--##---##-#-#----##-##-----#-----#------#-
-##------#---####---##--#-#------#-#---------##-------------#--#----#-#-------#--#-------#---#--#---
-----#--#---#-----#---#--#---#------------#--###----###-------------###-#----------###-----#--#-#--#
----------#-----##------------#-#--#---#----#----#--#--#------#--#-------#----#-##-------#-------##-
#---#-###-##--#----#-----#-#-###--#--####---#--####-#------------###--#----#-#---#----#--#----------
--#--------##---#-#----#-#-----#--#--#---##-##-#-###-#-----#------#-------##-#----#--##--------#--##
--#-##--#-#-#---#-------#-#-------#---#----#--#--#-#-#-#-#-###-#-#----#-###--#--------#--#--#------#
##-###----###--#-#----##-#-##------###--#-#--#-##-------#---#--------#--###--#--#-#---------#-#-#-#-
-#----###-#-#-####-----##-----#----------#--#--#----#--#--#---#-####-------#-#-##--#---#-#--------#-
--#--#------#--#----#-##---#-------##-------#-#---------#---#--#------------#-#-##-#--#---#-#----#-#
--------#--##---#-------##-##-#--#--#-#---#---##-----##-#--#--#----###-#####----------#-#----#-----#
--------#-------#----#---##-#---#--#--#---------#--#-----#---#----#--#-##--##-------------#-##--##--
----####-#-#-#--#-#-----------------#-#-#-#-#---#-------#-------------##-####-----#---#---#-------#-
-#--##-##----#-----##------#------##-#---#-#-##---#---###-#--#-----#------##---------#-#-#-#------##
----------#--#-#---##--####-----#---##-##---##--##-#--#----##--##---#------#--#--#-#--------#---##--
#----#---------#----###--##--#-#----#---#-###----#-----###-----#--##------#--#----#---#----#--#---#-
--#-----##-#--------##---#---##----#-----##-----##---------#----#------#------------##---#--#-----#-
----#------------#---#-----#---#--#---#-----#-##----#----#--#---#-#-----##---#----#--#------#----##-
#------##------#--###---###-----#-##-#----------#-#----#-----##-#---#-#----#--#-#---#-#--#-----#----
---#-------#-----###----#---#----##-#------#----##--#-##--####---#--#-#----##------#--##--##-----#-#
--##---#--------#-##----#--------#--------#-#--###---####-----#--#---#-#-------#-------#--##---###--
--#------###----#---#-#---##-#------##-#---##----#-#--##---###-----#-----S#---##-----#-----##---###-
#--##--###----#---##-------#------#-##-----##--#-------#--#-#----##-#-####----#--#-#-#--#--#----##--
-----#-#-###------##----------###-##---#-#--####-#--#--#--##-##-##----##-#--#---#----#----#--#--#-#-
--#--#-#--#--##-#----#--#-##--#-------#--------#--#--##--#-#--#-#-----#-----#----#--------#--##----#
#--##-----#-##-------#----#-----#-----#-###---##-#-#--#--##---#----#------------#----------#---##---
--#---#-------#----#-#----#-#-#-#-##-#----#----#--#----#--#----------###-------#-##-####-##---#--##-
--##----##----#-##--#-##----#--#--##----#---##---#---#--#--###--#--#-#-#---------#---#----#-#-#-----
-##----#-----##-#----#--#----#-#------#-----#---#------#-#--#----##-#---------#-#--#-#---------##---
------#------####-#-##-##-#----------##------#---#--#---#---#---#------#-##--------#---------#------
#---#------###--------#----##---###-#-----###---#-#---#---#----#-#--#--#--#-#-#-#--#---#---###-##---
#--#---#---#----------#--##--#--##-##--#-#-##-##---##-#------#-###-#####--------##-#---------#---#-#
##--#--#-#-#--#----###--------#-----##------#---#-#-------##-##---###----#---#--#-##------###-----#-
---#---#--#-#--#-###------#------##-------------#-##-#--#-#----#---#---------###--#-#---#--#-#-##---
-#-#-----#-----#-#-#-#--##-##-----#--##--#----##---------#-#--#----#-------#--##--#-#-###---#------#
-#---#----##-#---###-#----#--##-##--#--##-#--#------#-###--#----##-----##-#------#----#--#--##-#-##-
#----#-----##-------#-#-----#----#-###----#---#---#--#-----#-#--#--------#-##----##--####---##-----#
-#-#--------#--#---#-#--##--##---#---#-##---#----####---##-#--#-#--#-------#--#------#--#--------##-
---#-------##-###-#-##-------#-##--#-----#-#---#-####--##-----#---#----##--#--###---#-####-------#--
#--#-##-#---##-#---#-------#--#---#-----#------#-#------#-#--#---#-----##----##-----##-#-#-#--#-##-#
------#---##--#--#-----#---##---#--#----#-##------------##---#-#--#-----##-#---#--#----#--------#--#
--#--#-#---------#------#####--#---#---#------#-##---#-#-#-----#-------#----------####-#------------
--#------##-#----#------#-#---##--###-#--#-##-#----##----##-#-------#-----##-#-------------#------##
##-##-##---#--#--#-#--#-#----##-#---##---##--###--#--##-#-#-#-##----E##--#-###-#--#------###---#----
-#-#-###--#--#--##------#--#---#---------------#-####--##-#-#--#-----#----------#-----#--------#--#-
-#-#---#-----#-----#----#---#-###--#-----------####---------#-------------#--#--####------#--#-#--#-
---###---#---#-#------------###----#-##-----##--------###-##--#---#-#--#----#----##----#--------###-
##-----#---##-#--##-------##-#---#-----#--###--------#---#-#--#-#--##---##---------------#---##-----
-#---##-----#--------#---#-#--##-#-----------#----#------##----#-#-##-#---#----#-----#-----##------#
----------#-#--#-#----##--#--##-#-#------#----#------#--------#---#---#---------#----###-#------#--#
-#--#--------#-##--##-#---#---#-###----#--#-#---#-#--------#---##---#----#-#-##--#--#-#-----#--#-###
--------#--#----##-#--#-#---#-#-#-###---###--#----------#--------#-----#-------#----##-#------#---#-
--#------#---#----#------#-#-#-#--#---------#----##-----####------#-#-###----#---#---------##--#-#--
-#------#-#-#--#----#--##----##---#-----#---#-##-#---#-#-###----#--------#--------------#-----#-#-#-
------##----#-#-#--#----#-#-##--#---#---##--#-#-----##-----##-------#--#-##----#-#-##--#--------#--#
-#----#-#-----------##--#-##----##----#---##---#-----#--##--#---#------#----##--#-##----#---#----#--
----#--#---------#--#--##--####---###-#---#-####-------#---#--------#-------#--------#---#--#---##--
-----------#--#--#---#---#--#--#-#-----##--#--#----#-#-##-#-##-#--#---------#-#-#--##---#-#---#-----
-----------#-#--#--###--##-----##---#-----------##-#-----#---#---#-#---#-#---##----##--#-##--##----#
-----------#-#-##-#---##-#-#-#------#-###----##---#-##-#-----#--#--##--#-#--#-----##-------#--#-###-
-#------#---##--------#-----#-----#----##-------#-----#-###--#-#--#--####----#-----#-###----#-#-#-#-
