-####---#-##-------###----#-#--#---#------####----------#--#-#-----#------#----#----#-#-#-##--#-----
--------#--##-#-###--#--#-#-----#--#--#-#-##-------#------#--##--##--#--###---##--##--####--##--#-#-
---##-----##--#---#-######------#----##---#-###--#--#---###-#--------#-#-#-##-----##----#-#---------
---------##------#---------#------#-#---##-###---------###-#--#--#--#-#-#---#-##-##---#-------------
---#---#-------#-#---###--#-----##-#---##----#--##---------------#---#-#--#----#---##---#---#---#---
#-#---E----------##-#---#-#----#----##---#-#---#--#---###-#------#-#----#-##-----#---------##-------
--###----##-------#--#-##---##--#---#-------###-------------##-#-#-##---#--#--##--###-#-------##-#--
---------------#-#--##--###-##----#----#-#--###--#-##-#-----#-#---#--##----------------------#-----#
----------------#------##----#-#--#---##------#---#-#-#---#------##-#---#-----#-#---#-----#-#--#-#--
--#------###--------------#-##---#------#-------###-----#---#-------#-###----#-#-#----------#--#---#
-##---#-#--#-##-----#------#-#-#--#--#---##-#---#-####---------##-#---##------#--##-##-----#-----###
--#--#---#-#-#--------#----#--##-#---#----##--#--#---#------#-----####----#-#---##----#--#-##-#-#---
----##-######--##---#----##-----------##------------##-#---#--##----#-##--##-#----#---##----#---##-#
#-#--#-######---##-#----##--#---##-#--###-#----#---#-##---##-#-##---#-###---#-#--#-#-##---#-##-----#
-#-----#-#----#----#-#-#-#--#------#--##--##---#--#---#-#-#-#-#--#--------#--#----##-#---#-#--##--#-
-#---#------#-----###--#-------#---#---##-------#-#-###-###-----##------#------#---#--#--#-#-#---#--
##----#---#---#--#----#-#-----##-##-----#-------#-------------#---------#------#----#-#----##---#---
-----------##-#--#--#----#-####-#----#-----#-####-#-#--#-#-#-##------#---#---------##------#--##----
#--#----###----####----#-----#-----#-#-#-#----#---#--#-###--##--#-#-#--#--##--#--##---#---#------#--
-##---------##-#---#--##-#####--------------#---##-#-#--#----#--#--#-#-###-##------##-#-#--#-------#
-#-###--#-#--###--#----##--#-#----#---#-#---#-##-----------#---#--#--#-##-##------#-#--#------##-##-
---#-#--#---#-#--#-------##----#-----#--#---#--##----##-#-##-----##--#-#-------##-#--#--#----#-##---
-#--#---#------#-##-----#-#----#--##-----#--#--------#-----------#----#-#------------##------#-#--#-
-#----#-----###---------###-###---#-----####--#-#-#-------#---------#-####-#---#--#--#---------#---#
#-#--###--#--##-#-----#-#--#-#------#-------#---#-----#---##------#-#-##-#-----------#-----#-##-#---
#-----#--------#----####-#-##-#------#--##--#--##---#----#-##-#--##----#-#------###------#---#-##---
----#-----#-#-##------#-#-----###-##----#-------###-####-#-----#-#----------#####-#--##--#-##-------
#-----##-#-##----##-#----#-##-#-----##----#---#-#-###-#--#-----#-----------#--------#------#####----
-----#--#-#-#---#--------#--#----------#--##--#-#--#--#-#-----##--##----#---#-----#-#-#---#-##-----#
--#-#----#-#-##--#----------------#--#----###----#----#----#--------#----#---###----#-###----#-#----
#-##--#-#---------#---------##---###-------#-----------#-----#-##---#------#-----#--#------#----##--
##-------#-#---###----######--#--#-#---###--##-#---#-#----------#---------###----###---##-#------##-
-#--#-#-------#----#-#--###-------##-#---------#-##-#--#-###---#------#------#-#--------------#-####
-------#--------------------------#------#---#--------##---#-#--#-#--#---#-----###--#---#-#-----#-#-
-###--##-#-#-###----#----####--#-#--###-#--#--##---##----#--#---#-#---#-##--##---##-#-##--#--##-----
--#-#---##------#-----------#-##-#---##--#-#-#--#--#-----###--##----------###-#--##-#--###--#--###--
--###-#----#-------#-#------#-#-##---#-##--#---#-#----#-#---#--#--#####---#--------#-####-#---#-#---
#---#------#------#-----##-#----#-##---------##--##----##--------------#------#####--#----#---------
#-#-###-----##-#------#--#-----#------###-#--#---#----#-#-##---#-----#---#--#----#----------#---###-
---#--#-#---##-#-#---#-#-#-#----#-#-#-##-----##-#--###-#-----#-----#---------#--#--#-##---##---#--#-
#--#---------###-#-#-----####-------#-----##-#---##---#----#------##----##-#--#------#---##--#--##--
#----#------#-#--------#---###--##---#-----#---------#--#---#-#-#--##----#----#--------#-#---#-----#
-#--#--#-#----#-##---------#-#-----##-#-----#-#####-#-------#---#--###----###-------#--#--#-#-###---
-#---#--#-##--#-----##---#--#---##----###---#----###------#--#-------#-#-##--#---#----#-#--#--------
#------#--#--#-##----#---#-##-#----#---#----##-##----#-#------##--##--#-----#---#-#--###---###------
---##--#---###--------#----##------##---##-###-------#----#----#----#-#-#-#####-##-#-#--#----#--#---
##-##--#-#---#---#-S---##--#----#-#-#---#------#---###-#-------##-#-#---#-#---------####-#-#--#-#---
##-----------#------#-----#---#--#-#--#--#-##--#---##-#------#--#----####--##----#---------#-----#-#
--#-#--------##--##-##---#--#-#--###-#--#-##-#--#-####------#-----#--####---#-##---#----------------
#-#---------###-#----###--#--##--##-#--#----#--#--##-----#--#-#######--#----#-----##----#-----#--#--
--#--####------#-----#-#--#--------#----###-#---#---#-----------#--#-#-##---------#-#--------#--##-#
-------#--#--###-#--##---#-#---#---#-#-###----------#-----##----------#--#--#------------------##---
---#---##----#---##----##-------------#--#----###----#---#-----------##--------##--------#-##----##-
#--#---------#---#--#------#----#-#-#----#-------#-----#--##----#--####-----##---#---##--#---##---#-
-#----#--#-------#----###-##----#----#---------#--##--#----##-###--#---#--#-#-###-----##-----#------
------#-##---#------#---#-#-----------------##--#--#-------#--#----###--#--#--------#-#-#--###------
---#--###--------------#---######----##-#--##--#---##-#-------###---#---#-------#---------#---------
#--#---##---##-#-##-#--##---#--#--##---#----#-------#------#-------#--#--------###-##-##--#---#-----
---#----##-##----#---##---#------#--##--#---#-----#-#------#----------#-----##-----#-#---#-#--#-##-#
-##--#------#-##-#-#---------#--#------#-##-----###-#-#---------#--#-#----#--##-#-#--###--#-#-------
-##--#--#-----#--#-#-#------------#------#--#-#-----#---------##------##---#####-#-----#--#---------
------#---###---##--##-#--------#--##-##---#-#----##---#----#-#-#-------##-##-#---#--#-------##--##-
--##--##-----#----##---#-----##--------#----#--------------#-##---#--#-#------#----#--#----####----#
---#-#-----#--##----##-##-------#--##---------#--#-###--#--#-#-----------##---------##--#-----#---#-
###-###-##--#---##---##-#--#-#--#-------------####-------##-#-#----##-#-#-#-#--#---#-##-#--#-#--###-
-----------------#--#--------##----#-----#-#-#---##-#-----------#-#-#-----#####-----#--#--##----##-#
-#-------#-##----#-###--#--#----#----#--#---###-##---###-#-----#-#-------##--#-#--##----##---##-----
-#-#---#-----#--##-#--------#--#--#----------#-----------------#-----##-##---#-#----#-#---#----#--#-
--#-##--#--#---------#-#---##---#----#-------#-------###----------------#--##------#-#---#-#------#-
-##----------##---#---##-----#-------#--##------#-##-#-##--#----#---#---##----#-#---#-#---#--#-----#
##-#-#----#--#---#---#--------####---#----------------###-#--#------##--##---#-#--------##-#--##---#
--#---##-#-#---#-#-#-----#-----#---##---#--##----#----#--###--##-#-#-#-##--#--#-##-#-####--#-#---##-
--#-------#--#-------###-------#--##--##----#--#--#----------#----#-#----#---##----#-------------##-
-#--#-----#------##------#-###--#---#-----##-#---------#-##--#--#-#---------#-------#----#--#-###---
-#-#------#------##-##-##-#-#--#--#------###-##---#-#--##-#-#--#--#------#--###---#-#-------####--#-
#-#--#---#--#-##-----------##-#-##-#-#--#--#----#-#--##--------#---#--#--###-##-##--#--#------#--#--
##-#-----##-#-#--------------##---#---###----#----#--#--##-------#---##-##-#-#--#-#-#--#-#-##-##-#--
--#-##----#--##-####----#---#--##--#------#------##-#-#--#-#-#---#----##-#-#----#---#-------#-------
##--#---#--#-------------------##-##--#---------------#-#-###-#----#-#-----##----#--#--------#---###
--#---#---#--#--#-#--#---------##-#------#-------------##---#-----#-#-----------##-----#---------#-#
###-#----#----#------#-#-------#####-#-#--#--##-##--#-###--##----#-###---#-------###----#-----------
##--##--#-----##-----#------#----#-------#---#----#--#---------##-#-##-#--#-#------###-#-#--#---#-#-
---------#-----#--##------------------#-#---##--#---##------#--#--------#---#--##--#-------###---#--
#--#-#----#---##--#----#-##---#-#--#------#-#--#----------#--##-------#-#-#-#---#----#--#----#-##-#-
-##-#--#-------------##-##-----#-#-----#---#------##-###-#--#---#---#-#-#-#--#------------#-##-##---
---#------##-#--#---##--#-#-##-#--##--------#-#------#--#---###-#------#---#--#--##--#--#----------#
---#-##----#-#------#------###-#-###-#----##-------#---#----#-------#-#--##----##-#-#---#-----##----
-###----#---#------#------##------------##--####-------##--#--#--##----#-----#----#-###-#-#---#--#--
#--#-----#------##-----#---#----#-------#---------#----------------#---#---------###--#--#-----#--##
-##-##-#--#----#--#----##--##---#-##---#-###-----------#----#-#-#-##---#--------#---#-#####-------##
----##-##-----#-#--##-#------#----##--------##----#---##-#--------#----#-#---#--#---##-----#-----##-
--#---#-#---------#--##--------#--##---#-##--#--------#-#--#-----##--------##---#----#--##--------#-
--#-#-#-----###-##-#--#---#----#---#--#--#-#------#----##-------#---##-###-----##--#--#----#-#-#-#--
--####-#--#-#-###-#-#------------#-#-----------#-##--#-----------##----#-------#------#--##---#--#--
------##--#-#-#---#----------#-#-#-#---#-#-#-#-#--#----##---##-##---#------#--#-#--##----#-#-------#
---#-##---#-#---##-------#-#----##---##---#-###-##--#------#-#--#-------###---------#--##-#---##----
-------#-----------#-###--##-----#####---###-#-##--#--#-#--###--#----#---#--##--#-##-----#----#--#-#
-#--#---------##-#---##-#-#----#-#-----##--##-------------#----#-----#-------#-#-----##------#---#--
----#------##--##----######--#-------------#-##--------##--#-###-----#--#-#---##-##----##-------##--
##---------#--#--#---#-------#-#----#--#-#-##--#-##--#-----#---####-----#---##-#---#-#-###-----#----
