--#-#---##-###----#-##-----##---#-----#---#--#---------#--####-----#-#--###--------#-----------#----
------#---#-#----#---#-------#------#-#-#--#--###-##-#------#-#---##--###-##--#----#####---#----#-#-
-###-----#--##--#-#---------#-#---#--#-##---#--#-------##-####----##--------####-------#--#----#----
--------###--#-#---#---#-#--#--#--##---#---####---------#------#--#-------#-#---##----------##------
---##--E---#-#-----#--#-------------#-#--------#--#----##--###----#-----##-#--#------#-#-#--#-#--#--
--#---####--#-#-#---#-----#----##------###--##----#--####----#-#----####-###------------#---##-----#
##-----####----##---------#---------#----###---##-###-#----##-#-##-#---#-#-#----#------#-#-#----#-##
#-##---#-#--#---#------#-##-#---##----#-#-#--##-###---#----#--#-###---##-#----#--#------------#-##-#
----#-----##-------#---#------#----##-#---#-###-##----#-##-####--#--#-#----#-#-#--#-----##---#--##-#
-#-----------------#-------------##-------##-----#-------##----#-#----#--#-#-#--#--#-#--#---------#-
#-#-#-#-#--##--------#---#------##-#--#----------#-##-##-#---#-----#---#---#-#-------#--#--#-#------
----###-#---#---#-#------------#--#--#---##-----------#---#----##-----#---#----#--#-----------------
#----#-####----#-#----#-##-#--#--#-#-##----##-##---#--#-###-----#---#-#-#----##------#--##------#---
-----###---#####-###----##-----#------#--###----#----##-##--#---#--------#--###---#-------##-----##-
-##-##----#--#####--#--###-#-##--##-##---#------------#-###------#---#--------#-#-##--------#-#--#--
---#-#------#---#---#-#--##--#--#-##-----##---#-#--##-#--------#-----#---#-#--#-##-#-#-#---##----#--
-#-##--#-#---------#---#-----#---------###-----##--##--------#---#-##---#---------##-------#------#-
###-##--#-----##-#-#-#-#-----#---#-#---#---####-#------##-#--#--#--#-#-#----###----#----#-#-----#-#-
-------#-##-#-#--#-#--##----##--#---#------#----#----#---#-#------#--#-##----#-#-------------#---#--
--##--#-#-##-#------#####--#--------#-#-----#-----------##--------#--#---------##-----#--#--#-#----#
#-------------------------#-------#----#------#------####-------#------##-----#-##-#--------#-#-#--#
-#--##-#--#-------##--------##--#------##-##---#------#--#--#--#--#--#---###--###-#--#-----##--##--#
#--#---#-##--#-#-----#---------##--#------------##-#---#--#---###-#-##--##----###-##----##------#-##
--#-####---#--##---------#-##---------------#----#-#----##----##----#-#-##--#-#--#-----#------------
-----------##----------#--#---#-#-------##----#-------#----#--#----##----#-----------------##--#-##-
---#-#------#--###--#-##-#-#-#-##-##---#-----#--#-#---#----#--#-#------###-###----#----#--###-#-----
-#----#---#-##---#-----#-#--#-#-----#----###------------#---#----------##-#---##-#----#---#-#-------
#------#-#-##-----#-#----#------#-#---------#-###-#---#-----###-##-##-#-#-#--##-------#-------#-----
##-----------#------#--------##-#---####---#-#--#--#-----#------------#-##--#-#----#-#-----#--#-#---
#---------#--#--##-----#--#----#-----#--#--#-#--#--##---------#-#--#------#----#-##---##-###--#-##--
#-----#-#-#--------#----##-------##--##--#---#-#---#----#-----#-S---##---###--#----##--#------#-#---
-#----#-###-#-----#-#----#----#-#--###---##-#---#-#---------#-#---#-###----------#-----#--#-----#---
--#--##--#-#--#-------##---#-#---#-#--#-#-#--#--##--#-##-###----##-----#-------##-#----#-#-#--------
--###---#-#------#--#-##-------#------##----#---#--#-#-#------------#----#-##-###--##---#--####--###
---#-#---#-#----#----##--#-----#---#------------#---#-#---##---#------######----###-----------------
--------#---#-###----#-##--#-#---#---------####-###------#----#--#--#------#-#--#-##--###--#--------
--#--##-####--##--#--###-##---#-##-----#-###---#-#---#-#--#--###------#--------#---###------###-#-#-
-------------#--#------####--###-#-------#--#-----#---#------#-------##--------#--#------#-#-###-#--
-##-#-#-#---#---###----------##--#-----##-------###----#-#--#---##----###------#-----##----#----#-#-
####--##-#-####---##----#--#-#-----#-----#-##--###--#--------####-#####--##-#-#--#-#-#--#----##---#-
#--#-####---#--#--------#-#-#-##----#-#-#--#--#-----#--#-#-#-#-###---#-----#------#--#-#--###------#
--#---#--#--#--#-----#-##----##-----#--##----#-##--##-------#----##-#--###---#-#------##-##---#----#
-----##---#-#-##-##--#----------#---##--##-#--######---#-###-#-##-#---#-#-#--#-###---###-----###----
---#---#-----------#---#---#-#--####---#-#-#-##-----#----##-#-#--##----#-#---#---##-#-#---##---##---
#-----#----------#-----#-#####-#-#-##---#-#---#-#-#----#----###--##------------#-##--#---------#----
-##---##----#-#---#--##----#--##-------#--#-#--####---##-----#-#-#--#--#---#-#----------##-#-#-#-##-
----#------###-----#-#---#---#----#---#-#-#--##-#-------##----#-----##---#-#---#--#--##----#---#----
--#----#--#----#-##-###------#-----------#--#---#-#--#----##---###-#-----##-#---#-------#------#----
#----------##-#---#----#---#--##--#-#------#---##-----###-#--#----#---#----###-#--#-----#--###-#-##-
---#-#---##-#-#----#-#-#-#-----#--#-------#-##------##-#-##-#-#--------#--#--#-#-------#--------#--#
-#-#---#------------#--#----##--#--#---#-#--#-------#----##----#-##-#-#-#-##--##--#--###--#------#-#
#----####-----#-----#-#-----#---##-#---#---#--##--#---#---#-----##-#---#-------#-----#----##---##--#
---#------#--#----#-#---#----##---###-------#--#--#-#---#------------####-#----#-#---------##-------
--#-#-#--------##-#------#-###--##------#--###---#--#-#--#-#-#----#---#---#---#----#--#---##--------
#-#-###--------#--#----------#---#---#-##--#--#--#-##-----#---#-#--#-###---#----#-#-#-------##--#---
#----#-##--#####-#-#---#----#-----#-#-----##---#----#------#####-----#--------#--##----#--###---###-
----#-#--##-#---------------#---#---#-#----#---##------#----#-#--#---#--#-------##---------#-####-##
---#---#--#-#----#-#-##--##-#-#--###--#----#---------#---#---#--#--##-##-#--##-#---------#---------#
-#--#--#--###----###-----#-----#---#----#--#--------#----#-#--#--------#-#----#-----#---#------#-#--
---#------------#-----##------###-###-----#-----###---#--#-##-----##-##---#--#-#-----#------#-#-----
#####--#----#-#-----#------####--#---#-#-------#--#----#----#--#-##-----##---#---------#---#--------
#------#-------##------#-##----#--#---#-#--#---#-#----#-----------#-----#--------#-####----#----##-#
#-#-#-----##---##---#-------#-#-#--#-#--#-#-#-----#--##--#-----#----#--##-#---#--#--#-------#------#
---#----#----##--#--#-------#--#---#--#-####-#--#--####------##---#---##-------#--###----##---#-----
##--#--------###------##-##-#-------#-#------###--------##--#---#-#####--##------#-#-#-###--##--#---
-##---#----#-#-##-##-#---##-#--#---#---#-#--##-##-----##-------#-----#--#--#-##-##-#--#---###--#----
-#----##-----------#--#-#------#-##----#-----#-#----##--#---###--##----#--#----#----------#--#----#-
#-#-----------#---##--#-----------##---#---#-------#--#---#-----#-#------#-----#-#-----#-#--##-#--#-
---#----##--#--##-#--##-#-#--#--###---##------#--#-------#-#----###--##---#---##---------##-###---##
##--#-#------##-#-#---#---------###----#-#-----#-#--#-#--#-----#-----#-#----#-#-#---###--#-#--------
-##----#--------#-------#-#-------#-----###--###--#----#-#---##------##---####--#--#-----------#----
#----------#--###----------#--##--#-----#--------###---##-#---#-##----#--#---#-#--#-##--#---#----#--
--#--#-#--#-#--#-------#---###-----###-#----###----------###--##---#-#---#---#-#-#---------#---#-#--
---#------#-----#---------#-###-##---#-#-----##---##-----###-----###------#---##--###-----------###-
------------#---###---#--##-#------###-----##----##---#------##--###----#----#---#--###---###------#
#-###--#--#---#-#-----#--#------##----#---#----##-----##---#----#-##--#----#-----##--#----#--#-#--#-
#-#-#---####--#-#-----#--#-#-----##---#---#--#--#-#----#----#--#-##---##-------------#--#--##----#-#
-#--#-#--##--#--#---###-##-#----##----##----#--#-##--#--#-#-#-#---#--#-#---#---#-#--#-----#---#-###-
#--#---##-#-#----#-#---#--#-#--#-####--#---------#--##--##-----#---#-#----#---#-#-#-------#-##------
#-#-###-----#-#---#-##----#-#-#-----------#--#---#---##-#-----#----#----##-#--##----##---#-#-------#
#--#--#-------#--#-----##---#------#-##-#-#-------#--#--#--#---#---------#-----##-#--#--#----###----
-----#------##-#-----#---##---#----##----##----------#####-##---#-#--#-#--#--#-#----###--#--#-#---#-
-#----###-#----#---#--##--#------#-#--#----##-----##---#-----#-----#---##----##-#--#-#-#--------#-##
-----##------##-#-------------##----------##--#---#---#--#---#----#---##------#-###---------#-#-----
##-#-----##-#----#-#-----#---#----###-#--##-##-#--#--##--------##-#--##-#--###--#--#---#--------#---
#-#--#--#---#--#---#-###----##---#---#------------#-#-##----#----#-#-----#####----###---#--##--#-#--
#------------------------#--------#-#-----##-#---##-#-##---#------#-#--#-#----#----#-###-##-#---#-#-
#--#-----###-#---###-----##-----#---#-----#---#----#-#-#--#-#---#---#----##-------------###---##-###
-----#---#-#-##--###----##---------------#---##-------------#--##--##-###-#-----#--#----#-----#--#--
--##----#------------------#----#--#--#----#--#--------##-#---##----#-#-----#----#--##--##-#----#---
#--##-#------------#-#-------#-##--##---#--#-#-----#----#-----------#--#-#--##--##---##---#---------
##-#-####-##-----------#-----------#-###--#----#------#--#-----#--##-----#--#-----#-#---#-##--#-#---
---##--------#--#------#----------#--##-----##------#-#-#-----##--#-----#-----##-----##--#---#--##--
-##-------#----#---#----------##--#--##---------------#----#-#-#-#----------#---##-###------##-##---
##----#-----#-####--##-#----------#--------#----###------##--#--##---####--#---##-#---####--#-------
##---##-#-###--------------#-#--#--#-------#--#-------##---##-#--#--######-#------#-------#-#--#-#--
--#---------#------#----#---#--##--#--#---#------##--#--------------#---#------#-#----#-----#-##-##-
--#----#------#-#--##--#------###--#----##---#----------#-#------##-#-##--------#---#-#---#-----##-#
---#----#----##---------#-#---#-------#-#--#-#-#--------#---#--------#-----##------##---------------
--##----#-------#--#----#----###---#-----##--#---#---#---#---##-----------------#-----#--#----##-#--
