#--##-------##-#---#--##-----#-#--------#--------#--##-------#---##--##---#-#--#---###-----##---#---
#-###-#----------##----#---#------##---##-#--#--------------#--#-###-#-------##-#---#-----#-#-##--#-
##-##----#-#-#---#----##-----#-#----##---#--#--####---#-#-#--#----#--#--#--#----#----##-#--#-#-----#
-##--------#----#---###-------#--#--#-#---#-----#----------#------------##-#-#-------#----#--#--#---
---####------#----------#---###-#-#--#---#---#------#--#--##-###-#--###--##----#-###--#-------#-----
##-------#----###-#---##-#--#--##--##--#-#---##--#--#------------#-#--##-------###--#-###--#--------
#--###-#------#----#----##-#------------------#--------#-----#--##-#----####------#----##-------###-
-#-----#-#-#----###-#-##--#-------##---##-#--#----#------#--####---######-#####--##-##-----#-#-----#
#--#####--#---#---####-#-#---#---------#-#----#---#--##---##-#-#-------#-##--#--####---#-#-----#----
-----#---#---#--#--#-------------------#----##--#-#-------##---#--------------###-##-#--##--###-#-#-
------#####-#--#-------##----#-#----#--#-#-##-#-###-#--#------##--##----#---#--##-#-----#-----------
#-#--------##--------##-##-----#-##-#-####---#----#---#####---#--------#----##---###----##--#--#----
-#-#--#---##-#-#----##-----------#----#-###-#-#-#---#-#-----#----------##--#-##---##----#-#---#----#
------#---#-#---#------------#-#----------#--#-------#--#--####---#-###-------#----------##---##---#
----#------##----####-#---#--#----#------#-#-----#--##-#----##-#-#---#----#--#----#--###-##-#-------
---------#----#-#--#-------###--#------------#-#------#--#----##----#---------#--###------#-#-#---##
------#---#-#---#-#-#-#--###----#-##-----------###--#-----#-#-----##-----#------##-#--#---###--##---
---##--#--------#----#----######----###-#---#------#--##--####--#------#-#-#-----#---#----------#-#-
--------#----####---#--------#--------#--#-###--#-##--#----#--#-------#-#-###----#------#--##--#--##
##---#-------#-#----#--###-#--#-----##---------#--##---#--##---------##----#-#--#-#-#--##-#----##--#
--#---##---###-#---#----#-----#--#---#-##--##------###------------#----#--#-----##----#-#--#----###-
##------####-#--#-----####-#-------#-----#-#-#-#-------#--#--#-###---#-#--###--#---##--#-##--#-##--#
--##-#-##--#-##-------#-#--#-------###--#---#-#-----#-#-##--#------#---##-#------#-----#-#-#---#---#
-#-#-----------#--------##-##----#--#------##-#--#---------###---#-----------#-------##-##-###-###--
#-#--#-#---#----#----##-----#--#---####-##--#-#---#-#--#-----#----#-#----##---#----#-----#--##-##---
---------------#-----#-##--#--#-##-#--#-##-----##--##--------#-##--#--##----#--#----##-----##--#--#-
----#--#-#-##-------##--#-#---##-----#------#---#--###----#-###-------##-----#---#----#----#--#-----
------#---#-----#-#-#-------#-#----#-##---#---##-##-----#-#------##---#----#-----#---##-------------
#------#-#---#--#-----##-#------##----#-----#--##--#-#------#-#------#-##--#--##---#--#-#-##-----###
---#---##------##-#-------##----##--##---##---#----#--##-#------#----#-#-#---#--------------#-###--E
##-#-#-----##---###-----#--#--#--#----#-###--###---#------#-#---#----------#-------------#--#----#--
----#-----#---###-#-#-----#-##--#-------##--#-#--------#--#-##--##----#-----##-#---#---#--#-#---##--
-#-###-#-----##------######-#---#--#-----#-##-----#---#--#-##--#-#---#---##--#-#--##------#-#-------
-#---#---------##-#-------#--#-#--------##---#----#----#--#---#-----#-#-----#----#--###-#-----------
--#------------##-#---#--#---###----#---------#-#-------##----#---#----------##---#-------#---#--##-
-----#-#--#-#---##--#-#--#---#---#-#-----##--#--------#--#---#---#------##-#--#------#-##-----------
#-#--#-#----#---#-----#--#--#-#-----##-#--------###--------#----###---##-#----##--#---#-#-----#-----
--#-#--###--#-###--#---#---#-----#-----#-#----#--#----#-----#-##--#------#----#-#-#-S-#--#----------
##--------#-----##--#-----##-------#--##----###----------#--#------##------#-#----#-#-##-##---#-#--#
-----##--------##-#----#---#-##-------#-#---#-----#---#--#--#---#-#-##---#--##-----#-#---#---#---##-
----####---##--#####----------#---#-------###----#-#------#-------#------##--------#--###-##------#-
#---#---###--#------#-##-#------#---#-----##-----#---##--##-#-#-------###-##-#--#-##---##-#-------#-
##-#-##-----#-----#------#-##--#-##-#---#---------#----#-##-------####------##--##------------#----#
-#------###-----#---#--####--##-#--#####--#-#-#--#--#----#-#--#----#----#----##----#----#--##---#--#
--#-#---------#---#---#-#-###-#-#-----#-#----#---#---#-#-----##--#-###--#-#------##--------#------#-
--#-----#-##-#-#-#-##----#-#---#--#-#-----#-#-#------------#----###-------#-#-#-#--##------###-----#
------##----#-#---#--#---#---------#-##--#-----#-#--#------##---#---#--#--------##--#--------#--#---
-#-###-#---#--------------#------#--#--#-#--#---##------##--#--##---#----#------#-#---#-###----#----
--##-----------###--##-------##----#---------#-#-#-#--#-------###-#-##--#--#---#----##--#----#----#-
----#---##----#-##-#-----#-##---#--#--#-#-----------#----#----#-##---------##----#-#-----#-#------#-
-------#-##---#--#-#----#--#---#---#--#----#-#-#-#-------###-#-----###---###--#-------#-###-----#--#
---##-#--#-#-#---#-##--#------#----#---#-##-#---#-#--#-----##-----##-#---##-#-#--###--#-##-----#---#
-#--#-#-#--#-#----##--#---#-----##--#-##-##-##-#-#---#----------#--###----------#--#-##----------#--
#--#-#-#--##---###--#--------#--#-------#------#-#-#----#---#--#-----#-#----#-#------#---#-#---#----
-#-----------#---#------#--#---#-##---#-##-#-#----#-###---#--#-#---------####---#--#------#-#-##-#--
#-#--#-#--#---#-##---#--#--#--##---##-#---#-###------------#------#--#-#-#-##--------#------##-#-#--
---#------##------###--#-----#---#-#----#-#--#-#---#--###----#--#----#-#---#-##--#-##--------------#
--#-----###----#-#----##---#--##---#---#----#-#-#--#######---#--------------------###---#-----#---##
#-----------#-##--#---------#--#-----#--##-#-----#---#-#-----###------#-----##-##--#----#---#-#-#--#
-#----##------#-####-#---#-#--#--###------#---#---#####-------#--#-------#----------##---#----#-##--
-#----#---#------#-#-#------#---##-###--#-##-#---###-#--------###------###-#-#-###-#-#---#-#----#-##
#-------#---#-------##---#-#--#-#-#--------#-#-------###---#--#---#-----------##-#----#----#--#---#-
-----##---#-#-#--#--##-#-----#-##-----##---##---#-#--#-#----##-----------#--##------#---###--------#
-#-#---#--#-#-##------##--##----#---------##---#-###---#--#-------#-#-#--#---#----#----##-#--#-----#
----#-----#----#----###-----#-###-##----#-#-------#-###----##--###--#-##--#----#-####-#--#--#--##-#-
----##--------#------#----#--##---#-#-##---#-####-######-----##-#---#-#-#-------##----##-#-----##---
#-#---#-------#---#-#-#-##---#-----------#-----#-###---------#-###------#-------------#---##--------
--##--###-#-#--------#-##---#-#-----#---#------#--------------#----#-#-##--##-##--#----#-##--##-#-#-
-#-##----#---------#------##-------------#--#---------##-#---------#--###-#--##-#--#--------#---#--#
--#-#--#--#---------#-#--##----#-------##---#-##-#--#-#-#-#-##-#--##-#---#--#--##----#---#----------
#-----#-#---------#-----#-#--------#-##---------------#--##--#----##--#----##-----#-##----#-#-#-#-#-
#-----##---####----#--#-#-##--#-##-#---###--------###-##------#-##---#-##-------#-#-----#--##---#---
#-----------##---#----##-##--#----##-##-#---##--#------#------##---#####-#--#--#--#-####---#------##
-#--##--#-#---#------#--#-----##--##----#--###--##---##-##---#----#-----##----###--##-------------#-
-------------##---#-#----------------#-#-#--#---#-#----------##---###--------#-#--#----##-#-#---##--
----------------#------------#--##--------#-#-------#--##---#-###-----##---##-##----#-----#------#--
------#----######--##-###--#-#------##--####---#------#-#-#-#----#--##-#-###---###-----------#------
---#----##-##---#--#----##-------##----#------##-#-------#-#-#-##--#---#--#-#---#--##------#-#---###
---#-##-#-#---###--#----#-##----------#-##-----#-----##-#--#-----------#-------#-#--#-###---#--#----
#-##--#---#-#----##----------#----#-------#--#-##--####---#----#---#--##-----#---#-#-----#--#-------
------#---#----##---#-#---#-##----------#---------##--#------#--------#--#-----#---#---####-#-#--#-#
-#--##-------##-#-#--------#-#----#-#-##-------#-------###------#-----#-##-#--#--#------#-##---#----
----#---#--#---#----------#--#-#-#---#--#--#-#---#-#-#-------#-##----#---#-########-----------------
-----------#----#---------##-##--#--#--#-#--------------##--##------#-##---#-#----#--#--#----#-----#
--#---#-##--#-#---#-#---##--#-##-#--------##---#--##-##-#------###---#-------#-##-#--#-#-----##-----
---------#-#---#----#--#--#-----#--------#--#--#-##---#-#--###-#-#-----#------#-#---#------#---#-#--
#----##-###--##--#--#---#--##----#-#--#--#-###--#--#--#-###---#-#-#------#--#------#---#-------#-#--
-------#----##-#-#-#--#-###-#-##------#-#--#---#-----##----#---#--####----#--#------#-#----##----##-
---#----#-#-------#------#-#---#--##--#------###--------------#-------#-------###-------------------
--#----------#---#--#---##--------##----##------#-#--#-------##-###-#---#--#--#-#--#-####-#-#-#--#-#
--###-###---#-##------#---##--##--#------#--##----#-#-------#------------#----#--#--#--#-##---#-#---
------#----#-#---------#---#--#-##--##---------#---#-#------##----#---##--##-##-#----------#------#-
#---#---##-####---#--#--------------------##----#---#---#---##-----#--#---------#--#--#---#-------#-
---#--#--#----#-----###---#----#--####----#-##-----#----#-----#------#--#-##---#-##----##-#-#----#--
-------#--------#-##-####---#-#-----##---#----#---#----#-#-#---------#---#-#--#--#-#######--##---###
-------#---#----#-----------#-----------#---#--#-##--#-#---##--------------###-#--##-#---####-#-#---
---#---#---##--#----#-#--#-#-##-#--#-------####----#--#--#--#--##-----##-#----#-##--#-----##--------
-#------#---#-#----#----#-##------#--#-##--#-#------###--#-#--#--##---------#-----#----#####--#-##--
#---##------#-###---##--#--#-#--#---#---####-#-#-----####----#--#----#-##---##--#---##--#-#-#---#---
----#-####---------#-#-#--##---#-##--#-###---#-##---#--#-#---#----#---#---#-#--#---###------#---##--
