-##------#-#-#-#-#-#-#--#--#---#--#-----#-#--####--------#-##-----##---#------##--#-##--##-------#--
----##--------###-##-#####---###---#-#-#---#---#--#-#--#-#----#---#-----#--#-#-----##------#--------
#-------###-#####-#---#---##---------#####--#------###----#--#-----#---##-#-##-#---------#----#-----
--#--##-------#----####--#--------##-###-----###-#-----#-#----#--#-----------#-----##---#--##-##----
--#-#-#---#-----#---#####-#-#--------#--#-#-#--###-------##-#-#---#--##-#--------#--#--#-#---##-#---
----#----##-#-#-----------##-#-----#-----#-#-----#-#---E---#-#---#-----#-------##------##-#---#---#-
----#-------#--------#--##-#--###--#--------#-#-#-#--##-#------#-###-#--##--------#----#-------#-#--
--##-------------##-#-#-#######--#-#-#-#-#--#---#---##---##--##----##-#----##--#--#-----#----------#
#------###-------#-#--##--#-##-----#--#---------#--#---##-#-##--------###----##-----#-----------#-#-
------#-----##-----#--##-#----##--#-#----#----#----#---------#-#---#-##--#---#-------##---#-----###-
-##-----#----#------##-##--------##--#-----------##--------##-###--------#--###---#-#-----##---#---#
-----#----------#-#-----#-#--#-----------##-#-#-#-###-----#-##-#--##--##-#-##--#--------------------
----#-#--#-#--###-#-------#---###---#-#-#S---#-#----------#------#-#---#-#---------#--#-#--##--#--#-
#-#-----####-##------#--#-#-#--------#----#----#-#----#---#-##-##-----#--#--#---##-#-#-#####--#----#
----#--#-----####----#-#-#---#--###---#------#--#--#---#---#------#--#--#--#----##---#---#---#-----#
-##--##------#------#-#-##--#--#--###-#----#-###---#---#-##--#-#--#-##-##-------#--------------#--##
#---#-#-#------#---------------#-#--#------###----#----##-#---#-----#------#-###--#----#--#-#--#--##
#-##-###--#------#-#---#--#-##--#--------##-#-#----#-##----#--#-----##----#--#--------#-#-----------
#--#--#-#-----#------#----------#-#---###---#---#-----##-###-#----#-#--#---#--#----##--###---##-----
-#-#-#----##---#--###---#------###--#--##-#------#---------#-##-----##-------##---#------##-------##
---#-----##---#--#---#----#--#-##-#---##---------#-##-###-##-------#--#-#---#-#-##----##--##-------#
##--#-#-##-------#----##---#---###--------#--------#---------#-###-##-#-----#-------#-#-###-###---#-
#--#-#----#---------##-#--#---#---#---###---#--#-#--#------#------#-##---#----##--######---#-#-###-#
--#--------#--#----------#--#--##--#--###-#-###---------####-#-------##-#------###--#----##----##---
#-#-#---#-####---#--##--##-#----#-##-###--###--#---#-##-#----#------#-#----#-#--###-####-#----###---
---###-----------------#-------#-##-#------#---#--#----------#--------------##-###-#-----#------#--#
--#----#####-#-#-#-#--#-----------#-#----#----#-------#-#----#-##-----#--------#-----#-##-----#-----
--------#--##--#--------#----#--#-#---#-#--##-----##-#--#-#--#-#---#-#-###-----#---#--##----#----#-#
#-#-##-##-#---#-#----#-####----------------##-----##-----------##---#--#-----##-#-#-#--#-####-#--#--
#----##-#-#-#-----##-##-----#----#--#----#--------#-----------#--#---#-#-----#--##------#-###------#
#----#---#--#------#---#---#-#--#----#----#-#---###--#-#----##-#-##-#-#-#----------------#-#----#-#-
------###-#-#--##----#---#---------#------###--###-#--------#--#-------#---#--#-##--##-#-###-----##-
---#---##-##--#-----##---##-#-#--#--#-------------###-----#-#---#------#---#-#---####-#--##--#------
#-----#-#--#--##-#-#---#------#----###-#-##-#--##----#---#-#---------##---#------------#-----###--#-
-#---#--#---#-#--#---##--##-#-#---##-##------##-#-#-----###--#-#---##------#----#-#------------###--
--#-#--#------##---#---##----#-##-------##-#--#----##--#------#--#-------------##--#------##-##--#-#
----##---#-##--##--#----#--#---#------#---##------------#-#----##-##--#----#--#-----#-#--#--##-###--
---##----#-------#----------#---#--###-#-#------------------#-#---###----#--#---------------------##
#---------#-##-#--#--##----------##-##-#-####------#-##----#--##--#----##--------#--------#-----#---
------##--#-----#--#----#-#--#-------##-----------#--#-#----#-#-#---##-#---#-#---------#-#-------#-#
-#-----#-#---##--#----#-#----#-#-##------#--##----##-------###-#-#--##----#--###-----##----###-#-#--
-#--####------#-#-#---#-####-#--------##--#---#-##--##-----#----------#--#--###--#-#-----#-----#-##-
------###--#----#------#-#-----#----##---#-#--#----#----#--#-----##-#----#-------#---#--####--#####-
----#----#--#--#----#----#-------#-----------###----#---#------##------#---###-#--#----#--##-#------
#----###-#----#-----------#-------#####-#--#-#----#-#--##---------#----------##-##---#######---#-#--
#-#-----------#--#-####--#-#-#---##-##-#----#-----#---#------------#-#---#----------##---###----#---
--#--##-#-#-##----####-##----##-#------#-#-###--##-#--##-#----##--#--#--#--------##--###------#-#-#-
##-------#-#---#--##-#-##-----#---##--#-##-####-----#-------#-##-----#--------##--#--#-##----##--#--
-#--#-#-------###------##-#----#------#----#-----###-#-#----#--#---#-#---#----#--#---#----#-------##
--#--#--#--##-##-#---#-#-#-------#-#--#####---#---#--#----##--#-#---#-#-#---#-##-#----#--#-#-#--#---
--#------##-##---#--#---#----#--##---#--------#---##-------#--#--#-#-----#--##--#------#-####--#---#
-##---##------#------##---#------------##-----#----#-#---##-##---#---#-####---#--------#--#-----#---
-#----######-----------------#-##-------#-###---------#-##-#------#------#-###--#-------#------#---#
-####--#---#---#---#-####--##--#-#---##-##--###-#-###-------#--#-#-----------#--------#---#-#-#-#-##
-###--------#####-#-#---#---------#---#-#----#---------#---##----#--------#------#-------#--#-------
-##---------#-----#-----------#-##-----#-----#-------##--###-###---#-#----#--#--#--#-###-#-#--#-----
---------###--#-----#-#--#---##-#-#-#-#--##----#-#--#--#-#-#---#----##-#--#--#--#-----#-#--##-------
--#--##-#----#-------#-###-#-#------#---#--#--#-##--#-----##----------------#-#---------##--#-#---##
#--#--###------##--------#-###---#--##---##----#--#-----------#-#------#----###-#---#--#----------#-
#---#--#-------##-##----##--------#-#--#-----#-#--####--##---#----##--#----##----#-###-#####-#---#--
--#--#-#-#-#---#----------#---##-----#---#----#-#####--#---#-----#--#-#--#-#-#-#-#--##-----#-#-#--#-
-#-#------#----#----------#--------#---------##--------#-#-##---------#-#-##-#------###-----#---#-#-
-##--#-#----#--##-######----#---#-#---#-#-#---##---#-----#------#---#----#-#-#-----#---#-------#-#--
#---#-----#----##--#---#-##-##-##--#-##--------#-----#-#-#-#--#---------##--#----##-#--##------####-
---###--#-#--#-#--#-#--#-#-----#----####------#--#---#-###----##-----#---#-##-------#------##--##-#-
#--------##-#-#-####-#-#------#---##-----#-------#-#-##-------##---##---#--#-####-#---------#-#----#
#-----#-#-#---##---#-#--------##-----#---##---------#---##--###-#---#--#-#-#----#--#-###--#---####--
-------------#-##----#---#--------##-##---#-#-#-#-##-------#---#------#-#-#-#-------#------####----#
##---#--#--##-##-#---##--#-#-#---#---##-###--#---#--------#--###-----##------##---#-###--#---#-##---
----##---------#---#---#-#---#--#-#---##--#-------#-#----#-##-----#----#--##----##--------#-----#-##
-------------#-------#-#-#---#---#--#--#-------------####---#---#---#---##-#--------##--###---###---
#-------#---#-#####--------#--#--------#-----#-##----##---#--#-----#---------#-------------#-#-##-#-
------##--###-------#----------#-----#-------###---#---#--##-##-------#-#----#--##------###-#-#-#---
-------#-----------#-#--#--##-------#--#-#---#-------#--#---##--##----#---#--#----#---#----#---#-#--
---------#----##--#-#----###-----#-----#--------------#-####-#-#------##---#--#-----#----#--###--#--
-----##-##-#---#-------#-#---#-----#--------##--##---------##-----#-#---#-#--##-##----##----#---##--
------#--#----#---#-----#-#----#----##-#-#----#---#--##------#--#--------#---#-----#-----------#----
--#-#-----------#-#---#--------#----##----#------#-#-------#--#---#---#--#------#--###---##-#-#--##-
--#----#-#-#--##----##----------#-#---##---#-#-----------------##-#-#-#-----#-#--#-#------##--------
--#------##-----##-##-##-#-------#--------###-#-#---##---#-#---#-#-#-#-##---#-#-----#--#-##-----##--
--##----#-##------#-#-------#--##------#------#------#---#-#-#--##--#--------#--#------------------#
----#-#----------#--#------#-#--#---###---##--#------#--#-----------------##--##-#----------#---#---
-#--#----#--------##-#---#---##--#-#-#------#-###--#-#-#-#-#-#---#-----##---#-###-#---#-#--#----#---
#-#---#---------#--##--###-#-#-##--#--#---##-----#-#--#---#-##--#---#-#---#--#-#---##---#--#-###---#
----#-#-#---#-#---------#--#---##-##----##----#--#--#-#---#--#--##-#---#-#--#--------#--#----#--#-#-
-------####-#--#-----#-----#----##---###---#------#--#-#---------#-#--------#-##--##-#---#----#--#--
#--#--------##-#----###--#-##--#-#--#---####--#--#--##----####-##---#-##--#---#--##--#-#-##--#--#---
#--#--#-##-#------#-#-#-#-#-#-#-----#----#---#-#------------#-##----#------##-#-####---#----##------
--#-#--------#--##----###-#--#---#---------#---#-#----##---#----------#-#--#-##-#-----##-----------#
-##--#-##-#-----#-#-----####---#-----##------#-----#----#-----#-##--#---#-----##-#-##--###----#--#--
#------###--------###----#----####-#-#-#-#----#----#-##-##---#-------#--------#-#--#-#--#-#---#----#
-#--#-##-------------#-#--###-------#####----##-----#--#----#---##-#-##----##--##----#-#-----------#
--#----------#--#--------#-----###-#------------#--##--#----#-#---#----###--#---------------#----#-#
##---#-#-----------##-#---#-#--##------------#-------##--#--#-----------#--#--#----#---##-#-##---#--
------####---#-----#-------------###-#--#----###-------#-------##-#-#-#-##---#------#--------#-----#
--#-###-##---##---#--#--------##----#----#--#-##-#--#----#----#-----###---#---------#--#---#--------
-------##-#----###----#-##--#------###--#-#---#-#-----#---------###-#--------##-###-----#--#-------#
#------#-#--####-#-----#----#-#----##-#--------##--#----##---#-----#-#-#---------#-----##-----------
---#------#-##-##-#--#---#--#--#---#----#----#--#-#####-##-#----#-#------##---#---#------#-#------#-
--#-#-###--#---##----##--#---------#-----#--#-##-#---##------##-#-----#-#------##----#-#-#--#---##--
