-#--#-----##-#--#-----#---#-#----#-------#-#--#-#-------#-------##-#-----#---##----#-#--#---#--#----
-#-#--#--#--#--#--#------#--------#----######---#----##----##-#-#-##------#-#--#-##--#----#--####---
-##-##--------######-----###---#--##-----##--#-###-#-------#---#-#--------#----##----#-------#-----#
---#-#-#-#------#-----#----#-#-##-#---##---#-##----#--#--#####---#-#-##---#----#-#--#-#--###-##-##--
---##---##---------------#---#--------------#--#-------##---#----##-#---#--#----#-##--#--#-------#--
-----#------##-----#---##--------##-#-#---#----#--##-----#-##-####--------------##-#--#---#--#-#----
##-#--###---#-#-#--#---##-------#--#--#--###-##-----#-##-##--#----#----#--##----##-#--#-#----#------
-##-###-------#-#--#-------------####--#-----#-#-##-#------#-#--#------------##--#--#-----#-#---####
--#----#---#-----#-----#---------------#-#-----#---#---#-###--#-##-#-#---#--#----#-#--#--#--#-#-##--
-#--#--#------------------##---####---#-##-#-------##-#----#-------##---#--##---------#----###---#--
-----#----#---------#------#-#------##-##---#----#-----------##-##--###----###---#----#--#-##--#---#
-----#-#-#-----#-#--#-#--#---#-#------#---#------#--#-##----#------#----#-#--##----#-#--#----##--#--
---##----#--##-----##----#-#-#----#-###---#-#-##----#----#--#--#-----#-#-#--------#--##-#-----#---#-
##-----##---------#----#-#-##--#--##-##-#-###---------#-##----#-----###---#-----#--#--------#-----##
-#-##-#-----#---#----##----#-#--#------------#--#-###--#---------#------#-#------#--##---#--#-------
------#--##----#-#-#---------------#-#-#--#-----##--------#-----#----#-----#-#---#-----###---#--#-##
----#-#-----#-#-------#-####-----#-------##----#----#--#-#-#-##--#--#---#--#--------#--#------#-----
-#-----##--#---#-###-##--#-#---#--##-#-###-###--#----#-#-----#---#--#------#-##-#-##--#-------------
---------#----------#--#----##-#####-#----#------##--#-----######-##-#-##--#--#--------#----#-------
#---#------##-#-----#---#---#-##-#-----#----------###------#--#---##---#--#-#-##------#-#--#--#-----
-#-#-----#-----------#-####-#--#-#---#--##----------------#-----#-#-----------#----##-------------##
---#-#--#--#-##---------------#---#-#---#-#--##--#--#--#--###--------#--#--#----###-#-----------##--
#---#-#-##----#--#--###--------------##---##------##-#-#-#------#--##-#-#-----#--##--#---#-##-----#-
#---#--#-#-#----------------##-#-#--#-##--#---#--------##-----------#-----#--##--#-#------#--#-#-#--
#----#-##--#-#----------#-#--##-------#-#-----#-#----####---#------#---##------#-----#--#------#--#-
-#-###----###------#-----###-#--#-#---#--#-----#-##------------###--#--#----##--##--#-##-#----#-----
-#---#-----#-----------#--------###---##-------#---------#-###--##--#-----#------#--#----#--#--#-##-
--#--#-#-#----#----#----#---##-----#-###--#--##-##-------##-#-----###---#-------#-----##-#----#--#--
-------####------#---##-----#-------#--------#-##---#---------#-----#-#-#--#-###-#--##---#-------#--
---##---#-##-#--#--#---#-#-#---#---##--#-----#-#-#----##---------#-#--#--#-#---#--#-------#-#--##---
--#####--##-#-#--##-------#-------#---#--------##----#--#-##----#-#---#-#---#---#---#-#-####---#---#
#---#---##----#----#---#---##------#-#----##--#-#-----##----#--------##----#---###-----##---#--#---#
-##---#-####-#--#-----#-----------------#-----#-#----##------#-----#--##--#--#-##--##--#-----#--#-#-
##------##-##----------##-#--##-#--#-------#--#--#---#-#----#-#---------#--##--#---#--#-#---#-#-#-#-
#--##-------------#---#-##------##-##----------##------#-#--##--#-#-----#----#----#---------------#-
--###-#----#--#--#---#----#-###-#-#--#-----###----#-----------#--------#-----------#-##-#---#-#----#
-#---#-#---------##---#---#----#--#----------#--#---------#----#---#-#---#-#---#--##--#--------#-###
--------#-#-#--#--###-------###----#--###--#----#----------------#---#----#-----#-#---#-#---------#-
-----------###-##-##--#---#-----##--#-#--#--#--###---#---###-----------#---#-#-------##----#-#---#--
#--##--#--#--#---------#-#---#-#------#-#--#---#--##--###-#-#-#---#---#--#-#--#-----#--#---------#--
-#---------#--#--#--#--##-----########----#--------##--#---#--#-##-##--#----##-##----###--------#---
---#------------#------------#--#---#-#--##--#-#---##-###-----#--#-#-#----##----#-----##--##----##--
--##-###----#--###-##-----#----------#---------###---#-##--#------------#-##---#---#-##--#-##-------
----#-----#---##-#------#-#####-#-#-#--#---------------##----##-#-#-------#---###----#-##---------##
---------#----#--#--##--#--#-#---#-#-##----#-##-#--#----#-#---#----##-----#--######------#-----#--##
#--#----#-----##-##-#----####-#---##-----#----###-#--#---------#-#---#-#--##---#--#-------##-----#--
---#----#------#--#-------#-#----#------#---#---#-#----##--S-----#----#---#----#----#-#-##----#-##-#
--#-------####--#-##---##-#-#--##--#---#--#-#----###---#-#-#---##---#--##---#------##----#------###-
-#-----##--#---#-------#---#------#---###------##---#---#--#-#----###-#-----#-#------#-#-##-#-----##
----------###----##---###-----#-###---#--#-##--#------#-----#---#---#---##--#--#-#--##------------#-
--##------#-##--#---#--#----##-###-#----######---#####--#-##-#--##-###---#-##--#-#------#--#----##--
###--##-#-------#----#-##--#---------#---#------##-#-------#---###--#--#-#--#-##---#--#---#-###--#-#
--#--####--##---##----#--##-------#--##--#####------#-#---------##--#---##-----#---##-------#-##-#--
--#-#-##-#----##--#--##--------#------#--#-----###--#---------------###-----#----###---##-#-#---#---
--##-----##---##-----E###------##---#-------#------#-------#------#----#-##-#--##--#--#---#-#----#--
--#--#----#----#--------#-#-#--######---#-----------##---#---#----#--#----#-##-#-----#---####-----#-
#---#-#----##-##--#------#--##--#-#--###---------#-#--###------#---------------------#----##-##-----
#-----#-###-#-----#-----#------#---##------##--------------##---#--##-#-##----#-----------#----#-##-
#----#-#----###--###-#-#--#--###-##---#--#-----##------##-#-#---------#-----##-#-###--#-#-------#--#
#--##-----#------#---#--#-#-##-#-#-------------###------###----##----#-------------#-#--##-----#---#
------------#---#-----#-----#-#-#--#--#----#--#------#--##-##-#--#----##------#--#-##---##--#-------
--#--#------------#---#-#---##-#--#-----------#----------------------#-#--#-##---#-#--#-#------##---
--#---#-#-----#---#--##----#---------##--------##-#-#---------#----#--##--#-------#-----#---#--###-#
-------#---#-#--------#-#-###---------#--###----------###--#-------#----#---#-#--#-----#-#-----#----
#---#----##-##-#-##---#---##---###--#---#---##--##-##-#----#--#-#-####-#-##---------#-#-#-#-#-----#-
#----#-----#----####--------#--###--------#-##------#-#-----##---#----#--#----#----#-----#-#---#----
---------#---#-----#-#-##---##--##--#---#--#--##----#-###---##--#----#-------#------#-#-#---#--###-#
---#--#-##---------#--------#--#---#--------------#-----####------#--#----##-#-#-#------------##-##-
#------##-------#-#--------##-----###--#---#--###-----#--#-##-#-##-#--#-#---#-#---------#---####-#--
-##----#---#------##--###-#--#---#-##-----#-#------##-#----#-#---##--#---#---##-#-------#--##-------
###-##-##-#-------#------#----#----#---#-#-#---#--##--#---#---##---#-#-#--##-#-----#-#--##-#-----##-
-#-#---#--#----#-#------#-----#--#-##-#--###-----#-#####----#------###--#--#--#-#---#---------------
-####-#-----#-----#-###-#--#-----##--#-----#----#--#-----##-#--#-##---#-#--#---#-#-##-#--#-##--#----
##-----#--#-----#--##--------#---###------#----------#-##--#-#-----#------###----##-#-#--#--##------
------#--#------#-----#--------#-#---##-##--#-#---##----------------###---#---#-#--#----##-----#-#--
##---#--#--#-#----#--###---#--#-#---#----##------------#--#-#------#---#---#-#-----##-#-------#----#
#-#--#--#-----#-###--##-#----#---####--#-#--#----#-#--#----#-#-#-#-##------#-#-##--#-----#-#--###-#-
##-#----#----###-#-#------#----##-##-#-#-###-#-----#-##--##--##---#---#---#---##-#---#--------#--#--
-------#-#-----#---#--------------###-##-#--####--###-#-#---#-#-#--#---#-#--#--------#--#-#---##---#
-------------#-#---#---##---#---#---#---#--#-###--###----##---#-----##-#--###--#----------#-#---#---
-##-#---##---###-#-#--#----------#---#-#-----#--#--#---------#-#---#-#----#-#-#--#--#--###--##-##---
###------#---#-#-----####--#--#---##--#-----#---------#-------#--#-#------#----#----###---#-#--#--#-
#--#--#----#-###-----##-####-##-#--------#-#---#-#--###-#--#####---##------------##--#-#------#-----
-#----#-#-##-#--###--###-#----#--###-#----##-#-#-##-#--#----#-#----#---#--#-###--------#-#----#--##-
-##---#-----#----#-##--------------##-----------#--#-----#--#---#--##-###------##--#-##-#--#---#-#-#
--#-#------#---#-------#-##-##--#-#--###-#-#--##---#------##-#---##---###-##----#-###---#------#-###
##-#-##--#------##-##-----------##-#--####---#--#---#----#--------#------#--#----###----#----#----#-
--##--#---#---#-#-##--#-##------#---#--------------#--#-----##--###--#-#--#####-###-###-#-#--###-#--
-####--------#-----#--#-#-#--####-----##--#----#-----#---#---#--#----#--#-#-----#---#--##--##-##-##-
#-##-#-----#-##--#----------###-------#-#-#--#-##--------#------###----#---------#-----###----------
#-#-------##-----#-##-#--#---#---#-#---#-##-##---#-#--------#-#--#-#-#--#-##--##-##---#----#--#-----
--#----------##-##-#-#---#-#-------#----##--#----##------##--#-###----#--#-----------#--------#--#--
--#---#----##-##---------#-##---###-#--#---##---#---##---#####---###-#-------#-----#----------#----#
---#----#---#-----##-#----------##-----##--------------#----------#------#---#---###----#---#--##---
--#----#--#-#-------#------#--##-#-#-#--##-##----#-#----------#-----#----#----#-----#--###-##--#-#-#
-#----##-###---#-#-------#-#--#-----#-----##-#--##---#-###--#-##----##-----#--#---------#-#--------#
---#--#----#-#-####--------##-#-----#--#---#-#----------#-#-#--#--###-#---##-#-##--#-#--------#-#--#
#-------#--#-------#--#-----------#--------###----##-##----##--#--#--##-#-#-#-#--##--#---#----#--##-
##------------#-----------#-#------##---##-#---#-----##---##----#----#---------#-#--#-#--##-##----##
-##-#---#---###-#---#--#---#---#----#-#---------------------#--#----#-#-----##-#-----#-#-###-----#--
