--#---##-#--------#-#---#-----#---##----##-##--#---#----#---##------#--###--#-##---------#---#--#---
#-#-##----#-#--#---#--#-#-----###-------#-----#--#--------#----------#---#-##------#--#--#-#---#----
##---##--------#---#---##--------#-----###----##--#------#-#-#-----#-------#-#--##-----#---#####----
#------#------###---##-----#-----#####-#--#--#------#--###---##--#-##---##----#--#---------#-#------
-------#-##-------#-------##----#-#-##-#--#---------#----#--#-##---#-------##-----#-------#-#-------
-#--#---#--#--#-#-#####--###---#---#----#-------------###--##------####-#---##---#-####-----#--#----
------#-#-#-#-#-----#-#-#--###-------------#--#--------------#----####------#-#--##------#---#-####-
--####------##--######---##-------#--#-#-#--#-#-----##--#--##------------#---####-#-------#---#--#--
#--#---#-S---#--------#----#-##-#--##-#---------##-----#----------#-#--#-###-#-#-------#-#-----#--##
--#--#-----#--##---#-------##----#-#-------#---#--#-###---#-#------###-#----#-#--------#-#--#----#--
-##--#--#------##-#-----#--####-----##-#-#--------##----------###---------#-------------#---#-#-#---
----#-------###-#------##-#---#--#---------#--#----#----####--------#----#-#-#----#-----#-#--#---###
-#-#--#----#-#--##------#-#-##-----####---------##----------#---#--------#---#---##-#------#--------
-##-#-#----#--#-#-#-----#--#--------#--#----##-#-----#--#-##----##-#-#--------####-#-#-#--#-#--#----
-----#--#----##-#--------#----#---#-------##-------#----#--------##-#----##-----###----#---#---#----
------##---------####-#---#----#--#---#--#-#-#--#####-#---#-----#--#-------###--#-#------##--#-#----
###--##-#---#---##--#--#--#-#--#-#----#--#------#-##----#-#--#-#----#----#-##------#-##--#----##-#--
#----#---##-----##----#---#-#-----#-#-#--#-#---##-#---#---#-#--#-##-#----#-#----##------###----#---#
-----#--------#-#-----##--#####-----###---#-###-##--##----##-#----#----------##-#-##--##-#--###-#---
---#-----#-----#-#------------------------#-------#-#--#-#--##--#-#--#---#-------###-##----#---#-#-#
-#--#-#----#----#-----#-###----#--##--------###--------##-----#-------####--#--#-#--#-#--#--#---###-
-#-#--#--##-##-----##-####------#--##--#------#-#---##-##---##-----------#-##--#-#--##---#----------
---#-----#--#----#-#------#-----#----##--#-----#---##--#-#--#----#--###-#----##-#---------------##--
-----------#----#---#----#--##---#---#--------#-#---#####-#-#-#-#-##-##---#---#--###------#----##--#
----#----##-#-##-#--#-----#--#-#-------------------##--#---#-----##---#-----##-#--###-#-#----##--#-#
#----##----###-------#-----###--#---###-##--#-##--##--#----------#-#----#---###--#--##-#------##----
#-#-----#-----#-#--#--###------#---##------#---#-#--------#----#------#---------##---#-------#---#-#
------#-#-#--#--#-----##--#----#-###---#-------------##-#-##----#--#--------#--#------#----#-####--#
-------##--#--#-#-------#----#--#-##-#-------#--------------####------###-#-----##--##-#----#-------
##-#--##---#----#-#-#-#-----------#--#-----#-----##-----##-##-#---##-###--###----#---------#--------
--#---#----###-#---#-#-##---##------#------#--#-----#--#-------#------##--##----##---#--#--#-#--##-#
-#----##-----##---------#-##--#-##---------#---#----#----#--#--#------------#-#-#----##-#--##-----#-
-#---#---------##---#--#--#-###--#-----#---#---------#--#-#---#---#-#-#---#---#-###------------###--
--##-------##-#-#--##--##-##-#-----#------#-#-#-#--#-###----#--##--#-----##----------##---#-------#-
##----#-------#-----#-#--#---#--##-#---#-#----#--------##-#-----#-#--#--##-#----#-#--#--##--####----
#-##-#---#-#----------##----#-----##------##---#------#----------#-#----#--#-----#-#---#------------
-##---#--#-##---#----#-----#------#---------#-#-------#--#-##-#-#--#--#---#-#-###-#--------#----##-#
--#----#-##-#---##-#------#-----#--#-#--#-#---#-##-#--#------------------#--#-#---#-#----#--------##
-----#---##---#---#------#-#------###--#--#-----E##-#--###-----###----#---#-##---#------#-#-#-#--#--
#----#-##-##------#---#--#-#---#------#-#--#------#-#--#---##------------##-----------#-#--#-#------
##---#---##--#--#--#--##--#-###-----#-----#--#--#-#--#--#-#---#--###--###-#-##----#-#-#-#--#-##----#
---##--#-#-#-##--#--#--##--#--#----#--#-------------##-##----##--##---#---#-##-#-#-#-----##------##-
-#-#--##---#-##---------##---##---##----#-----#-#--#--------##-#-#--#-----#--#-#--#-#-#------#---#-#
#----#-#-##-##-------#-###-##-----#-#-#----####--##-----#--#-##--#-#------##---#-#-#--#-#-----#--###
-#----##-##-##-#-#--##--#------#--#-##-##-#-#---------##--###-#-----#-##----#---#-#--#-#---##---##--
-#--###---#--#------#------#-##-#--------#-----#--#--####--##----#--#-#----#-#----#------------#---#
#----##--#---#--#--#--#--##---#-##--####-##---------#-#-#----#----##--#-----#-------#-###---#-------
#----#--#-##-#----##-#----#--------------#-##------#-##---#----#------#-#------#-##---#----#----#---
--#---##-#--####--##----#----#---#---------#--#-#-##-###--#-#----#----#------##-#--#---#----#--#-##-
##-#---#---#####--#--------##----##--#-###-####---#-#---##-#--#--#------------##----#--#------##--#-
-----#-##--#--#----#-#-###-#--------------##--##---------##--#----#-##--#-#--#---#-#--#------#-#---#
#####--#---##----#-------------#-----##--##-#-#--##-#---#---#-#-##--#--#--------------#-#-##--#-#---
#----#-###----##--#--#--#-####--#--######-#-#-#---#----#--##----#-----#--------##----#---####---#--#
#---#---#---#-#-#--##--###---#-#---#--##-#-----###-#-##---##--###--------#----#-#-#---###-----------
------#-##-----##-#-#--#---##--#-------------###-##--#----#-#-----#-----#-##----------#--#---#------
#-#-#-#-#-###-#--#--##---##-#---#-##-#------#-#-##---###---#-----#-#-#----###-------###----------#--
------------#-------##------#######---#------#-#---##--------------------##---##-------#-----###--##
-##-------------------##-#--#-------##----#----#-##--#-#-#---------#--------##------#-####--##--#--#
#----##----##-##--------------#---------#---#----#-#--#-#-#----##----##----#-------##--###---##-##-#
##---------#-###---#-#---#-##------##-##-#-#-----#------##----##--##-##-##-----#---###---#---#---#--
---------####--#--#--#---##---#-#--#--------##-#---------#-##-#---#-#-----#--#---#-##--------#---#--
--##--------#----------------##-#-#-#-----##---#-#-#-#----###-##------#-#--#-#-------##---#----###--
-#--------#------------#---##-------#----#-#------##----#---#--####------#---#-------#----#--##-#---
-#-#--------#------#----##-####-#-#-##----##--------#-#-#-##----#---#-#--#----#----#---#---#----#---
--##-#-#-#---##--#---###--#--#--#-#--###--------#-------------#-#---#--------#--------#-#-#---#----#
-###--#--#-#-------#--##--#####-#--#-----#-#--#--#--------#-------------------##---------#------##-#
###----------#---------#-###-----##-##----#-------#--#----#------------####--#-#-----#-----#---#-#--
-##-#--#-#-----#---#----------#--#-#--#--##-----#---#---#-----###--#-#-#-----##-##-#--#----#-#------
-----#-#-#-#--#---#--#---------#-------#----###--##-----#-#--##-----#-#-----#---#-#----#-#--#-##----
-##--#---------#------#-#------##-#-#-----#--#----#-###---#---##-##------------##--#-#--#-------###-
------##-##--##--##---#-###--##--##--#------##-##-----##-#-#-----#-#--##-#--#---#--#-----##-#--####-
#---------##--###-----##-#--#--##---------------###-#-#--##--#-####--#----#-----##-##--#####----#---
------##-----------#-#-##---#-----#--------------##--------##-#-##-#--------#-----#--#----#------##-
#-#-#--##---#---#-#-#---#-------#-------------#--##----------#----##-------#--##-###---#-----#-##---
#--#--------##---##--#-----------#----#-#----##-#-#----##--#--##-##-------#-----------------#--##---
----##--#-#------#-----#----#----##-#---#--##---#----#---#-##------#---##-#--#----------#-###-#-#--#
-#-#-#----#--#-------##-------#---##-##-#-----#-----##-----#---------#----##-#--###----#---#----###-
------#--##--#--#--#-#--#-----#-##-##-##--#-#------##-#-----#-#---#-##--#----#------------####----#-
#---#--#-##----------#--#-##-----#--------#-#-##--#-#--#---#---#---##--#-##-####-----##-#----##-----
------#-#--------####--#--#--#-###-------#--#-#-#--##-------------#-#-----#-#--#-----#----#-----#-#-
#--#-#------###--#-##-##-#-##--#----#-##-#--####-----#---##-#---###---##--------#--##-##--###-#----#
#---------##-#--------#---#---#----#-----#-----------#---#-#-------####-##-#---#--##-##---##-----###
----#-#-##-##----#----#-##-----#---#-#-#--#--#---##--#-#--###-#-------#-##----------#----#--#--#-###
------#-------##--------#-----#-#--#--##-##---##--#----#-#-------#-#----#-#-##--##-----#--#-----##--
-----------#-----##-#------#---#-#-##--#-#---#--##---##---#---#--###--#-#-----#----#-----##-----#-##
----------#-------####-----#-------##--#--------#--#---------#-----##--#----##--#-#--#---#-##------#
----#--#----#-##---####-#-----#-#----------#-#----#---#-#----##------##--#------##----#-#-----#--###
-----#----#-#--#####--##---#--#---#---##----#-##---#----###-###-#-#--#---#----------##--------------
------#--------##---------###-#---#------##-------#----#-##--#-#---#----#-------##--------#---------
#-----------#---------#----##--##----##----#--#-##-##-##-------#---#------#------------#-#--###--##-
#-#--#--#---#-----#--#---#-###--#--#--#----#--#-##-#--#-----#-----###-#####-------#-#----##--#---#--
-#-#-#--#---------#---------#-#------#-##-#-------#-##-------#---##-##----#---#-#-#-----#-#----#----
---------------##-#-##---#----#------#-##-----#-####--#######-#-##--------------#--------#--##---#-#
---------#----------##-----###--##--###---#---##-#--#----##-#--#---#-#----#------##-#-------#-------
---#----##--##-#--#--##--##---#--#-----#-----##----#--#-#----##-#---------#-#-#--#--------#---##-#-#
#--##-##----#--###---#------#-------#-#------##----#--#-#--#-----#-----#---##---#---###--#----#-##-#
-#-----##--#--##----#---##------#----##----#---##---##---##---#----#------#--#-----#---#--#--#-##-#-
##-----##----#--#-----##----#####--###---#---#--#-#---#-#----#--#----##-###---#--------#--#-#-------
-#----#-##---#---#---#----#----#---#-------#---#-#----###---#-#-##------#-----#-##-##-----------#---
#------#--#------#-#--##----#---##-#--#--#--#--##--#----###-----#-------###-#------#-#---#-##----#--
