##----#---#---#--#-##-#-----#---#--------#-###--------##-#--#-----#-----###-###-#----##-##---------#
-----#--#-#-####-#--#-----#--#-##------#---#-#---#--#------#-#-#-###------###-----#-#--#----------#-
--#---#---#----#-#--#-###---##--#----#--##-#--#------#-------#--#--#--####-###-----#-#-----##----###
-----##---#--#----------------#-#-#-##-#----#--#-#-#----##----##-#--#-----------###--#--#-#----##---
#-##-#---#---#---#----#---#---###-#----##---#--#---#---#---###----------##------------#-----#----##-
--####----##---#-#---#-##-#-------#----#-#--#-----##------#---####--#-##---#----#---#--#-#-----##---
#---------#-#-----#----#----#----#--##-------#-#--#-#----#--#---#--#---##----###--------##---#----#-
---###--#-##--#-##----###---#--#------#--------#--------#-----#####----------#--#--#----#------#-#-#
#---#---#--##--##--##-------#------#---#------#---------#-#-#---#---##-#---#--##-#-#---#-#-----#--#-
##-#-#-------#----#--------###---###---#-------###-----#-##--#-----#-#---#------#-----#----#---##--#
-------##------#--#--###-----##--#-#-#----##-#-##-----#-#-#-#----##-----##-###-##-#--##-#-#-#--#--#-
#--#-###---##-##-####--------#-###-----#-------------#--##--#---#--#------##-#--------#---#--------#
------##-#------#---#--#-----##---#-----#-#--#--#-#----##------#--#--#-#-##-#-----#-##--#-##-----#-#
##--##------#-#----#-#----##-#-------#-#--#---#-#-##----##-----###-#-#----#-------#-----#-----------
#-#-----#--------#------#----#-##--------#------#-----#---------#-#---#-------------------##--------
#-------#--##-#-##--#-----#-#---##-##--###---#----#--#--------#----#--##------#---###-##-----#-####-
-##-#---###-------##--#-##------#-##---#---#-#--------#-#---##----#-#-#--#-#-----#-#--#--##-----#---
-##------#----#-#-----#--------##--####-#-#-#--##---#----#------##--#----#---#----#--#---#-####-#-##
#-#---##------##---------###-----------#--#-#--##-------####-#-#-#####-#-#--#---#---------#-------#-
#-----#--#-----##-#------#-----#--#---------##---##-#---#--##---------###--######------#-----#--#-#-
--#----#-----#----##----##--#----#--###-----#--#--##-#-#-#-#---##--#####--###-##----#-#-###--------#
-----##-###----#--##-----##----#----##--#--##--#--#----#--#-##-###--#------------#-------##-----#--#
----##-##--#--#-##--###---#-----#---#-#-##-#-#---#--##----------#---#------#--#-#-#------#-##-------
##--##-----#-#-#--#-##---#-#-----##--#-##--#--##-#---#----------------##----#--#-#--#--#------##-#--
------###-#-##-#-#------##-------#-#--#--##-#-#---#--#---##--#--##-###--####-----#-#----#-##-#--#---
#--#-#---##--#-#-----#----#--###--#-#---#-----#--#---#-----#---##--#------#--#---#-#---##----#--#---
--#--#-##--------#---###------#----#-#---#------##-----##-##-#-#--#--#---#---#----#-#-#-##-#-###--#-
--#-#-##-#----------#-###--#-------#--#---#-#-----##-#----#---####-#---------##-##----#-------------
--#---#--##-----##--------#-#-----------###-----#--#-#-#---###-#-------#-----#-----#-#----------#-#-
--------###--#-#----#-----#---#---##---##----##-#--------------##-#---#-#----#----#---#--##---#--#--
-#----##-#-#-#--#--##-#-------#---###-#-----#---------#---#-----------#-#------#-##---#------#----#-
-#--#--#-----------##--###-#------#-#---###-#--#---#---###----##-##-#------#--#--####--#---##-----##
#----------#--------E-----#----##---#--##---#--###---#----#----#---#----#--#--###-#-#--####---###---
-----##---###----#-#---#-#-#-##----#-----#-#--#---------#--##--#------------#####-#-#-#--##-----#---
---#------#--#-#-#---##-#-#--#----#---------##--##-##------------#---#----##-#---#--#---#--#-----#--
#------#------------##-#-#--#----------##---#--#--#----#-#-----##--##-###-##--#----#-#-#--##---#-#--
--#----#---------#--#-#----#-----#-----#--#-#--------##--#---#--##-#--#----------#-----#--##--------
---##---#--#-#-----#--#--#--#-----###-#--#-##-------------#---#-------#---#-#--##--#--##----#--#--##
---#----#-----#---##-#--#--#-----#---#-----#----#--#--###-------#----#--#---##--#----------##-#-#---
---##---#---##-------#--##--#-#----------------#---#------------#-#-###-------#---#---#--#--------#-
---#-------#----##--#--#------##-#-#---#-#-#-#----#---##------------#----#--#----------------------#
-----#--##-#--------#-#-#-#-#------##---#--#-#----##-#--#-#-----#--##-#--#-##----#-#--###----###----
#-----#--#----#-#-#--##--##--#---##-#-#--#--#---#-#-#---###--#------##--#---#-#---#-#--##-#-##------
-#-#-##-##-#---#--#---#------#---#---------#-#------#-----#####----###-#----##--------###--#---###--
----------##------#--#----#---#--#-###---#-##---####--###-##--##-------#------------##-#---#-#-----#
-#-----##--#---##----#--------#--#--------#--#-------#--#-####-##-------------##---------#---------#
#--##-----#-##-----###--##-##-------#--###-##--#-#####-#--#-##----#-##--##--#-#--##--#--#----##-#-##
#---##-##---#-#---#####-#-----#--####---#--##-##---#-------##--#---###-----#--#-#--####----#-#-##---
--#-----##-----------#-#-----#-#--#-##-#------#-------------#-##-#-#-#--#-------#-##---#--#-----#---
----#---#-----##-----###----#-##---##-#--------##-#---#--------#----------#----------#-#--#--###-###
----#--------------------###-#--#----------#--#--#---##-----#--------###--#----#--#------#---#--#---
------------##------###-#----#-----#-#----#-##---#--###-#-------##--#------#----#----#-#--##----#--#
----------#---#---##--#-----##-##-----##-#------#--#-###-#--#-#---#---------##-#--##-#--#--##--#---#
##------#---#-----#-##---#----#-#-#-#-#-#-#-###-#-####-#----##---------##-----#----#--#---------#--#
---------#----#------#-------#-#-#-##-#--#--#----#-#---#--#----#--#--#--#-#---#-#----#---#-#-----#--
#--#-#--##------#---#-#----##-#---##-#----#-----##--#--###-#--##-#-------##-#-----##---##--#-#-#----
-#-#------##--#----##-#---##-####------#----#--#-----##-####----##-##-#--#-----#-###-----#--#-#-----
##---#-#---###-#--#--##----###--------#----------#------##--#---#--#--#---#-##---------#-----#-#-#-#
---####-#-#----#-##-----##--#--#-#--##----##--#---#----####--------#-##----#---#-######---#--#--##-#
-#-#-#------##----#------------##-#-#--#-------#-###--##-#---##-#---#-##---#--#-----#---#----##---##
#--------##-------#-----------------#--------#--#----##---#####--#--------------#--#-#--##---##-#---
------#----#--------#--##--#---##------##-----##-#-----#--#-----#-#---#------#---------#----#-#-----
----#-#--#-----#-----#--#---#---##-#--#---------#----#--#-#---#-----#--#-----------#-#----#-----#---
----##----##-------#---####---##--#-##-----###---##--#--------##-#-##-#----#---##----##-----#---#--#
-#-##---##---##-##-#-#------###-#--#---#--###----#-#--#---------##-----------##--#--#--#---##-#-#---
-------#-----#-#--###--#-------#--------##------###--#-##--#--#-#-------##-##---###----#----------##
#------#--#----#---##------##-###-#----#---#---------##--#---#-#---##--#-#----#--------###--#--#-#--
----###--#---##---##--##--###-#------##--#-#-----#--###-#---###------#----------#---#-#----#-##-----
#--#---#--#---#--##-#-###--##--#----#-#---------#--#-#---#------------------###-#-------#---#-------
---#-#--------#-##--#-#-#-#-----#------#-##--------#--------------#--#-#--------#---##-##--##---#---
--##--##--------###-----#-#----##-#--#-------##-----#----#--#-#---#----#---##----#--#--#-###--#--#--
------#-#-###-#--#-----#----#-----#--------##-------------#--##-#------##---##--------#-------#-----
--------##----##------#--#---#-----#--#----#----#-----##---#--##--#----#-#--#-----#--#---#-##--##--#
---#--------#--#---#--#--#-#----###-#-#----#-#-------#---##---------#---##--#--#-#--###-----#-##----
-#-#---#-------##-#----#-#---------#---#----------#------##----#-###-----#------#-######-------#-#-#
-----##--#------#--###------#---#----#-----#------#---#----#--#-------###--#---#-###-#--#--#---#-###
---------#-----#-----##-------###--#----#-#--##----#----#-#--#-##-##------#--##--#---#-#---#--#----#
--#-#--##--#-#------##-----##-#--#--#----#----#----##-###--#---------#---##---#---##-#----#---###-#-
------##-----#-----###----#---#-----------#-#---#--#--###----#-#----#---#-##-#-#---#--##-----##-----
-#--#------S-####-#--#-##-#--#----#------#-----#----####----------#--------------###-----#-----#----
---#-#---##-----#--#---#---##--#--#-----#---#--#--#--#-#-#----#-#-#-##----#----#----------#--------#
---##--#-#-------#--#-#-#-##-#------------#---------#--#--#--------------##-#---#-##---##-##---##--#
------##-------#-#----#--######-#-#---##--#--#-##---#--##--##------###--#--#--------#--#-#####-##---
#-#----##----#----#####---#------#-##----------###-#-------#-###---#----####--#----###-###----------
#-##----#-#-##-----#---------#----#-#----#-----#-#----#---#--#---#------##--###-##-------#----#----#
--##-#---#---##----#-----###-#--#-#-##--#--#-----##---#-----#-#--------##--#----#--#-#--#--##----#--
#--#---#---#---#---#-----#----#----#---##-##----------##----#-##-#--#-#---#-----#---###-##------#--#
##---#--------##--#-#----##------------#-##--#------###----#-##----#-#-----#--##-###-----#-----#----
--#-----#---#-----#-#----#---#--------#--#-----#--#----#---#-------#----------#---#-#----#--#-#--#-#
--#----##---#---------#--#-#-----#--#---#--#---#--#----#--#-#-#-----#-------##-#--#-###------#------
---#----#---#-##-#-##-###--#----#---###------####-#####----#-----#--#---##-#----------#-----##-#-##-
---#-#-##-#-#------##----#-------#-#--#--##-##--##----#--#------#-#---#---##-#-------##-----#-#-----
###-#--------#---##-#-------#--#--#---#-#-------#----#-#----------#---#---#--#####--#---#-----------
---##---####--##--#-#--#--##--#-#####-----#--#-##-##-###----##-#-------#----#--##------#-----##--##-
--#-----##--#-###---#--#---#----#-#----------#-##-------##------#-#----#-#--###----#-----#---------#
-------#----##--------------#-##-----#--##----##---####--------##--#--#--##-##--#--------###--####-#
-##-----###--#-#--##-##--#-#--#-------###----###---#--#-#-#-#--------#-#-##-##---#---##-#-###-#----#
--#-#---------#-#-#-----#---##-#-##-#----#------#-#-----##---#---#--#--------##-#--##------------#-#
-##---#----#--#-------#-----------#---#--#--##----------------#--#---#------###-#-----##-#---#-#--##
-----#--##-#-#--------#----#----###----###-------#---#---#--------#-#----#---###-#--#---####-#-#--#-
