#-#-#---#-###--#-----#-#---#--#--#-----#----#--#-#-#-###----#---##-###-##---#----#-#-#-#---#-#----##
-----##--#--#-##---#----#-##--#---#--------#---##----#-###---#-#--------#--------#--#--------##-##--
-#--#---#-#----#----#-####-##-#--##-----##-#----#-#-----#-#--------##-------#---#-###-#-#-----------
--#--#-#---#---#----##-#---#---#-#----#----##---##---#-#--#-#-#---#---#--------##--#---#---##-#-#---
---#-##-#-----#----#--#-----##-----##---##-##---#---#---#-#-#-##------##--#-#--#--------#-##------#-
--#--#----------#--#---#--------#-##------#--##--#-###--#--#--####----##---------#--#--#-##-##------
-----#------#-#---#--##-##---#-#-----##-----##---#-##-#------#-#------------#------#####--#---------
--###---##--#-----##--#-#-#--#-#---#---#-----#-#-----#--#-##--------------#-###--#-----##-#---#-----
----###---###-------#--------#---##------##---##---#--#----#-----------##-----#--#-#-----#---##-#---
--#--##---#--#------#--#-#----------------##---#--#-#-##-#----##-#--##-----#--#-#-###-#----#---#---#
##-------#--#-----#--#------#--###-#-#-#-##---##-#-#----#----#--#------#------#-##--------#---------
-----#-----------#---#-##-#-#-#-#-#----#----##--#--##---#-#-----#---#----###-#--###-#----#-#-#----##
------###-----#-----#-------#-#-----##-#--###--#------#----------##-#-##-###----------##---#--------
------#------------##----#---#------#---###--##--#-------#-##--#-#--###----#---#------##---#-##-#---
---###-####---##---#--#---------##---#-----#-----------------##-#-----##--------#-#-#--------##----#
#--------#----#----#--#-###--#--##----##---#--#--#---#--#----##-#---###---#--##----#----#-#--###-#-#
###---#------------#-##---#-----#-----#----#---#-##----##----####----#####-----#-----------#--#-----
------#----------------#--##-#--#-----###-----#-####---#--#-----##----#-#---#-------####--#--------#
#-------#----#--#--#----#-##---##------#---##---------#-#---##-----------#------------------##-----#
--####--#--#--------------#------------#----#-##-###--###---#----#-#------####--#-#---#----#---#-#-#
--###---##---#-#----#-#-#---#---###----##------###-##-##-###-#-#-----#---#-#-#-####----#-#-##-------
-##-#-----#---#-#--#-##---#--#-#--#--#------#--#-#--##----------#-----###-###----#-#---#--#--###----
-----#--###--###--##-#-----#-#---#-#--#-----#-#--###------------#---------#-----##-##--#---------#--
##--#-#----------#-##--##-#----#-#------##----------####--#--#-----#--#-#-#-#-----#-----#---###-#---
##-####-----#--#-----#--#----##-#-#--#--#-----------------##--##----#------#-#--##-##-##--#--#--#---
-#-###-#-#--#-##-----#---##-#---####---##----#--###----#------##--#-------#--------#--------##--#-##
#--##--------#-##------#--#-##-#-##---#-#-##--#----#----#-#--##-#---#---#--#----#-----#---#----#----
--##---#--#------#-------#--------####-----#---#----#-#-#-#-##----#---#---#-----#-------------#----#
---#-##-#------#--#----#-#-####--##------#-##-----####-#----####-#---------#---#-#----------#-#---#-
#--#--------#--#---###-#--##-------##-###---###------#-#-##---##-#--##-#-#-#---#--------###-#---#-##
--#-#--#---#-###--------------------#-#--##-------#-#------#####-###-##-----#--#-----------#--#-----
-#--##---#-#--#-##--#-#--#----#---####--#--##----#------##-#----------#-#-#-#----#--------#--##-##-#
--#--------#-#-----#-##--#-----#---#---#--##---#-#-----------#-#-------#--##-#-----##-#---##---#-#--
-#---###-------##--#--#---#-#---#---#-------#----#----#--#---##---#---#--###---#-#-###--#-###-###-##
----#------#---------#-#-#------#----#-#-##-------#--------#---##-----------#------#####----##-#-#-#
-#-####----##-#---#--##----#-##--#------##---#-------------##--#---#--##--##-----#--#--#-------#----
#------##---#--#-#--------#---##---###----#--##---####--#---#####--#--##-#-----#-------##-----------
-----#------#-#---#---#--------#-#-##---#------#-#--#--------#-------#---#----#-##--------##-----#-#
---#---#--#-###-------##--------#--#---#-----##--#---#-#-##---#-###-#----##---------------#-----#--#
-#---#---#--#-#--------#----#-------#--#--##--#----------##----##---##---#------#--#-#----#-#---##--
---##-#-#######-#---#---------#--##----##---#-#-----#-#--#--##---#--#--#-----#----#-----#-#--#--###-
-----#---#-#--------------#-#----#----#----#-----#-------####---##-#-#--#-#---------##---#-#----#-#-
----#----#--#------###--#-##--------#----##-##--#--#-#-#--##--#------#--#-##---####-#----#----#-----
-#-##---#-#----#---##--#----#--#-#-------#-----####---#-#--#---#-----------#-#-#-##-----##-#-##-#---
------#----#------#--#--#--------##--#---#-#----#--#-#------#-----#--###--#--###-----#---##---#-#---
--##--#--#----#-#--#--#-----------#-----##-------#--#----#-----#--#---#------#--#--##-##-##-----#---
#-------#--#--#----##-#-##--#----------#----------#---#---##-#----#---#---##--##-----#--#----------#
-#-##------#---#--#----------##-#-#-----###-####-#---##--#----#-##----##--------#---#--#------------
-#-#-#-#####---#-#----------#---####-----#--------##-------###-##-#--###--#--------#-----#--###--###
-----###----#---#-#-#-----#-#-#--#----#-#--#----###S-#--####--#--#--#--#--#--#--------###----#-----#
-#-----------##----#------##-#-----#-------##-##--------##-#----#---------#-------#-----#--#---##--#
-----------------##---#--###-----##--#---###----#--#-----#-#-------#-#-#-#--##-----###--------------
##-----###-##---#--#--##--##---#-------#-------#---#-##--###-#------#------##--#------#--##-#-------
#--##------#------#-##-#--#--#-#-#---#--#--#---#------###----##--#----------##---#--#--##----#-#----
#---------##-#-##--#-##--####--##-----#--#--#--#------#--##-------#--#--#---####-#--##-#-##--##-----
---#-#---#--#--#---#--###---#-#--#-------------------#--####---#-#--#----#--#--#-------#-#---##--##-
#--#---#--##--------#---#---#---##--#--##-#---#---##--##-##----#-#--##---###--##-######-----##------
---###-#-#---#-----#--#-----#-###-#-#-###----##-------#--#-#-#--#--#--##----------#-----#-##----#-#-
---------------##---##--#------#--#----#####----#-----#-#--#-####--#-#-#---##---#--#-------#----###-
--#----#------##--###----------------#----------#---------####--------#--#-#--####-----##------##---
----##---##---#---#--#--#-###-----------##-----#---##---#-#--#-----#-#--------#---#-#------#--------
#-#------#---##----#--###-#-#-#-#--#--#-##-----#----#--#-#------#--#--#---#---------#------#-------#
#-#--#---##---##--#---##---------------#-----#-#-------##--#-##---#---#--#-------##--#------#---##--
#-#----#-----###---##--#------#-##------###----#--#----##-#-----#---#---#--###-----#-#----##----#-#-
-#-----#----#----#----#-#-#----#-----##--#--------##---#---#--#--#-#---##--#----------#----#-#------
-##-###-##--#------#----#####-#-----###---#-##-------#--#-#--------#--#--#--##--#---##-----####-#-##
----#---#---#--#-##--------------#---#-##-----#-#-------#-#-------##--#--#---------####-----####-#--
--##-#-#-----------------###---#-##---##-#-#-#-#---#------#--------#----#-#-##-#-----##----#-------#
--------###---#-----#-#------#-#-#--###--##-####-#--#------#-------#-#-#----#---#-#-#-##---#-#-#--##
--##----#--#--#----#-##----#-#---#---##-----###---#---#--#---##--#--#----#-####-##-#--#--#-#--------
-#--#-###------#--##-#-#-------#-#---#-#-#--###-#----#-#-#-#-#---#---#----#--#---#-#-----##-##-#----
#####--------#-----#--##---#---###----#-#-#-###---##--#-####----#-#----#----------####-#--#--------#
###--#-###----##----###-##-#--#--#-------#----##---------##-------#-#-#--#----------#------#-##--#--
-#--#-----#---#--####-#----#-##--###--#-##-#-------#---#---#-##--##--#-###--#----#---##--#---#------
#---#-###-#-##-#-#--##-------#---------#-###--------#---------------##-#---#--#-#-#-##-#----#-------
-#----#-#--#---------#---###---##-#-------#---#--------#---#---#--------------#--##------#-------###
------#--#-####-------##-------#------#-#--#------#-------###--#-#----#---#----#---#---------#-#-#-#
#--##-####--#-#--#--#---#-#--##-#####-#-#------##--##-##--##-----#------------#----#--#--#--#----#--
--#-#------#---#-#----#--#--#----#------###-#--#---#-##-#---#-###---#-##--------##----##--#---#-----
---##--------##-#---##-#---------#--#-#-###---#-------#---#---#-####--#----#--###-###--##---#---##--
-##------###-#----##-#-###-#-##--#-###-##-#####---#-##-#-----#-#-#--#--------#-##--#---##--#------#-
---#-##--#----#####-#-#-#-###--#---#---#-##---#-----#-#-------#--------#--##---#-#--##---#-#------##
---#--#-#---#---#-##-#-#------#--#----#--#-#-----##----##-#-#-##---#---#--#--#----##-#--#------#----
-##----##-#--#-#--#-#---###--#-##--#---#---##-------#--------##---#---##-#-#--#------#--#-#--------#
#-#-##-----#----##--##-#-------------#-------#-#---#------##----#----##-#-##----#--#---------#----##
---#--#-#-----------------#----#-#-#---------------#-#-----------##--#-------#-#-#---#---#--#-#---##
-##----##-----------#----------#----#-------####-#-#--#-#----#------#-------#--##---##---#---######-
#----------#--###---------------#-#-###-----#-#--###---#----#------###-----#-##--#------#---#-#-#--#
-#--#-#--##-#-#-----#-#-#-------#----#-#-#------#--#-----#-----#-#-#--####------##--#------###------
#---#--##----------######--###--------#--#----------#-#---#-#--#-#-----#-##-----------#---#---------
-----#----------#--#--##-----##-----#----##--#-#---#-#---###-#-#---#-----#######--##-#---------#----
-#----##-#---#-----##-------#--------#--#-#--------##------##---#----------#------##------#-#----#--
-#----#------##--#-----#-------#--#-------##--#---#------#---#--#-#-#--####---#-#--###-------#-#--#-
#--#----------#--##---#--##----#-#-#-----#---#--##-----#-------#--#--#-##----------#---#-#-#--------
#-#----------#----#------#-----#----#---#--#-#----#-#-------##--#---#--#------------##----##--###---
-#-----#---#--##--##--#-#-----#-------##--##----------#--#-----------#--#----------##--##-#-#-#-#--#
-----------#----#-#-------#-------###----##------#-----#---##-------------#-------##--#--#---#---###
--#---#-##----#------#--##-####-#---#-----#-#--#-#-###-##-------#--#-#---#------#--------#-#-#--####
-----#--#-##-#--#-----#---####-###----#------##-E-#--#-------#---#-#------###--#-#-#-#--#-------##-#
##-####----#-#---#-#-#---#--#-##----####-##------#-------------#---#-----#-#----#-#-#--##--#-----#--
