-#-##----##-##--#--#-----#---#----#---#---#-#---#-##---#-#-#----#------------#---------###-###------
#------##-#---#-#---#-##-#-#-----#-----------###---#----#-#---#--#-##---#-##-#--#-###-#--#-----#---#
#--------#--#####-##----#-----#-##-#-#------------####-###----#---#-----#-##-###-#---#--#-------#---
-----#-#-------#-#--#----##-----------#-###---#--#-#-#-----#-#-----#------#-##-##--#-#-##-###------#
###--#----#--##---##------#--#------#-#------------------##---##--------#-###-#--#-#--#--###------##
----###-##-##-#--#---#--#-##--##--------###--#--#-------#--###-##----#--##-----------#--------##-#--
-##-#-#-----------#####----###-##-----#--##-##-#--#--#--####-----##--#-###----###---------#-#---####
-----#-#-#------------##----#-##---#--##----#------###--#-#--------#------------###--##-#---####--#-
------#--------###--------###---------------#--------#-##--------#-#-#---#-#-#-#-#-#--#--##--#--##--
#------##---##--#-#---#---###----##-####--#-----#-#-#-#--##-##------#---------#---#--#-##-#----#--#-
-------#-----##-#----#------------#---#---#--#----#-##-##--#------###-#--------###-------#-#####--##
-#-#--##--#-##-#--#-#---#-----#---#------#-----#--#--#--#-#--#--#-#--#-#-#-#---##-------------------
###-##---#--#-----------#---#--#-----#--##-------#----##-#--#-#-#-###------#--#-##-----#--------##--
-----##-----##--------#--#---#---##---#--#---#----#-----#-----------#----#-------##--#-#-----#------
-#------#----#------#---##-----#---#--#--#--#-#-##---##--#--------------###---##---##------##--#-###
---#------#------#---#-##-----##--####-#--#---#-##----#-#-----##----------------#-#-----###--#------
--#---#---#------##---#-##--#-#---#---#---------------##-##--###-------#--#-##-------#--#-##-##---#-
#-###--#---#-##---------#-###---##-#----#----#----#----------###-####---#------##-#---#--#---##---##
#---#---#--#-#--###--#-##--#-#---##---##------###--#-#----#---#--#---###--------#---######-#----####
-#-#-#--#-##-#---#-#-#-#-###----#####-#--#--#-#---##---------------##-#----#-#--##-----#-#--#---#--#
-#-###-##---#-#-#--###--###-#-#--#-----#--##--#---###--#-#-#-----#--#--#-----##--#-----#---#--#----#
#-##---#--##----##-----####-#----#---#-----#--#-#-#--#-####-------#--------#----#-#--##----##--#----
###-#--------##--###-----####--###-#-#--####-------#-----####-----#--#-#-----------------##------#--
#-------#-#---####----------##-####------#-------#-###-##-##-##-------#------#-----#--##----#-------
-#-#----#--#--#--##--------#-##---#-#---------------##-----#---#---#-----------#------#---##--#-----
--#---#---#-----###--#---#--##-----##--#--##-----------------#--#--#-#--###------#--##--#-#---------
---#--#-#--##----##----##---------#-------------#-#-----#----##-#---#-#---------#--##-------#--##-#-
------#-----#--##-------#-----#--#----------#-------##-----#-##-##-----------#-#--#---------#-#----#
--#--#-------#----#--------#---#-----#--##-##------###-##-----#-#-#-#-#----#-------##-----#---------
---###-#---#-#-###-------#---##-#-------#-#--#--#----#--##-##--#-#--#-##------#-----###---#-##------
--##-#--#####----###--#-#---#---#--#--#------------##--#----####------###-#--------#--#-------------
#-------#-------##----#--#----##-----#---###----------##----------------#-------#----###-#-##-##---#
--#--#--##-#--#--#-#----###-##--#----#-###-#-----#-#--#--##-###--#----##--#####------#---#---#---#--
---#-----####---###--#---------#--#----##----#-------#-----#--------##--#----###-##---###---#-#-----
##-##--##--------#----#-#-----##-----------###-#------#-#------#--#---##---#--#--#--#-----#--##-#-#-
-#-----#--##-----#--#-#---###-----------##-#-##-##----#---#-#------------#--#-##----#-----#-#----###
--##----#----#-##-#-#--#---#---###-----#-##-----#-#-#--------------##--#-#----------#-#-------#---##
-##-#---#----------##-----#-------##--#-#-#--#--##--##-#------#--##---#-------##-#-#-------#-#----#-
----#-------------#---#----##---#-##---------------------#-----#--------##----#--#-#---#---#-#------
#--#-----------##-----------##----##----------##---#--#-#----#-#--#-----#-------#-#-----#--#-#----##
-#-------##--#---------#---#--#---#-#---#--##---#----#-#--#-------------#----#---------#####-#####--
------#--####-###---#-##----#-#----#---#-----------#--#------------------#----#---#-#-#-------##----
#---##--#--#----##-#-#-#----#-#-----####----#-#-----#-###--#-------#-##-#-------#--##----#-#-#-----#
-#---#--#-#-#----#----###---------#-#-------------###---#-#-#--#---#-#-------#-#-#--------#-#--#-#-#
---#-#---#---#----#--------#--#-#-----##----##--##------##-----##---#-##---##--#--------#-##-#------
-####--------#----#--#---#----###--#-#-#--#----##--##-##---------#--##-####-##----#---#----#-----#-#
--#-#--#------#-#------------##-#--#-#----------------#-#-----#-----#-#-------#-#---#---#-----------
-----#----##-######---#--##---###----##------#------#-------####-------#----------#----#-#---#-#--#-
--#-----#--------S#---###--#-###-------###----#-#----#------##---#--#---------#-##---#--------##----
#-#-#----#--#-------#---#----###--------#--------#-#----#--##--#------#------#-#----#-##----#-#---##
#-------#------------##-#---#-#---#--#--------------#----#--##-###-----#--#-----#----##--###--------
--#---#-------------#------#-----#-#-----#------#--#---##-#-#-#---#-#--#--##--#---#-#--#--#-------#-
-##-----#-#---#---##-#-#-------#--#-##-------#--#-#--#-#--#-#---#--#-##-#--#-#----##--##--#--##--#--
-#------##------#--#-------#-#--------#--#--#-#--#-##-###--##--##--###--#---##----#---#-----------#-
----###-#----#-#----#-#-##----------##---##----#-##----#----##-##-#----#-#-#-##-#---##---#-#--#--#--
--#-#-###------#-#------#-#--------------#--------##---#----#----#-#-------#--##----------#----###--
#-#-##----##-----#----#-##----#---##---#---#-#----#-#--#----##---#----------#-----##--#---#------#--
#--------#####---------#---#--####-----###-#-###---#-#---#-------#-##-#--#--#------##--#-##-#-------
--#-##----------#----##-#----#-##-#-##-----###---#-------#--------##-###--#----#-#-##-#---#-#-#-----
---##-#-#-##--#-#-#--#---------#-------#----#-#-------##----#-##-#######---#------------##--------#-
-##-#---#----#-#--#---#-#-----##---------##-----##----#-#-#----#----##--##-#-#-#---------------#--##
------#-------###-#--------##---#--##-#-----#-------##-####---##------#-#-----#---#--------#------##
-###-#----##---##---#---#-##-------------#-#-#-----#-------#--##--######-----#--#-----#---------#--#
#----#---#-#----#-#-#-#-#-----#--#-----------#-##-#-#------##--##--#----##--###----##-#-------#--###
--#--#-##-#-#-#--#--##-#----#--------#-#-###------------##--#####--#--#-#----#-------#--#--------#--
#--#----###-----#--#-#----#------------#--#-##-#-----#-------#-------##-----#--##----##-###---#-##--
---#-#-----##-#--#-----##-#--##-----------#---------------#-##-##------#----#-#----####-#-#---#-##-#
#-#---#--------####-#-#--##-#--#------#--#-------##---###---#----######---####---##-#-----##-####-#-
------#---##---#-----#----##--#---##---------#-#-#-###--------#-#--#-#-##--#-#-######---#---#--#--#-
-#-#-###--E-#--#----#----#--#-----##----##-#---#-#-##-------------#------#-#-#----###----#--##-#---#
--------##-#-#----#####-#---#--#--#--#--#--------#-#-#-#----#-#---#---#-#--#----#-----#-------#---#-
---#-####-#----##---#-#---#-#-#--###-###-------#-----#-##-#-####----##------#-#-##-#-----#-##-#-####
-------#-##-##-#-#---------#--######--#-------#---#---#----#------#-#----------#---#---###---#--#-#-
-#----#---#----#-#-#--------##--###----#-----#--#---------------#--#-#---##----#---#-----#------#--#
---#--#-----------#-----------------###--#-#----------##-##---#-#---##-##---#--#---#####-##-----#---
#-----#------#--#--#-#--#---##----##-##---#--------###--#--#-##-----#---------##-----#------##--##--
-##----------#-##--#------#--#----##-###---#---#-##----------#--#--#-##---------#-#--##-#-#---#-#--#
--#------#--#--#----###-##----##--#--###-----------###--#--#---------#---#-#---#--##---#---#--------
-----####----#--#---#------#--#------##--##--------#-#-#------###----------------#-----##-----##--#-
----#--------#-#-#----##--------------#-#---#-#-------#-#--#--#-#-----------##------#-###-##---##---
----#---#--###--#-------#---#--###---#--#----###-##-#---#-#--#--##------------------#-#-------#--##-
---#--##-#-#----##------#-#--#-------------#--#---##-----#---#----#-----#-##-#------##--#-#-###----#
----##---#------#--#-#----#---#---##-#-#-##---#-#-#------#-##------##-#-#----#-#-#---##-----##-#----
-#-##-#--#---#-#--#---#--#-##----------------#-###----------#----##---##--#--#----####--#-----##---#
------##------##----#-#--#-###-#-----#-#----#--#-#-###----#--#----#----##---#--#--#-----##----#-----
#-##-##----##--##--##--##------#-##--#-##-##-#-#-#----##--#-##------#----##-#####----#--------------
##-##--#-#--###-#--#-#--##--#-##-#-##---#-----------###--#--#-#-#---#-#--#-#-#-##-##-#-##--#---####-
-----#-----#-##-#--##---##-#--#-----#----#------#-#-#--#-###-#---------###---#-##-#---##--###----#--
------#--###-------###----#-----#-#-#--#--------------#--##--##---##---#---#---#--------#--##----#-#
#-#-#--#-----#-#-#--#-----#---#--#---##-###------#-#--#-##-----#------#----#----##-----#-#----#--#--
---#-#####-#-#-----#-###------------#--####--##--#-----#---##-----#--#--#--#-##-##--#--#-##-####--#-
--#-#-###-#--##----#------##-#--#--#-#-#-#-------#---##----------#----##-#---#--#-#----------#-##---
-----##-----#-#----#--##---------#-#----####-#--#----#--------##----#-#---##-#--#--#-##--#---#-#----
-#--#-##----##--#--#------#---#---#---#---#-#-------------#-#-##-###-##---------#--#----------------
--##---##--#-#------##---#-------------#-####----#-----#---#---------#--###---#----#-------------#--
-#-----#-#-#-------#-#-------------#-#-#-##-----#---#--#--#-----#---#---------#-------#--####--#----
------#------------#------#-#-#-#---###-##----#-#--##-#-##-##-#-#------#-##---##--#-##----#--#------
--#-#--####-##-#---#-#-------#---#-----------##--#------#-#-#-------#----#-##-------#------##-#---#-
-##-#---##--#---------#--#--##---#---#----#-----#-#####------###--------#---#---#---##--#--#--##----
--#---#--#-#-#--#---#-#--#-##---#----#---------------#--#---#----####---#--##--#-#----#-#--#--#---#-
