------###-#-------##------#--#-----#-#--#---#####----#--------------##----#####------###-#--#-##-###
#-----#-#-----#-#---#---#-##--###--#--#----#---##--###--#--##-------------------#----#####----------
--#--#----#---#-##--#-##----##----#-------#--#--------#---#--------#-##-------#----##---###----###--
#---#----#----#---#---#------#----#------##---#--#-----#---#--#-#-#-----#--#--#-#--##-----##-##---#-
#-----#--#--###----#-#-----#---#-----#-------------##-----#--#----########-#--#-#--#-#-#------------
-#-----#--#------#-#---#--#-##--#-##-#-#--###--#----#-----#------#---###------#----#---##----####---
--#-#-###-#--#---####---#--#----------#-----####-#------#---------#-##--#-----------#---#--##------#
--##-#----#---------#-#---##---#------##-------#--#----#----#--------#--#----#-#---##---------###--#
--------#---#------#--#-#--------##-#-#---#-#-#-------#-#-----#-----#-##---#--#----#-#------#---#---
---------#-----------------#---#-#------#---#--#--##-#----#-#-#-##---#-#--#--#--------#---#-###-#-#-
--#--#-----#----#---#---#---###-##------------------#####-#--##----##--##--#-----###---#-----#-----#
-----#-##---#------------#-------------##---#--#--#--#-#---#---##--#-------#-----#-##-----------#-#-
###----#---#----#-----#------#-##-----##------------###--#-----#-----#---#-----#-#--###-----------##
-#------------#--#-#-------#--#----#---##-------#-#-#-#-#---#-#-----#------#--#---#----#-#--#--#--##
-#--#--##---#-#-#------#-##-#-----#-----#-#----##--#--#--##--###-##-##----#----#-#---#-----#------##
-###--#---------#------#-#----##-#----#--#------##--###-##--#---#---#----##-#-#-----#----#----#-----
#-##-#-#--------#----#----#------##---#--#-#-#-----------#-#------#---##-#--#-#--#--#-------#--#-#--
#-#-----#-#-#------#--##-#-#-#-----##-#-#-###-##---##--#--#----#---#----####------##------------##-#
#-##-##---#-###----#-#--#-----#-#-###-#-----#----##----#-#-#--#--#-#--#---#------#---#--------------
-#---#----#-##----#-#-#-###-----###--#----#-#-----#---------##--#-#---------#-#-----#---#-----#----#
-#-#----#-###----------#-#----#-###--###--#---#-#-##--##-#--##-###-###-##-------#-##-----#-#--##--#-
------####-#-##--#---#------#----#---#--##--#--#-----------##----#-#----####-#--------#--##---##----
------#-#-#----##---#-----#------#-#--#-------##-#####---#------##-#----------#-##---#---#---#--#---
--#--##----#-#---#-----##-##---###----#--#-#-#----#----####-#--#--#--#--#-#-------#-####-##-----#---
--#-#-#-#-#-------------#-#--#--#----###----##-#--##--#---##-#####----------#--#-##-#-#--#---##--##-
------------#--#-#------#---#-#-###------#-#-#----#---------#--#-#-------#---#------#-##----#---#-#-
--##----####--#-#-#-------#-##-##-#---#-#-----------##---###----#----##--##-###--#--##-###------##--
--#----#-#-##---#-----#-#--##---------#-###---#----##-#--#-#-##---##---#----#---#---##-#---#-#---#-#
----------##--#---#-------#-###-##----------#---##-------#-#--##-------#-###-#-#-----#-#--##----###-
-#-##-#---#---------##----###-##-----##-----##-------##-#--###----####--####--#-#--#------##-#-#----
------#---#-#---#-------------#---#-------------#-###------##-#---##-----#----------##-##--#--##----
-#----#--#----#---#-#-#----####-##--------------##---------#--#-##--------###---##--#-------------#-
-###-#--#--#--#----#-----#------------#-#------#--##----###-#----##--#----#---#--#------#-#--###--#-
--#-#--##---#-------##-----###-----------#---#--####-------##-----##----#-#-###-#----#-#--------#--#
#####---#--#---#---##-----##-------##-#---##--#----#--#---#------#----#-###-#-#-#-#-#--#----#----##-
-#--------#--#-##--------#--###---------######----#-#--#---#-------------#-##------#-#---##--#-----#
-----##--#--##------#-----#---##-#--#-----###---#-----#-------#-#-##----#---###--#--#-##------#---##
##-#-#-#--#-#--#----##-#---##--#-#---#--------#--#-----#---#-------#-#-----##--#---#----#-#----#--##
--#----#---##--#-##---#-#---##--##---##--#----#--##-##------#--------##-#-----##----###---#---#--#--
--#-###-##-#---------#--##-----###-----#--#------#-------#-###---#--#-###-#--#---#----#-#S--##-#-###
---------#---#-----#-----#--#-------#-#----#-----#-#---#-#---------#---------##-#-##-##-#--------#-#
#####---#-#----#-#--##-#-#-----##-##---------##------##--##--#-#---#----#-----#--#----#--------#---#
#-#--#-#--#------#--##-#-#---------###---##---#-#-------#-------#--#-#--##---#-#-----------#-----###
##--##-#-#-##--#--#----------##-----------------#-###--#--##---#------#-###-----#------#--#--#---##-
---#--#--###----#----#----#-----####--#-#----###-----#-#----#----#-##---#--#--------##----#-###--#--
-------#---#---##---###----#-----###----##--#---####-####--#--#----------#-#--##-#--#-#-----#---#--#
-##--#-----------#--##--#--#-#-----#--#---##---#---#--#-##-#-#---#-##--##----#-#-#----#-#---##-----#
-----###-----#---------###-----------#-#---#---#-----##-------------#--#---#--#---#-##----------##--
----###---##---##---#-#-###-------------#--#--#-----#--#--#-#-------#-#-##------#-#---------#--#--#-
----#-##------#----#--#--#--#--##-#----#---##--##--##-#-----#--#--#-#--####-------------##--#------#
-#-#-#-#-#-#------#-##-----#-#---------######--#-##---#-----#--------#--#-###-#--#---##-#-##-#------
-------#-##-#-#---#----#--#---#--##-#-------##-----##--#-#------------###-#-#-#-----##----#--##--#--
----#-##-------#--##-#-#-#-#-#---###---#-#---#-#-###---#---#-------#-#-----#---#-#-##--#-#-##--##-##
#---#-------#-#--#--#-#-#--#-#--##---#-#----##----#---#-#-------#----#--------#----#-#-----------#--
###--#-##------##------###-##---#---#------#----#------##----#-#-----#--#-##-#----#------#---#-##-##
-----#-#-#--##----#----#--#--#---------#-#--#------##-----##--#---##------#---#-----#-------##----#-
-##-#---##--#-----#------#####--#---###-#-#-#--#----#-------###---#---##---##-#---------##-##------#
##-##--#-#--##-#--------##----###--#----#-###-#-----##---#-#-------#-#-#---##---##-#--#-##-#----#-##
--#-----#--#----#------##--#---###---#-#--#------#-##-#------#--##---#---#----#---#-#----#-----#-#-#
-----#--##----#-#-##-------#----#------#---#---##----#-----#---#-#--#-----------#-#-##-----##--#--#-
------#----#---#------#--##-####--#--#--#-#---------#---##--#--------####-----##-------###------#---
---------##-###-##--#----#--#---###--#--#-#-----#-#--#-#----#-#-#-#--#----------###--###--###--#--##
---#---#-#-#-#####-#-#-#-------###------#-#-#-#-#--##----#-#--#----##--##-------##---#-##---#-##--#-
--#-#----#---------##-#-----#--#--------------##--####----#---##--#----------#-#-#-#---#------#-##-#
---#--#---#------##--#--#-#-#--##-----#--------##---#--------##---#--#--#-#---#--##-------##--#-#--#
--#--#-----------####---#-#-##-##-----------#-#--------#-##---#---#---#-#-----#----#-###----#-------
##-#--------------#---------#-##--#-##-----##--#-###-#-###---#--#-#------#-#-----#-##--#-##-###---##
-----####---#---#--#-##----------###------#-#----#-#--#-#--#-##--#----#----#-----#---#--------#-----
---#-#----##---##------##---#--#--#-#-----#-#---####---#---##-##--#----##-#-#--###-##----------#-#--
-#-#---#--#--#--#---------#-#---###----#----####---------##-#-----##--------#--------##----#-#-----#
--#-----#---#---------#-----#-##----##----###----####-##-#------#------###--##-------#--#-----#-----
-#-#---##---##-----#--#-#--#-#----#--#----#-#---#----#----#--##-----#-#-##---####--------#------###-
#----#---#-##---------------#-----#--##-##---#-#-#---------#--------#-#--#-#--###---#---#---#-------
------#-##-#-------##-#---#-##-##--##----##---#----#---#-###---#-----#---#-------##---##-#--###----#
-------#----------#-#----#------##---#---#--#-#-#---#--#-##-------#---------##----#--------#--------
-----#-------#--#----###-----##--#------##---#------#---#-#-#--#--#-#--###----#--#-###-#-#-#----#---
#-----------#----##-----#-#---#---###-###-#-#----#-#-##--#-------#------------###---#-##-----#-#----
--##----#----###-#-#---#-#---##----#----#-##----#---#---#--#-###---#--#-----###--------##--#---#--##
--#--###--------###-#-#-#-#----###-#-#---#-----------##----#-#--#---#-#---##-----##--------#--##-##-
##-#-#---##-#-#------#-#-###--#---#--#------##---##--##--#--#--#--#---###----#--------#----##--#---#
-##--#---##----#----#---#-----#-#--#-----------#######----#-#--#-#------------#---#---#-----#-------
--##--##---####--------##-#--#-###----##--------##-###-#---#---------------#---##-##-----#--------#-
---#---#--#--#-###-----#-##-----#-#-#---------#-#--------#----#-#----#--#-------#----###-----#--#-#-
----#--##-#-#----#--###--#---#---#---#-----#-------#-------#--##---------#-------#--#---#-##---#----
#----------#-#--------#---#--#--------#----------#-#----##--------#----------##---###----#-----##--#
-#--#--##-----#------#--##---#-#-----#----#----#----##-------#--#--#-#--#--#----#--##----#--#-------
#-###--------##--------####-###-###--#---#-#-----------------##-#----#----#---##----------#----###--
------#---#--#-------#--#-#-#---#-#-----#-##-#------#--##-#--##-###----#--#------#-----###-#--#-----
#-#--##--#----##---#---#-####-----#--#-#---#-##-#----#-----#-##---#-##----#--##-----#------#--#----#
---##-##--##-##---#-##---#---###---##-##--##-----#----#----#-#-#-------#--#-##-#--#--#---#-#-------#
--#-#-#-#---#--#--#--#--#--#---#---#----------------------#----##---#--------#--#-------#----##-----
#-#----##-##--#-#---##----##--#-------#----#---##---#-----#-----#----#-----#-------#-#--###--#---#-#
---#-------#---##-----#-----#--------#-----##-##-###-----------#-##-#--#--####----##-----#-#--##--#-
--#--##---#-#-------#--#------##-#####--##-----#--#---#--#--##------###-#---###--#-----#------#-#---
#------------#--###-#-#--#---##-#---#-----#--##----#---##--##-#--#-#---##-#-------#-##-#---#---#----
-----#--##--#-------#-#--------#--#-##--#--#----##--#-----###-#-#---#------#-##---###-#-----#-##----
#-#-#------##-------#--#-----#-----##-#--#-----#-#--#-#-#------#----#-#---#--------------##-#--###--
-----#---##------##--#-#----#----#--#--#-###-----#-#--#--#----#----#--##-##-------#------------###--
-#-------------#-##----------##-#-###-#--------#---#----##-----#---#--------#-#--#-----#-----#-----#
#--#--------##-##------------#-#--##-##--------#-E-#-#----#-#--###---#--##---##---#------#-----#---#
