----###---#-#-##--###-#-###--#---##-#----#--#---------#----------##---#--------##--#---#---###-#----
-#####-----#-#----------#--#----##-###---#-----####---#-------#-#-------#-##------#-#-##------------
-##--#-#----##-#-------------##-#-#---#------#-----------------#-----#--#-----#-----#-----#------#--
#---------#--##-----#-------##--##--##--#-##--#-#-#----#--#--#--#-#------####---#---#--#--#-#--##---
###-#-##-#-#-#----#-#-#-##-#-#-----#-------#-#-----#----##--#-----#---####-#--------------#--##--##-
###---#-#-#-#-##-#---#---#-------##------#---#-------#--#-#-#-------#-----#-#-------#-#--##-#--#--#-
###-###-##----------#-#----#-#---#-#---------#--#--#-#--#-#-#--#-#-----#-##--#-##-##---#-##-#-------
-#-----#-#----#-#--#---#--#----#----------#---####-#-#-#--#---###--#---###---------#----------#-----
--####-##------#--#-------#------------#-#-----#--##--##--#----#---#-###---#----#-#--------------#--
#-----#----####------#------#-#-#-----#---#-#---#--#---------##-----##--#---#---------#--------#-#--
--#--#--##-#------#--#----#----#--#--#-##-------##--#--#-#------#---#--#--#-#------##----------#----
#-#----#-------#-#-#--#-#--#-#-##---#--###--#-##-#-#---------------------#----#----#--#--###-#######
-------##-------#--------#-#-----#---#-#-#-#-#----#---#-###---##-#--#-##-###-##--##--#---#-#--####-#
--#-----#---##----#---###-#----###----#-------------##--#--###----##-----#---#-#---#-#---------#--#-
---#---##-#-#-####--#--#--#--#----#---##-##--#--#-------#--#------##--------#---##---#-#------------
--#------#---#-#--##-##------------##--#--#----##-#--------------#-##-##------#-##-#--#-##----#-##--
###------------------##--#---###--#------#--#-#---#-##-#---####----#--#-#-#-##-##-#--#--------------
----#-#-#--#--#--#---#--###-#----#-#------##---#-#----#-----#---##-#-##----#--#----#-###-#----------
--#---#-------#-###-#-#--#-----#---------------#--------#----#-#---#-----#----#--#-#----#-###--#----
---##-----##--#---#-------#-----#-#----------#---##-#-#-#--#---#---#-----------#-----#-------##---#-
#----####--##---##-#--#----#------#-##-#-------#--#---#------#-----------##-###----##-----##-#---#-#
--##--------##-#--#--#---#----###-##--#-#---------------##----#-----##--#-#-#----#----##-#------##-#
--#-#--#--#-###-#--#-----------#---#---#-#--#---#-#----#--#--#----#--##--#-----------#-#----##-#-###
--##----------------#-----#---#------#-#---#----###---#-#-#---#-------#--#--##---#---#--#-------#-#-
--------##-#---###--------------#---##------##--#-#----##-----#-----#--#--------------#--#------####
--#---#----#----#-#-#---#----##-##-#--------------#--##-#-----####------#---#---#-###-#-------#-##--
--#----#--#--##--#-##--#-##--####-----#---#--------#------#--#---#----#--#----#--#-#--#-#----#--#-#-
-#--#-#----##---#----#-##-#------------#---#---#--#-#------##------#--#----#--#-####----#----#--#---
-##-#-------------#-#-#--------#-#------------#-###----#--#-#-#--#-------#-------#-----##---#-----##
----#-#----##-----#-----##-#------#-#---##-#--#-------#-#--###---------###----#--##---#-#----##--#--
-----#-----#--#-#-------#--###-###-#-#--------------#--#--#-#---##-#-#-#-#---#--#----#-#-----#-#-#--
--#-----#----#--#-##--#--#----##-#---#-##--#--#--------#-#--#--#---#---#-#-----#---#-#-##--#-###----
#-##--##S----#-#------#-------------#-----##-#-#-------#---#--#---#-#-##---#-----#-####-#--------#-#
---------#-#-#---#--------##---##---#-#----------###--##------#-#-##---##--------#----##-----#-#--#-
#----###----###--#-------#---#-#--#-#--#--##-------##--#---#---#---#---------#-##--#-#-#-----#####--
---#----###--#-------#-#-----#----##----#-##----#-#---#-#-#----#---#--##-#--#-#-##-----#-#----#--#-#
##-#---#-#-#---#-----##---##-#-###--#-#-##--##----#-#-----#---##-------#-##-#--#---#----#-------#---
-------#-#--#---#-#--##---#---#-##--#-##--------##--#-#--#-----#-------#---------#####-------#-#--#-
#--#--###--#--#-##--------##--#-------------------#--#---#-#------#----#--------#-#------##--#------
#----##--------#-#----#---#--#-##------#----##-#-#----------####-#------#--##---##---------#----##-#
##-##------##-#--###--##--##----#---##-#----#-###-#-##---#----#--#----##--#--####---#--------#-#-##-
-----#----###-----------#-##----#-----##-#-----#-----------#-----##-#-#---#-#------------#-#---##---
-#-#-#---#--#-#---#---#----#-------------------##--#------------#-------------###---#---------------
--#---#-#-----##-------#-#--#-#---##--###-#-#------#---##-#-#------##--#----#----###--##---#--#---##
---##---##-#---#-#----#---#-#-##-##-##---###-------##----#-#-#--##--##------#--#----##--------#-----
--#-#-##--#---###-----#-#-#-#--------###---##-#--#-#--##---------#-#-----#---------#-#-#------#--###
#-#-#--------#---#-#-----#-###---------##---#---###-------##-#--##---##-----#-#-----#-#---#----##---
#-##--#------##-#----#---#-#-##--###-----#---#--#-#-#-#--#-----#-------###---##---------##----#-----
-#----#-#--###-#------#----------#---#-#-##-##-#-#---#--#-##--#-#---#-##----#--##-##--#-####--#-#-#-
#---#-#--#---#------##--#----#-------#--#--#-#----------##-##---##----#-#-#---#---#---##--#----#----
##-##------#---#--#--#---#-#---#-#---###-----#------#---#-----#--#--###-#--###---#-#-##---#--#-----#
#-#--------##---#--#--#--#--------#-----#--#--###-----#-------#--#---#---#-###--#-#-------##--------
#-###----#--------##-----#------#--##-----#-----#-#-#-#--#---##--######-#--#------#-#-#----#-------#
---#-#-#--#-#-#--#-----#------#--#---##--#-###-------#----##-----###---#--######---##------#-##---#-
-#-----#--#--#--#-----#-#--#-#-#-----#--#-#-------##-----#----#--#-#-------#---#-#-#---#----#--#---#
---#---#-----#---###----#--###---#--#----##--#------#-----#----#-----#-#-#-#--##-##---###-###---#---
--#----#---#----#----------#-----#--#-#--##-------#----##-##----------##-##---##--#--#--#-#-#-##-#--
#----#-#-----#---##---####-----#------#--#---#----#-#----#----------------#--#----#-------##--#--##-
##-##--------------#-----##--#-------#--#--#--#------------#----###---#-###----#---#----#--------#-#
-----#--#-----#####---------#-#---#--####--#---#-##---#----##-##-#---#--#---------###-#--#--#----#--
---##------#---##-##-#-----#--------#--------#-#--##-----------#----#-----#--#-#-#----#--#---#---#--
---##----#---##----##-#---#--#---#---------------#-#--#---------#-#-#-##--####--#-#-#-#--#-----#----
-#------###----#--#-#-###--#-----#------#-------#---------------#---##----------#---#---####--#--#--
#-#----------#----##-#---#------##-##----#---#---#--#-####------#-----#-#--##----##---###--#--#--#--
#---#--#-----#--#--##----#--#---#----###----#-#---##-----##---#-#-#--#-#--##----#------#--#-----#---
#--------#-------#-------#---#-#####---##-#-#-#-#-#--#--#--#---#---#-##-##-##----#--#-#-------#-#-#-
-----###-#-##----#--------------#--#####--##---#---##-#----##------###-------------###-#--#----#--#-
------###---##-------#--------##-#-----#----------#-#----##-###--#--------#-#--#--##---#--#-#---#-#-
-----#----#---#----#-###-###--#-#-----#-#-----#-###--#---#-#--#---##-##------#-------------#--#---#-
#------##---##---####---------#-#-######-#-#---#-------##---#--##-#-#-----#--#------##--#####--##---
#------#----#----###--#-----#--------#----#-##---###-#-#-#-##--#---##-#-------------#-----###-###-#-
----#--#-------#####-#-#--#---#-------##-#---#-#-#---#-----#--##-####--##-#---#--#------#----------#
--#--#-#---#----#-----##----------#-#--#--#-#-----#---#----#-#-#-#####---##--###----#----------#-#--
---######-##-----##-###--#-##---##--#----#--------#--------#-#--#-#--##----------#-----#--#-#-------
-#---#-------##--##------------###---##--##---#-#-#-------#-#--#-#--#-#----###-#-##----------------#
---##---------#------#-#--#-##--#---#---#--------------#------#------------####-----#---##-#-#-#--##
--#-#-#-#--#--##---#----#-#--#-#-#-##---#----#-#---###-#----##----##--#-###----#-##---#------------#
------------##-###--#-##-#--#-###-####-----------#------#--#--#-##---##---####-##-#------#--#-#-##--
#--------#-#--###----##--###------##--#------------#-#---------#----###------#--#--------##--#-##---
##----#-------#-#------#-#--#-#-#-#-#--#--####---#--##--#----#---#--#-#------#--#--##-#--##-----##--
----#-#----#-------#--#--#---#-#--#-#--#--#-##-##----#-##--###-#--#---#-##-----#---#---#-##-----#---
#-#----#-##-#-#--##--------#---##---###------##-------##----------------#-----######-##--#-#--#-#---
--#---#----#--#-##----##------#-#----#----##-#-###---#-#----##---##-#-#---#-----#--------#--#-#--#--
--#-##-#--#-#-#-#--##-##---#####----#--##---##----------#-#--#-###-##--##-##--##-##-#-------#####---
#----##----------#--------#-------#-#---#-#---##------#----#----#--#-####--##---------#----#-#-#----
------#------###-----##---#----#--##-#----#----#######----#--#-----##-#-#-#--------##-#--##-#----##-
##-####--###-----##-####-------------#-#-------##----#-#-#--#--#--##-#----##---#---##-#----------##-
--##---------##----------#--#----#-##------##-#---#-##-#----#--------#---#--#------###---#--##-##-#-
--#---#-#-#-#-###--#--#------##-#-#-##-----#-#------------#-###--##-----#-#---------#----#---#-##-#-
#-------------#-#----------##--#--#---##----##--##-####---#-###---#-----------#-----------#------#--
#-#--#-----------######-##----##----------#-----###----#-----#-##-#-#--#------#----##--#--#---###---
#---####------##-#---##-#-#--#-#-------#--#-#--------##-###-#-#--##--#---#-----#--##--#-----------#-
----##----#-------##---#####-#-----#-#---#--#----#-----##-#---#--#-------##-------#-#-----------#-#-
-#---------###--#-----#-----##-##--###---#----##-#-##-#--------#---E---#--##------#--#--##-------##-
-----##-----#---------#-#--##----##--##-#--#--#----#-#-------#----#-----#---#-----#-#---#-------#---
-#--#---#----#---#--##--#-#----###-##----##---#-----#-----#---#----##----------------#--#--#-#----#-
-----#--------#------##-----#----#-------#--###----##---#--#-#-####--#----#-#----------------#-#---#
#----#-##-#---#--#-#---##-------#----#--#---##-##---##-----#--####----#--#-#####---#--#-#---#-#--#--
#--#---##-----#----#-----#------##---#---##--#--##--#----##---------#-----##-#-----#-#--#----#----#-
#-#-------##-#---------#--#----#-##---------#--#-##---#-#--#--##-#-##-#---#-#---##---###-#--##------
