#------#-#---###--#-##------#-#----##--#--#-----##-----#----##-----##-------#-----##-#---#---##-#---
--#-------#-##------#---#--###-#-#-#--#----#----##--#--#-##--#-##---------#--#--#-#--#-#----#-----#-
-#-#-#---##--##-#---#-----#--##-#-#--#-#--#--------##--#---#-#--####-----#-#-#-#-#---###-##----#--#-
--------#-##--###---#-#------#---#-#-#----#--#--------#---#----#-#-#-#-##---###--#---#-#----#----##-
----#-----##-#---#-#-#-----#-----#--#------#-------------#-##-#-#-###---##-##--#--#-#-----------#---
---##-----##------#-#------#-#---#---------##--#-----#-##-##-#-#----------#--------####-----#-----##
##-----#----###----##-#---#-#------#-----#---#---#--#--#---####----#-----####----#--#------------#--
-------#-#---#------#--##--##-----#----#----#---#-----#-#---#--##-#---#---#####----#-##----#---#-#--
----#---#---------##-#----#----#-----#----#--###-#----##-#--##-#---#-#---####--#-----#--###---#-----
#----------###--#---#--#---#--###-#--------##-#-#-----#----#----#-#------#-#------#-----#-###----##-
#----####-#---------#-------##-#---------#--#---#---#--#--###-------##---##-##-----#----#-#-#-#----#
---#-#---#-----#---#-#------##--##-------#-#--#-#----##----#-#--##--#----#----#----#----#-#----#--#-
#--##---#-##-###-------#---#----#--##-----###---#------#------------#--#--#---------#----#####------
----#--#-#----##----#-#----#-#-#-#--#------------#-#-----#---#----#----------------#----------------
---#-----#-#--#--#-###-##--------#-###---#------------##-#-#####---#----#-#--##--------#--#-##-#####
-----#---#----#--------#--#-##-#---------#------#--#--#---##---#----------####-------###----##---#--
#####-----------#--#---###-#-#----#---#----#-#-###--#----#--##-##-####-#----------#-#---##---#---###
-#---#-###---------#--#--#--#-------#----#----#-###-------#--#--##----##---#-----#---###---#-#-#-##-
-#--#--------#--#--##-##-----##----#-#-----##------------##-##-##------#--#-##-----#--#-------------
#----#---#---#--##-----#----#--#---#-----####---##--#---#---#-----####-#---#-#------##-#----#-#-##--
#-----#------#-#-#-------#--#-#----#--#---#-----##--------#--#----##--#---#---------##---#--##--#-#-
-#-##-#--##-----#---#-------#------#-------##---##------#-#---###-#--#---------#-------#--#--#-#---#
-----#--#-----##--#--#--#-##--#---#--#-#-----#------#-##--#----#------#-##-#-##------#---###----#---
##-#-----##------#--#--#-#--##-#--#---#----------##--#--##--#-#--#-##----------#----------#--------#
#-#---#----#---#--##------#--#--#--------#-#--#-#--##-##---##-#-------#-##----------#-#--#-#---#-##-
------#----#---#----##-----#----#-#-###--##--#-------#--##---------##---#--##-#-##-#----##--#---#-#-
--#--##-##-#--#---#---#####-#----##------#---#-----##----------#-------#--##--#---##--#-#-###-----##
#----##-##-----##----------###----#-##---###-#---###---##-----#-#------------#####--##-#--#--#---##-
#-#---------##--#---------#--#--##---#--##--------#------##----#----------------#-#----#--#---#----#
-#-#---#--------#---#-#-#---#-------###------#-#--#-####------#-----####-----###--#-#-------------##
---#----####-#------#-#--#-#------#--#-#-------#----###-##---#--#------###--#-----#-----#--#-##-----
#----####--##--#-------------#-----#-----#---#--#-------#-##-----###---#-----#--#---##-#----###----#
----#-----#----#---#-------#--#----###---#------##------#-------###--#-#--#-----####--#---#--#-#----
-#---#----####---#------##----#-#--------#-#---#-----#-#-#---#---##------#--#---#----#-#-##--#------
--#-----##----#-#-###-----#------#--------#-----##--#-#-----#-###--#----##-##-#-#--#--###----##-----
#-----##---#------#----#--#------##--#-------#--#---#--#-#--#----#-#-------##-###-##--------#---#--#
---##-----#--##---#---###-------------#---#--------#-##-#-----#-----#-----#-#-##-#--#---#---##-##---
----#-----#-##-----#--#---#-##-#-#-#-----#---#--##-#----------###-#--------#-##------#---------#--#-
----#---##--###----#------#---#--#-#--#---####-------#-#-#-#---------#----#------##-------##-##-##--
##--##------------#---###-#-###--#-#--#--#-#---##-#--#---#--#-#--#-#--#----#--##----#-#--##--#--#---
-----#-##--------#--###---###----##-#---#-----#-###----#--#---#----#----##-----#--##--#--#-#--#-##--
#---#--------#---##------##-##-#---#---#-----#--###--#-----#---###-------##---#----------##-----#---
----#-#--#----#---#-#----##-----#----####----#-----#--#--#---#-#-#-##--#####----#--#####-#---##-##--
--#--#--#-------#----#-#----#--#---#--------#-#-#------#--#-#-----#-#-##--#--#---#--#-#--#----#-----
###---------#----#-#-#--#--##-#-#-##--#----#----#--#-#--##-----###-----#-#-#--------#--#####-##-#-#-
#-#-##------##----#-##--##---##--------#----#-----#---#--#-------####--##----------#-----#----#-----
----#------#--#---#----------------------##----###--####--------#-##-----#-------##--------#----#-#-
-##---------#----#--##------#-##-----#---#--#---#--#---#----------------------##----#-------#-------
--#--#-------#--#----##--#--###-#---##-#---#-#-#---#-#------------#---#-#-----#-#--###----#-----##--
--------#---#-##-----------#----##--#-#--#-#---#-----##-##----------#----#-----------##---------####
--##------#-------------###-#------##----#---#--#-#-#-#---#--#-#-#---#---##--------#--#-#----#-#----
##------#----###-#-#---#--#---------##----#-#-------#----###--#-----##----#####--------#-------#--#-
#-##------#--#---#----##-#---##-#-----###-######-----#-------#--#####----##-#------##-#-#----##-#---
--------#-#####----#-##------------#-#---##--#--#--##---#-#--#-##------#-#-----#--#-###-#--------#--
---#--------##------##--##--------##-----#--##----------#-#-###---#--#-#--#---##---#---###-##---#---
--#--##----#---#--------##--#--#----#-##-----###-##-#--#--###---------#----#--##-#----------##-#--#-
#------#--------#--#--#-#-----------#-----#---###-#----#---#-----------#-#-----#-#-#--#---#-#-#-----
---#---#--#--##-#-----#--#-#-#-#------##----#-##---###----#---#----#-##---#--#--##----#-#--#-##-###-
#----#--#-----------##---##-#--#-##----#-#--#-#--------#-#------#----###------##----#-##-#-------#--
-#-#-#-#-###-##--------#--#---####-#-#---##--#------##-#-#--#-##-#--------##--##---#--#-##--#----##-
#----#-#----#--#-#-##-#--#-----##-#####-#---#-#-#--#---#-###-----#---#-#-#----#-#-#--#--#--####--#-#
---#--#------##-#-#-##-#----#------#-#------------#--###-##--###--##-----#-##-------#--------#-#---#
-#-------###-#----#--------##--#--------##--#-#--#-#-----#--#-----#---#--#-#-----##---####-#-####--#
---#--#----##--#--#--#----##-#-##--------#--#-#---##--#-#-#------------#-###--###-#----##-#--#---##-
------#----##---------##-#---#---#####----#----##-----------#--------##--#-###---#----#-#-----#-#-#-
-##---------#-###--##-------------##----#-----##-##--#-#-#--#----##-#--##--#----------------#-#-#---
####---#----#----#-##---##----#-##-#---#-###----#---##---#---#--#---------#-------##-##-#--------##-
#-#----#--#---#-###-##------#-#--------#-----##--##-##-#---#---#---###-#---#-##--##-##--##-----##-##
#--#-#---#----#---------##--##-----####-----#--------#--####-#--#-##-#----#----####-##-#---##---#--#
--##---#----##--#-#-----#--##---#-#--#-#---#---#-------#--##--##--------###-----#---##-##----#---###
#----#----#-----###---------#-##---#----#--#-#------#-#-#----------#----##--#---##-------#---#---##-
----##---##-----##--------#----#---###---#-#------#----###-#---##---#-#-----------#-##-------#--E---
-#--#----###--#-######----##---#-----#-###-#-----#-----##-----##----####-------#####-#-##-##------#-
-#---#----#####-----#-#-#----#-----------#--##-#---##-##----##---#--#--##-----#-##----------#-##-#--
--#-------##--------#-#-#-#-##-#---#--------##----##-##-#-#---#-----#---#--#-###----#-#-#-###-##---#
---##--#----#-##-#--####---#------##----##--##-----#-----------------#------#------##-----------#--#
--#----#---------##----#-#---------#-#--##-#-##--#-#----#----#-#-#--##-#-#----##-##--##-##--#-------
#---#----#-##---------##------#-#------#------#-#------#----#-##--#---------#-#----#-##-------------
-####--#--#--#-#------------#---#---#---#-###--#---#---------#-----#--#--#-#-----------#-##--#----#-
--------#-------###--#--#-#---#---#######--##--------#-###---##--###-------#-------##--------##-----
---#----#-#---#--##-------###-#-#-#----------#----#----###-#----#---------#--------#-----------#----
-----#----#--#--##-#------#-#--#--#--#----#-------##--------#----#--#---#-#-##---#-#-#-##--#-#-##---
---#-#-----##--#-#-#---#-------##------##-###-----#--#----#---#----#------##--------##---------##---
-##--#--------------###-##-#---#--##-#-#------##--#--#----#---##-#####--##-----#-###----#-#---#---##
#-#-----#----------#---#----#---#---#---#---#-#####-#---##-#--#-#--#-##--#----###--##S##----#---#---
---#----##------#------#---#--##-----------#-#---#--#---#--#--##---###--#--##-#-----#----#-----#---#
###-----####-#-#--#-------#--#-#----#--##----##-----##-----------------#-#----#------------###-#----
---------##----####-#---#-#-##---#-#---#-#-----#---#-##--###----#--#-----#---#-##--#---###--##-###--
-#--##----##-------#--##---#----#----#----###--#-#--#-##-#--##---#--#----#-##-#---#-#---#---#---#-##
---#--#-#-----##---------#---#-#--#--#-###-#-#--------#--#-##--#--#----#-#--#--------#-##-#---------
--------##---#-##----##-#-#--#----###-#--#-#--##--#--#-------------##----------#-#-#------#-#-#-#---
-#---###--#---###------#--#----#-#----#----------##---#-#---#-#--###-#----##----#------#--##-#--#--#
###---------------##--#----------##------#--#------#-----##--#---#----#--#-#--------#---#--#---#----
-##--#--##-##-#----##---#----#-#---#-##--#--------#----#--#---##----#-#---#-------#--------------#-#
#-##----##---------##----#--#---#--#------#-#-#----#-------#---#---###-###-#----###----#--#--#---#--
###--#-----#------#-#-#####-#---#-#--#-#---#--#---#---#-#--------#-#--#------#-#-#-#-------#-----#--
-#---------------##-#-##--#--#-#----#--##-##----#--#----------#--#----------#----#-#--##-----#---#-#
-----#---#--#-##---###-#---------#---#--#-#---##-------------##-###-#---#---#####--##-#----#--#-----
#---##---#-#------#-###---#--###------###------##--------#-----#--#--#--------#-#--#-#-##-#--#-----#
------#--------#-#--------#---#--------#----#----#-#-#-#-#---#----#---###-#----------#----##----##--
