--#--#----#--#-#---#-##-###---#---#-#------#-#-#--#-#-#--##---#-----#-----#--#-#-#####-#---#-#-###-#
#-------##---##--#--------##---#-##----###---------#--#--#-#-#---------##-------------------###--##-
#---#-#-##--#-#-#-#----#----#####-#-----#----##-#----------#--##----#-#--#-#-----#----#---#-----##--
--------#-#-#------##--#--------#-##--#---------#-#-#---#-#--###-#--#-#-##--#--##---#----#--#-----#-
---#####-#---##---#---#-#----##-----#--#----#####-----#--#-#-#--#-##--##-#-------##---------------#-
##-------##----#--#-#####-------#--###-#----##-##-##-#------###----#------#--##-----#----###------#-
--------#-------#---##--#---------#-##-##-------#-------#-##--#---#--#----#-------###------####-##-#
--#-#-#-#--------#--###---###-----#-##--#------------#-##---------#-##------###--#-#----#---#---##--
--#-------------#--------------#--#----##-----#---#-#-#--#-#-----------#------#-#-##-----#--#--#-###
---------#--#--#-------#-#----##-#-----#--###--#--#-#----#--#--#----###--#-##-##----#-#-#---##-#-###
-#--#----#--#-----#-#------##--#--#-#----#--#-###---#--------#-#----#-#--##------#-##-----###------#
#----##-#---##--#-###-#-#---#------#-------#-##--#----#---#---##-------##--#-----#------#---#-------
-#-#-#--#-##-##-#--####--#--#-----##-------#----#--------#-----#-------##--#-#-----#------#--------#
----#-###----##---#---#------#-#-#-#-----#-#--#-###-------###--####-#---#-#-#-#####---#-----##-#-##-
-#----#-----------#------##--###--#-#---##---#---#-#-----#--##--#-##--##----#--#-----#---#---#----##
------------#--#------###------#---#-#--#-##----#-##-###-###-#---#--#---#-#-----#-#-#-#-#-#-##-----#
---#-###-#-#----#---#--#-----###--#-##--#------###--#-#-#--#---#--#----#------------###----##---#---
----#------#--------------###----##---#------------#-----#----###-----#----##---#------#---#---####-
#---#---##-------#----#------------------##---#----#-#-----------#-----###--##---#--##--#-----------
##--#----------#-#----#---##-##--#---#-----------###-------#--##----#-----###-#-#-#--#-----#-#--#--#
-#------#--#-#-#-----##---#-#-#-#-----#----#-#-----#--#--#--#-#-----#--#-#--#---#---#-######---##---
#--##-----#-##----###--#----#-#--#--#-#-##--##--------#--#------####-#-#--#-#-##-##--##-##-#-#----#-
#-------##-#---#---#----------#---##-----#-#-----#-##-###--#----------#---#-------#-#----###--##-#-#
#--##-#-#------##----##----#-------#------#-#--####------#-##---#-----##----###--#--###-------##-#--
--------------#--#--#-#--------#--------##---#----#-------#-----------#--#----#-#-----###-##--------
#-#------#--#-------##--#-----#--#---#-#-----#--#-#---------#--------##----##-##--#--#--#-##----###-
#--#---#####--#-------#----#------#--#--#--#--#---#-----##--#--#--###--#--#----------#-#--#---#-----
##---#-------##-###-----#-##-------###--##---####-#-------###-#----#--#-#--####---#---------#----#--
##-#------#-#--------###-###--##--#-#---#-#-#----#--#------#-##------###-----#-#--###--#-#--#-#---#-
-#---------#-##-------#---##---#--------------###--###----------####--#--#--------------##-##-------
#------#---#--#-#-###--##--#---#-----##-##----#-###-----###-#--#---##---------#--#-##-------#-------
--#-----#--#-----#---#------------###----#--#-------##-#--#---#---##--#-#---###--##-#--#------##-#--
#--#--#--#----------#-#----#-###-------#---#---#---###-------##---##---###-----------#----###---#--#
-##---------#----###-##-##---###---#------#-#--#-###------#-####-----#-#--#---#-#---#--------------#
-------##-#----##--##--#---#--#----##-----#---#-#--#--#------#-#-----#---------#------#-----#-------
##---------#---#----#----#----#-----#-#-#---------#-##------##--#---##------------#--#---#-----##--#
---#--#-#-###--#-----#--#----#----#-##----#----#------#-----##-----##--#--#-#----#-----#--##-##---#-
-##----------#-#--------------#------#-#----###-----##--#-#---#-#-##--------##-------#-#-#--------#-
--#--######-------#----#----#-----#-#--##-###----##---##---#----##-#---#--#---#-#--#--#-----#-###---
#----##-#-#--##-##------#-----#-#--------#-#-------#-----#--#--#--#---------#-##--##----#---#-###-##
-##--#####--#---#--#--#-#--#---##----#-------##-----#-#--#--##--------#-##---#--#----###----###--##-
-#--#-------#------#---#--#--------#--###--#--#-----#---#---##-##---##---#-----#-#---------#-#------
-#-------#-####--###----#----------###---#-##--####-----###----#-#-###----------#--#-#---#-###---#--
----####----#-#----#-----#-------#--#---#-----#-#-##---#-##-#-----###------##-#---------#----##-##--
--------#----#---#--------#--##------##-#--#--#-----#-----#--#-#----#--#----#--##----##-#-###------#
#--#---####-###------S--#--#---#--#--##--#-#---#----##---###---#--#---#-----#----#-#-##---#---------
#---##----##--#--#-#---------#---#--###-###-#----###----###-#-#---#-#------#-------#-----#-##----#--
#----##-----#---#--##--##----##------##-------##------#-#----##-#--##----#--##----------#-##--#--##-
-#--##-#--#---------#----------#-----#--------#--#---#-------#-----##----------#--##--#-#-----#-#---
--#--##----##---#-----#---##---#-------##-####-#---#-#-##----------##-##---##---##-----#-#-----#--#-
-----#--##--####---#--#-----#---##-#--#-----#--#-#-####-----#--#-##----#---#--##-##--#---------#-#-#
-#-##---#---###-----#---#--##---#--#----#-----##-----------#-#--#-##--#--------#---##--#----##-#--#-
---#-##--#----#----##------#----------#--#-#--##------##-----#--------#-#-#--##--#--#--#-#---##-----
-##-----#---#-##-#-##-----#---##----------#-#--#---#-----#-------##---#-------#--##--#-#-##--#--#--#
--#--#---##--------#-#----------------#-#-----##---#-#----#------###----#-#--##----#-------#--###---
#-##-#--##----------##---#-#-#-#---##--#------#-#----#---##-##----##-#--#---##-----#----#---------#-
----#-#--------#-####-#---#-#--##--#-#---##--#-#--#-#------##-#-###-#---#-----#-##-#----##--------##
-#----#-#---#--#---##----#------##----------##-#-###--------##-##---------------#-##-#-#-----#-----#
#####--#-#-----###----------##-------####------#--#-#--##--#----###---#----#-#-#-#--#-----#-###--##-
-#-#-#-#-------###-##-#------##-#----#--#--##-----------##------#---------###------##-#-#----##-#-##
--#-----#-----###-------------#---###--##-------##---#--------##--#--#-----------##-###-####---##-#-
---------#------###----#-----##---#---##--#--#---#----#-#---------------#-------#--#--------------#-
------#--#--#--#-#------#--#-#-##-#-#-------#-------##-#---#----#------##---#---#--#------#--#-##---
-#-###---#------------#------##----#-#-#--------------#-----##-#----------#----#-----------------#-#
-##--#--##---#-------##---##--------------------#-#--#--------##-####--#-##-------###---#-##-------#
-##---#---##--#--#-#--###-##--##-###-----------#-----#--##--#-----##---#--###----#-#---####--------#
#---##--###-#---#---#---#--#--#-##----#------#--#--##-#-------------####-#------#----#----##-##--##-
--------#-----##-#-##--#--#--#-#-##--#--#--#---#-----####-#-#----#-#-#--#-#-##-#-##-#-####-------#-#
---#------#---##--#--#-#---#-###----#-#--#-###--#----#--##-----#-#-----#---#-#--###-#-##--#---#-#--#
---#---#---##---#--##-----#----##-----##-----#-----------#-#----#--#--##----##-##-#--#-#----#--#----
-----------#----#-#-----#--##---#-------------#-#--#---###----------###-----#--#-##--#--#--#--#-----
-#---#-#-##-------------##------#--##-----#-##--------#-----#----##-#####---#----#--#-#--------#---#
---##---#-#-#------#---#--#----###--------#--##-#-#-#--#--#-----##-#--#-------#-##---------#--##----
------##--#---#---#---##--#-------#-----------#-##--#--------------#----#--###----#####---#-#--#-##-
----#---#------#-#---#-#--#---#------#--##-###--#----#---##---#-----##---##-----#-#------#--##--#-#-
#---##-##-#-#------##-#-#----##----###-##---#----#----##-##-#---#--##-----#--#--#-#----------##-----
----------#-----#---####-##----##-#-#----#E##----#-#------#-##-----#---#-##-----------------#-#---#-
##-##------#--#----#---#--#-----####-###---###----#--#---####-------##---------------#-#---##-------
#---#-##------#---#---#------#---#----##---##--#-----###----#---##-##-------#--#-#--#---##-#-#------
-#-#---###---#----------#----#-#--##-#---#--##--#---------#----#----#---#--------#----#-##----#---##
##-#--#-#-##---#------#------#--##--#---#-#-#-----##----#####---#-##--###--#---------##--##-#------#
--#--#-#---#---#-#--##------#-----###-##--##---#-##--#---#-#--##--##---#---#----#---#---#--#-###----
###---#----##---#-------##-#------#-#-#---###-#-----#---#-----------#------##----#----#-#--#-#------
--#-----#----#--##-#---#---######-#-----------#-##--###-###---##--##----#-----###----#-------###----
--#--#--#----#-#--#-----#--#----#-----#--###-----#---##---#-#-#-#---#---#--##--#------#----#-###--#-
------#-----#--###----#--#--###-----###--#----------------#-#---------##---#---------##--#-#----#---
#----##---------####---------#----#-----##--------#--#-------###-#---#-----#-#----#------#-----###--
-----###--##--##-#--------###-----#---#--#-#--#-##--#-#---#-----##------#-#---#-##------##----##----
-###--#-##-----##------##--#--###--#----#-#----#---#------#--#--##-##--#--#---#-##-###--------------
------##------##---##--#-#-#------#----#---##--------#--#---##---------#---##---#-###---##-#-#-###-#
#-##-------#---#-------##-#-----#-#---##-##-------------###-#-#-#----##---------#--###-------#---#--
----------#---##-----#--##-------------##--#-##-##--#---#----#-----#-###---#----##-#----#--#------##
-##-##-#--#-----#---#-#-#--#-----------#-###-#--#-#--#---#-#----------------#----#--##-#--#-#-------
--#-#--#-#-#-#---#---#--#--##-----##---#---#---#-#-----#------##--------#-#--##------#---###--------
-------#---#-#------#--#-#---###-#--##---#------#----#--#-#---#----#-----#----##-#---#-----#--#-----
-##--#-##-#--#--#----#--------------#-----#-----#--------#--###---#--#----#-#-#--#-#-----#----------
--------#---##-#-----------#-#---#--#-----#----#--####----#---#-----#---#--#-#------------#---------
---##----##-###--##-#---##-##--#-##---#-##--#--##----#-#----###-##---#-#---#---------#----#----#----
---#--#--#-##-##-----###----##-#--------------#--###-------#---##--#------------######---#---#######
#-####---#--#-#-#--#-##--##-#--#--##--#-------#------#--#----##--##-#---------###-------#--#-##----#
