#---##-------##--##-#-#---#---##--#-##--#----#####---#-#----#-#-##-----###E---------#-------#---##--
--#-----------------------#----#---##--##-#---#---#-#---#---##--##---#--#-----#----###-----#----#---
---------#-------#----#---#-#-----#-----##--#------#-#-#-#-###--#------#--#---#--------------###-#-#
----##-----------#---##-#--#-#-----#--#-##-#-#----#-##------------##----##----#-#--###----#-#--#--##
###-------#-#-##-##---#-#-----#---#-----#---#---#------#--#----------##-#-##-----##----#---#--#-----
-----#-----##-----#-----#--#---#--##---------#-#--#-#---#----#------#--#--------#-----###-##-#-#-#--
--------#-----#-#-##------#---#-#---#----##---#------##-----#---#---#-##-##-#--#--#-#---#--#--#--###
---------#----#----#--###-#--##--#----#---#--#--##-#-#-#-#---#-#--#-#------------#------##----#---##
-#--#-##-##--#-###---##--------#---###----##-##-##---#--#-##--#-#----##----#---#--------#---------#-
-#--#-#-##--#--##-----#-#-#--##-------#-###----#----------#-#---#-#-#--------#-#---#--#------##-#---
#---#-#---#-#--####---#--##-#--#---#------#-------------#--##------#---#-#----#-----#----#-#-----#--
------#------##---------#------##--##----#-----#--###-----##--#--------------####-#--#------##----##
-----#---#--##----##---##--##-#--##-#--#----#-#-###------#--#----#----#-#--#-#----##----#-#--#------
#----#----#####--#-----#---#-----#---#---#--#--###-#-#----##--#--##---###-#-#---#-#----#--#-#-#-----
----#-###---##---#-#----##---##-##--####---#---#---#--#----#---##--##--------#--#-##-----#--#-------
#--------####---##--#-----#--------##-#--##-#------#-#--------#-#-#-#---#-#---##----#-#---#-#-#--#--
#-#-####--#---#-#----#-----#-------#---#--------##-####-#-------------#-##--------#--#-#--#-#---#---
-----#--####-#-##-#--#------#-#--#--------#---##-#-----#----#------------#-----##--#-#--##--##--##--
--#--##-#-###---#-##--------------#-#-###--------------#------#---#----##---#-------#--#---#-#------
#-##-#---#-------#-------#-##---------#-##----#-#-------#-#---##-#---#-------##-#--#---##--#-##-----
-----#-#-------##--##-#----#-#----#--#--#------#--------##--#---##---#-#-------#---#---#-#--#--#-##-
-#---#---##-----------#--###-#-##-#---------#---######---##--#-#-#---------##-----#--#-#-#----#-#-#-
-----#------#---###------#-#-------#--#--###--#-----------------##-----##---#-#--#------##----------
#----##--#-#-#--##--###---------#----------#---#--#--#-##---##-#--#---###-###-#--#--#-#------#---#-#
-#------------###-#---#--------#-----##-#--#----#--------#--------#--#----#---#--#----#-##---#--##--
------#--#---------#---#--#----##--#----------#----#----#-#--##--#-#####-##---##-#-##--####-#-#-----
--#------###--##---##----#----#---------##--------#-------#-----#--#-##-----#-#-#-##--------------#-
-#-----#-------#-#-----#-##--#-#-----#-#----##----#-#-#--####--#----#--#-----------#-------#--##---#
-#-#---#--#---##--#-#--------#--#--#-#---#-#----#-----------------#-##---#-#-----#-##-#---#-#-#-----
-#-#--#--##---#---##------------#-###--###-##-#---##--###---##-#-#-#---#--#----##-#---#---##----#--#
#----------##----#--#---#---#----#-#-#----#-#---##--##-##--#-###-#####---##--#------##-----------##-
-#-----##--#-#----#---#-----------##--#------#----##---------------###---------#-------#-#-----#--#-
-------#-##----#--#----#--#----##-#--#--------#-#------#-##-##--#--#---------------#---##----#-##---
#-##-----##--#---------#--#---##-#---###--------#--#--#--#--------#------#-#----#-------#--###--####
------#-#--##--#--#-----------##----#---##----#-----##-#--##----#-#------#----#-#--#--####--#-#---##
--###-#--##--##----#--#-----##-----#----#-##-#-##---#----#--#---#----#-----------#-----##---#----#--
--#-##-##------#---------#--S#-----#--#----#-----#---#---###-----####---#--#-##----##--#------#--#--
--#----#----#-#----#-#--#-#--#-#---#--#-#------#---------#-#---##---#-##-###---###-#-#-----#--------
---------##---#------#-----##--#-----#---------#-##--##------#--------##-----#-----#---#--#----###--
--#--###-#----##--#---#---#-#------#---#--#-##-#-#-#---#-##--#---#---#-----###-------------##---#---
-#---###--#--#-#-###---#--#----#---#-#----#-#--#-----###-------#-#------#--#-#-----##--#--#-----#---
----#---#--#-#-#-#-##--------#---##--#----#------#-------###-----##-#------#-------#-#--#-#-------#-
-##---#-----#--#-##--#-#--------#-------#------------#----####-----#-#--#--##---------#--##-----#---
--#---##------###-----------#--#----#-#---####--#----------##----#--#-#--##--#--#-#----#----###----#
--#----#---###----###----#--##---#-##---##-#---#-#-----##-------###------#--####-##--#------#--#-##-
#------#-#-----#--##----#-#--#--#--#-#-##---------#------#----#--#---#--#-##--#-#--#--#-#--------#-#
----#--##--##-###-----#-#------#---#-##-#--#-----#-##-#####----##--#-##---#---##-##-#---#----#---#--
---#------#---#-#-#---###--##-##-#-#-##---------#--------##-#-#----##-##--#-#--#----##-##----#--#---
----####--#--#----#---#------###--##-----##-#--#---###---#-##----#---------#-#--#----#-----#--###---
-----#--#-----#------------####---######-----##--##-------#---##---##-#-------##--#-----#--###-###--
#---#-#----#---##--##-#------##--#---#----------#--#-###---#---#--#-#--#----------#--#--------#-#-##
--#-----##-------#----#-##-##---#-#-#--------##-##------------------#-----------#-##----#----#------
-----#------#--#----#--#-----#----#--#------##-----#--#-#-###---##----#---#----#-#-------#----##-#-#
----#---#--#----#---#--##--#-###-----###-#---#--#-##--#-#-#-#-#-#-#-#------#----#---#-#------#------
#--##-#-#-------#----#-##-----#---#-#--------#---#--##----##---###-------#-------------##-#----###-#
##----#--#------#--##-#-#-----#-#----#-----##--#---#----#-#-##-#--------##---#-#--#----#-------#-#--
-----#---#-----#-----###-#----------#--#--#--##---------#------#-##-#--#-#--#--#----##--#----#---#-#
-#------##-#--#--#-#-#-##-----#-#--#--#-----##-#-##--#-------#----#---###---#-#---###-######--#--###
-##--#----#-##--#----#-#--#-###-#-##-##--------###-###---------#--###----#---#------#---##--###-----
#-#--#---####------------#------#----------#-##-----#------#---#--#--###---#---#----#--------##--#--
#---#---#-#------#-----##-##--#--#-#---#------#-##-#--####--------#----#-#---##-##----#-##----#-----
#--#---#-#---------------##-##----#--###-#--#---#---##-----#-#--#---------#-----#--#----#--#--------
--##----##-----##--##-#-#-#-#-#--------------#-###--#-------#--#-#-#-----#--#---#--#-#----#---#-----
---#------#-####--#------#--###-#-#----##-#--#-#-#-----##------------###--------#--#-##-#-----#-#---
##--#----#-----#-#--#----#-#-#-#-----------#-#-#--#---#--##----#--#####--#--#-#--#-#-###--#-##----##
-##-#-#-##---#-##--#-##-#-#--#----#-----#---#--#-#------------##---#------#--------#--###---####----
##----#-##---#-##---#--#----##-#--#--#---#---###-----#-----#---###------#-----#-#-#-#----#-#-----##-
---#--#--#--------#--##-----#-####--#-#-----#-----###-#--#-####----#-#-----###---#-#-###----###----#
---#---#---###---------##----#-#-----##------#------#----------##--#-----#----#-----#--#---------#--
-#---#--##-#------#--#-#-#----------#------###--#-----#----##---##--------#-------#-#-----#------##-
----#-#----#---#--#---#-#---#-----#--#---#-##----#-#--#-#---------#--#-#---#-----##----##-----#---##
----#-###-#---#---##--------#------##----##-----#-#-#-----------#-##--##--#-----#----------##-##-##-
-#--#--------#------###----#-----#-###--##--##---#---##-#-#--#----##-----##-##-#-#-#--#-----##-#--#-
##----#--#--####-##-#-#---##----#-#-###-##-##------#-#--##------------#----##-#-##-#---------#-----#
###-##-##------------------------#-#---#-#-#-------#---###-----#-#-#-#--#--#-##--###--#-----------##
-#--#--##--##---------##--#--##-----#---#--#--##-#-#--##-----#---#-#---#-#--#---#---------#--#---#--
--#-#--#-#---#--#---#-##-#-#-#-----#----#---#-----------#--###-##---#--#-#--####-----#---#-####-###-
---------###-----#-#-#----#--##--##---####---#-###--##---#--#--#-#-----#-----------#--#-------#---#-
#----#-###-------------#-#------#--#---#-#--#-#--#-###-----#-##---#--#-----#-------#--#-#-##-------#
--#--##---#---###---#--------#-#-#------#-#----##-------#--#---#--------##-#-#-----#---#--#--##-----
-#-----##--#-###-###---#--#--#-#--#-#---##--##-##-------#--##-----------#-##-#--#--#---#--##--#-----
----#----#---------#-#--#-#--##-----#-#-#---#-#-#####----#----#--###-#---#-#--#--#-----#---#----#--#
#---#--------##-#---------------####--##--#---------#--------####---#----#--##--------#--##--------#
----#----------##--#--##--------##-#----#-#-#--#-----#--##--#-####--#----#-#---#---#-#---#---#-----#
---#--------#-##-#-#---#-##-------#---#-----##--#------#-#--#--#-#--##-##-#-------#-#----##---#-----
-##--#---#---#--#---##-------###----#------#-#-#-#--#-#--#----#-#--##---#-----#----#-#-##----#-----#
-#-#--#-------#-#-#-#-##-#--#-##----#--#--##--#-#---------#-#-----#######-#---#------##---#--#---#--
-#-#--#--#----##-------##----------#----------##--#-#-#-#-------------##-#-##--#-----##--#------##--
-----#-#--#------###-#-#-##--#----#--#------#-----#----#----###---#---#---#----#-###---#-----------#
#------------#----#-##-#---#--#----#-#-----#-#-#--#----#--------#------------#-#-------##-----------
#---------#-#-#-------##----#-##-##---#--#---#---#-------##-----#----###---#--##------###-----#-#--#
----#-----#--#----#-#-#--#--###-##---###---#----#----#-----#-#-##-####--##-#-##-----------##---#----
---#-#-----#--##-#-------###-#-#--#-#--##--####-##---------##-------#---#--#---------#---#------#-#-
---#--##-----#-----------#-#----#-#-#--#--#----#-#-#---#---#-#-#----#-##---#-##--##--------##-#----#
-----##--#-----#----#-#--#---------#-----##--#----###-----#-#-#--##---#-----#--##------#-------#---#
#---#------###-----##-------####-#-#-###-#-----#-###-#-##-#--#-#----##------#--##--###-----#-#-----#
-#---------##-------##-#--#---#---#--##--##----#-###-#---##---####-#----#--#-#--#--------#----#-##-#
---#--##-###-###---#-#------#--##-----------#--#---#-#------#--#--#---#--------#-#-#-#-#------#--##-
-#---#--#------##-#---------##---##-#--#--##-#---##--####--#--#---#----#-#-#-#-------#--#--#-#-----#
-#--##---##-###---#--#-#------#------#--#-#--#--###--------#-##-#-#-##-------#####----------#-###--#
