------#---------##--#----######-#-#----#-##---##-##--S-##-###--##------#-------#-###-#-###------#-##
#---#--------##-#-#-#-#-#-----#---#----##-##---#-----##---#----###--------#----------#-#-----#---#--
#-#----#-------##----#-#-###-#-#--###-#-#--------#-#---#--------#-#----##----###---------#-#----##--
--#-##---##------###---#---#-----#----#--###----#-------#----##-#-#-##----#------##--#--##-#---#----
------#--###------###-----#--#---##--#--#-#--#-#-----#----#---#----#--#-#----#-###-#---###-----#-#--
--------#--#----#--#-----#---#-#--##---##--#----#-##-#-#--#--#-#--#-------#-###--#---------#------#-
#--#----######-#--------#-#-----####--#-#-----#-----###-#--#--##----#---------####-------#-##----#--
--#-##--#-##-------#----#---##---#-------#---##---#-----##--###---#---#---#-#-------###-----#-#--##-
----###----------#----#-##---#---#-#---##-----##--###-----#----##----##-----###-----#-#-#-------#-#-
--###---####---###-##----------#-#---#-----#---#---------#--------##---#----#--#--#---#----#---#----
--#------------#----#-##-##-----#----#-#--#--#--#-----###-#--#-#####-----#####---#--#--#-#-#-##-----
#----#-#-----#---##--##-#---#--##------#-#-#--#--##----#--##-----##-##--#--##-#---##-------------#-#
-#-#-#-##--#--#-#-#-#--#--#-------#####---#-----#--###-------##----------###----#-##--------###---##
---#-#-#--##--#-------#-----#---#--#-----#---##-#---#---------###----#----#--#--#---###-#-##-----#-#
-#------#--------#-##------#-#----------#------#-------------#--##-------#-#---##--------#--#-##----
--#--#####---###--##-#-###-----##--#-#---#--#--####-------#--#--#----##---#--##---##-------#---##--#
#------#-#-#-#--#-----------#-#-#---#------#---##-#-#--#-#--#----#--#-#-#--#-----#--------#-----#-#-
---###--#-------#-------##----#---#---#---------------##--#-#--#----#--#---#------#-#--##--------##-
----#---#-----##-##--##-----##------#-#------#---#--#----##---##---#--------##-####-----------#-####
##--#-#----#----#---------#-#----##-----#----#------#-#-#--#-#-#--#-----#----#-----#---#----#-#---#-
#----#---#-------#---#-----###--#-#---------#--#--#-##----#---------#-#-----##-----------------#---#
##----------#-#-#--#--#-----#-#-#------------#####----#--##--#-#-----####------#-#----#---#-------##
-----##-#-#---##-----#----#-##--#------#---#--------#--#---#--#-#--##--##--#--#-#--#-#------#---#--#
--------#------##----#------####--###-#-------#-----##---##--#---##---##--#---#-#--###--------#-#---
--#----#--#-#---#----#---#---#----#-#-#--###------------#-----------#-------##--#-##------#-----#---
--##-----------#-#---#-----#------#-----#-----#--#--#-#--#------#--#--#------###--##-----##----#---#
#---#-#---#--##-##-##---#----#-#---##-----#-------#-#---#-------#---#-#-###--------#---#--#---------
--#--#---#--###--#--#-###---#--#----##-##-----##--#-----#-#---------###--#----#--#-----#---#######-#
-----#---#-#--#------------##-------#--#-#-#--#-----#---##------###-----#-------------###--#-###----
-#--##---#---------##---#--#----#------##-#---#--#-----------------#----#--#--#----##--###-##---#---
-----#--#---#----###-------##--#-#-#####--#--#-#--##----#------------#-##-##--#---#--###----##--#-##
--##---#----------###--#---------#-----#----#-----#-#--#-#-#-##---##------------#-#-----####---#-##-
-------#----#-#-#--#---#--##--------#-----####-#-#---#--##----#---#--#--#--#----#--#--#-#-#--#---##-
-----------##--#---#---#---#-#---##-----##-----#----####--#--#-#-#-##-------#--###---##----##-##-#--
#---###--#-#-------###-#-#------#---#--------###---#-----###-#-----#-----#--#--##-#--#-###-#-----#--
##--------###-#-----#--------#-#----#-##--#----#----#---##-#------#----##-#------#-#-----#---#---##-
#-#--##-----#-----#---#-#----#---#--#---#-----------#--#------#-#--------#---##--#-##-##-##---##-##-
#----##----##-#-#---##-##--------##--#---#-------#-##-#-----#----#-#-##--#-#-#------#----#-#-#-#--##
---##-#-#----##-----------#-#-#-#-#---##------#-###------#--###--###-------###--#--#---##-#####-####
-##--#---#-----------#-#----#-##------------##-###-#------#--------#-##---#-#-------#-----###--#----
-------#-------#-#---------#-----#--##--##--#-#---#-##--#-##-#----#---#--#---------#--##---#---#----
--##--#---------#-#---#-##-####--------#-#---##---##-----#-#------#-##---#---##-#-#-##-##--#---#---#
-----#---#---#--#-------#----##-#------#---##-----##--#--#---##-##--#---#--####--#-#----#-#---#----#
#-----##-##----#----#-#-------#--#------------#--##----#--------------#-#-#--#-#----###-#---##------
-##--##---#---#--#--#--#-#-##--##-#---#------###-----#-#-#-###----#--#----------#------###-#--#-----
-#-##----##-#-########-#----#-----#-#---###----#----#----##-#-------#-##--#-#-#---#--#-----#-#------
------#---####--#------------#--##--##---#-#-----#-------------#-#----------#-##--------#---#-##--#-
#-#---#-----##-#--#-----###-#--#---#----#----#------#-----##----#--#-#--##--#-##----#--#--------#---
-----#-----#----#-------##--#-#---#-------#----##--###-----#---#------#-#-###--#-#-----#--#----#-#-#
#--##--#-###----#---#----#-#--##---#----#----##---#----#-##----#-#--#--##-----#---#-#-#-----##-#####
-###------#-#---#-#--#----#-#-##-##---------#----##-----###--##------#-##--###--#-#-#--##-#----#--##
-##----#-----#---------#----#-------##--###-#--###-#----#-------##-#-#####---#--#####----#-#----#---
#-----#---#-##-#------##-------------#----------#---#-#-###-#-##------#--##--#--#--#----------#-#--#
---------#-E--#--####--#-------#-#-------#---#--###---#----#-#----#-#---#--#-#-#-#-#-#---#-#-#-----#
-#-#--#----##-#-#----#-#-##-##-#-##---#--#--#----------#-----------###-###-----#-#-#---#--#-----#---
--#----##------####----##-##--#---#---##---#---##-------#----##---####-##----#------#-##-#--##------
---#-------#-------#-#---#--#-----#--##------------#----#-#--#--#-#----#---##----##--##-----#----#-#
-#----##---##-##-#----------#---##----#-##------#-#----#-#---------#-------##--##--------#--------#-
--##-###-#-#-#-#--#------#---#--#-----#-#---------#-----#-###-#----------#--#-#---------#--#---#-#--
#-###-#----------#-------------#-#---#-##----#--#------#----##-----###---#--#--##----#---#----#---##
--#-#---#---##---#--#-#-#---------#-#--#-#--#-----##-------##-#--#-------#--###-##-------#-#----##--
--##--#------#-#-##------#--------#---#-#---------------##--#----#----------#--#---#--###----##--#--
-----#-----#---#-##-----#---##----#---#--------#--#-#-------##----#-#-#--#------###----#----#---##--
##------#-----#-##---###--#------#--------#---#----#--#-#-----------#--#-#-#--------#--##--#------##
-----#--#---#-#--###-#-------###--#--#-##-#-#-#---#-----------##---#---####-##--###---#--#---#-#--##
#----#--#--#---#-------------#--#-------##-----#--#--#-#--#--------##--#----#--------#-#---##--#-#--
--#-#----##------##--#-#--#-#--#-------#---#-#-#-----#---##---#-----#-#--#------#--##-##------##----
--#----#-#---------#--------------#--#---------##-#-------#-##-----###---#-#-#---#-#--##-#-##-#-----
#--###--##---##----#----##------#-#-#---#---------------#-#-------#-##-#---------##-#---#--##-----#-
--##----##--#-----#-#-#-##--------#--#-#-----#-#-#---#---#---##------#-#--##----#--#----#-#----#----
#-##--##---#--------##--##---#--#--#------#--#---#-##----##-#---#---#-----#--------------------##-#-
--###---###----##------#---#----#-##-----###-#-----#-#-###----#---------#--#--------#-#-#------#--#-
----#-#---##--#--#------#------#--##-###----#---#-----#---#---#---#---##-------#--#--##---#----#--#-
---#------#-####------#-#-##---##-#-##--------###----#-##----#------------#-----##-----------###--##
-#---#-###-##--#----#--#-#------###----#--#----##-####-#--#-#--#-#--------#---##-----##---##--###--#
---##---#------#---------#-#------##-#-----##-#-#----#-#-----------#--#--#-------####---------------
##---#----#---#-#---#-#-#-------#-------#--#---#-#-#-##----#-#--##---#----#--##--#---#-------##--##-
----------#-----##---#-----#-#--------##---##------------#---#--##-----#--##--#----#----#--#----#--#
#-#-#--------##--###------#-#---------####---##---##-##-----------#--#-----#---#--###-#----#-#--#-#-
#-----####--------#----#--#-##-------#--#-#----------#-#-#-#-#-##----#---------------#------#-#---#-
#-----##---#-###----------#----#-------#------#---#-----#-##-#-----------#-#---#--#-#-#-------#-----
##-------###---##-#####---#-#-#--###-#####-#-#-#-#-#-##---#---##--#-###--#----##---#-##-##-#--#---#-
-#-------#-##-##--#-#--#-#-#--#-#--##---#####--#--------#-##-----------#####---------#-------##--###
#------#-#-#------------#-------#-----###--#--##--##-----##---##---##------#-#-#--------#--#--#-----
---#--------#-##-#-#-#--##-----#----##--#--#-#----------#----#------#--#-#--##------#-#--#---##-#---
#------#--#-----#--#-------##------------#---#---#-#----#--#----#--##-##---#-##-#--#-----------#----
-####-#-###-#-#-#-#-#--#-#-#-#-###--#----#---#-#-#-------#----#--------#------#----#---#-#--##------
-#------#-#---#-----#--#----#---#-#----#-#----#----#-##-###--#---#--##--#-#------#-----##-#----##-#-
-#-##---------#-----#---#----------###-----####----##---#-#---##--##---#--##---#--##------#--##--#--
---##-------####---#----#---##---#-----#-##---#------------#---#-----#--#--##---##----###---------##
---#---#-----#-##------##-#---#-#---#-----#---#---#--##-#-----#####-#--------------#------#---#--#--
-##-##---#-----------##-###-###-#-#-####---##-#---#--#---#-#---##-----##--#--#-----------#---#-#----
--##-------#---#---##-----#------###--#------#----###----#--#--#-----#--##----##--------#-#####-###-
-#-#-##------#----##---#--###----#--#--#-##-#---#--------#-#--#-#-------#-##----##------------#-##--
#-####-----#---#--------#-#-#--#-#-#----#-------####--#-----#-----##-#-##-#-#--###----#----##-------
---#-##------#-#-#----#--------#-#-#-###-###-#--##-##-----##-#--####----#-##-----#-#--#--#------#-#-
-------------#--#-#----##-####----#-#-------##-----------##-------------####-#-####-#--##--#--##----
-#------------##----#---#----#---#--#--####---#-#--###--#--##--##----#-----#--#-###--#-###------#-##
---#-###----#------##-------##---#-#---#-----#------#-#------#----#---------##---####-----##-----##-
##--#-----#-#-#----------#----#----#-####--#--##---##---##------#-#-#---#---##--##-#------#--#---##-
