-####-#---#---------#---#---------#----#-#---#---#----##-#-#-##-#---###-##----#--####-#-#-#--------#
-#-#----------##-#--#----#-------##-##------#----#---###---#-------#---------#-#--#----#----######-#
#-###----#--##-#---#--------#--##---#-#-----#-##-#---#-##--------#-----#--#-#-#-##--###--#--###-#---
-##-#--#-##-#---#-#-----#----#--##-#-#-----#-#--#-#--#-----#----------#--#--#------#---#-#----------
####-#----###-----------#--#------#-#------#-##--#-#---#----##---#-#--##-#---#---------#-##---------
#-----##-###-----------##----##-##-#--##-----#------------#--#--#--###-#-----##--##-#-------##--#--#
#-#------#---#--#----##-#-#-#------##-----#--#----#-#---##-#--#---#--------#--#--#-#--#------#--#---
###-###---##--##----#-------##---#---#--#----##---#--##---###---#-#--#------#-#-####-#--#---#-#-#--#
-#--#-------#-------#-----#-##---------#--#---##---#---------##--#-------#--#--#--------------#-#-#-
-#-------#-##------#--##----##-####-------##--#-##-----#---#-#-#--#----#----#--------#----#-----###-
-##------#-####----------#---#--#-----#--#-#---#------#-----#------#--#---##-----#-#-#-#--#--#----#-
---#---------#------##--#-------------------#---#---#-------#----#-#-#-##--####-#------###--#--#-###
###-----#-##--##---#---##----##-#-----#-#-----#-----#-#--#--#-#-#-----#---#---#--#--#--------#-#-#-#
-##---#-#-#------###----#--#--#-S#---#-##----#---##--##---#-------##-#--##--##-#-----##------#-####-
#-#--#---#-----#-#---#----#-###-#------#----------#----------#-#----#---#----##-#-#--#--------#-#---
----#-----####---#-------#----#----##-#####------#--#-#---##--#-#-----#---#-#-#----##---##-##---#--#
--##-----#--#-#--##---#---#-----#-###--#--#-###-#--------###---#-#-----#-#-----#-#----#--#-##-##-##-
-#------#--#----#---#----##-----------#--#-#-------##--------##-#-##---#-#-----#-------#---##-------
-#--#-#-----#-#-#----#-#--##---#-##--#-##----#---#---------#-#-##----###-#-#--###----#-#-##-#----#-#
-----##---####-------#----#-#-----##-#----#-##----#--#---#-##--#-#-------#-#----#------#-#---#-----#
--#--##--#--#--------#-##-#--#-#-#-#----------#--#----##--#-###-###----#-#-###----###-#---#---#----#
-#-----------#--------#--#--#-#--#-----###--#--##--------##-#-##-#------#-#--###--------#--#--##---#
#--##---##--##----#-#---##-#-#---#--------------#-##-----#-###-#####---#-#--#------#-----#---#----##
----###----##-##-#---#-----###-#-#--#--#------#--#--#------###---###-#----#--#-#-##-#---#--#------#-
##-#-#--------#---#-#-#-##---#----##-#--#-------#--------##-#-#------##-#------##---#----##---#-##--
--##--#----#--#-#----##------#--#-#-###-------##-##-#-#-------#-#---#---------##----##--------#-----
###-#-##-----#--------#-#-#--###-##----##--#--#----------#-----------------------#--##---#-------##-
-#-#----#---##--#-#--#-----#-##---#-----------##-------#-----###-------#-#-##---#----##-##---------#
----#--##-#-#---#-------#--#-##------------#----#-###----#-##------------#--#-------####-#----#--###
---###-------#-#---------------#----##-#---#--#--#--#--#---#--#--###---#-###-#--#-#--####-#-##----#-
--#-------#----##-##---#----##-------#-#----------#----#-##-----------#-##-----#--#--#--#----#---#--
---###-#----##-#----##-#---#---#-----###-##-#---#---##---#-#---#-####---#---#-#-----------##---##-#-
--------------#--#-----#----------##--###----------#------#--###-----#----#---#-#---#-#-------#---#-
##---#-----#--##-#-------#--#--#----#-----#---##----#--#----#--#-#---##-#---#-####---#--#-#--------#
#-##-#-#---#---------##----#-----#-#-#--#-###---#-#-#--#--#--#----#---###--##-#-#-#---##----##-----#
----#-----#-#---#-#----#-##-#----##--##-----#-#--#-----#-#-##--#--------#--###--#------###-----#-#-#
#----##-#-#--###--##-#---###---#-#------##--#---#------##--#-----#---####-#---#-----#---#----------#
----#---------##-----#---------#-#--#---#-----###--#--#-------#-#-#-#--#--#--##-##-#------##--------
#------##--###------###--#---#-##--#-----#---#-----##--#-----#---#-#---#####-#---#-#-#--#--#--#-#-##
--#--#-#--##--#--##---#-----##---#---#--#-#---#-#---#--#-##-#--##--###-----#-#--###---##----#-#--#--
---#-#---#--------#---------------#-----#---#-#--------#-#------##------#--#-##-#---#---#--##-#---#-
-#---#--###---#-#---#--#-----##-------#---#--#-#--------#----#----------------#-#-#-#------#--####--
--#-#------#-------------------#----##----------#-#----#####--#-#--#----#--#-#-#-#-------------###-#
---#-----#----#---#--#--#####--#-#-#-###--#------#---#---#-------#----#----------#----##-----####---
--------#-##------##-----#-#----#-----#---##------#-#------###-#-----#-----#-#---#---###---#--#---##
---------##---##-####--#--#----##--#---#----#--#-----------#--#-#-#-------#------#--###---#-#------#
-###-#--------##-##--#----##--#--#-#---#-----#-#-###----####-##---#-##---#---#--#----#-#--------#---
#---##-#--#--#---##----#----------##-#-#-###-#-#-----####-#-#-#---##-###--#-#-#---##-#------#-------
##-####-##--#-----#----##-#--##---#---##-----#-#----#-----#----#--#----####---##--#--##-##-E----#---
#-----#----#--#------#---------#----#--------#---#------------#-#-------#---#-#-#-------#----#------
--##---#---#--#-#-#-#-#-#------------#-#-#-#--#--#--#-#-----##-#---#----#-----#---------#-----------
--#---------#----####-##-------#-##-#-#-----#---#-##--#-##---###----------##-#------##---#---#---#-#
###-###--------##-----#-##---#---###---------###---##--#--------#-#---#-#-#--#-##---#--#--#---#-#---
-----#-#------#-------##----##-#--#---#---#-##-------#-#---#------------#-##-#-#-----------#------#-
------#####-----------##--#-----##-###----###--------##-----##-##-##--###---#-##-#-----#-##-----#---
-----------##---#--#-#--#-#-----#---##-----#-##-#--##--#----#------#--##----##-----#-##----#--------
--##------#--#--#-#--##------#-##-#----#-##--#--##--#--#----##-----#####-#--####-----#---#------#--#
-#-#---#-#-#----#--##--##-####--##--#---#------##-#------#---#--------#--#--##-#-------##------#----
---#--###----#-#-------#-#-----###------#---#-##--------#-##---#------#-##---------##--#---##--#---#
#-#-#------------#-------#--#----#--------#---#-#------#-#----##-------#--------##----#-#--#-------#
##----#-------#-#--####-#-----###-------##-#-#####----#-#--##-#-#-------#-###--#--#-###-#---#-#--###
#------#-----#-------##-###---##-#####-#----#----#####--#-#-##--##-#-####-#----#---#----#-#-#--#-###
----#-#-----------#-##----##----##-##---#-##--#----#-#-##-##--###-------#-----#--#-##-------#--##---
-##---##-----#--###---#-##---------------#-###-#--#---#------#-##---##-----#-#---------#--#-------#-
-#-###-###------#-###-##----#--#----#----#------##---------###-#--#--#------#-#---##-###--#---#----#
---#---###-##--#-#--#-----##-##-#------------#--#-#--#-####----------##-#---#-##--#-------------#---
-#-##----#--###--#-#--##-----#---------#---------##-#-----#-#---##--#-----#--#---##--#-#-#-##--#----
----#----##---##-#---#-#-#-#-#--------##-##--#-#----------##-####--##--#-----------#--###--###----#-
###---#--##-#----##--#---#------#--#----##--#--#-#----#-------#-----#------##--##---------#--#----#-
---#-------------#---#-#---------##-#---#-#-###-#-------#--#---#--#--#####---#------#-#---##---#----
----#--#-#-------#----#----#-##--#-##---------#----------###-----#-----#---##-----##--#------#-#----
###-----##---#----#--#-----#-------#-------##------#--#---#--##------##--------#-#-#-##-#---##----#-
#--#---##--##-##--------------###-##--#-----##--------#-#-##------#-#---------##--##--###--#--------
-#-##---##------#--#-###--##---##-##-#--------##------#-#-------#----#-##------#--#----#--#-#-----#-
--------##---##--------#---#---#--#-#-#--##--###----##----#-###----#----#--##--##--##--#-----#-----#
-------#-----#--###-#-##---##--#--####------#--#------#--#----##----##-#----#--#-###--#-#-------#--#
#-#-#-#-#--##--#------#-----------#----##----#---#---##--#---#-----##-#-------#------##-##---#------
-----------------#------#--------##--##--#-#--##---#---------##-##--#---#--#-----#---------#-----##-
--##-----#-#--#--------------------#-#----------##-----##-------#---#-----#-----##--#-#---##--#--##-
--------#---#-#--#--##-#---##--#-##-#-#-#----#----#-#----#-##-##-#--#--###-#-------#---#-#------#--#
------#-#-------#-#--#---##------#-#--##-#-#-#-#--#---##--#####--##--##--##-#-#--##--#--###------#--
---#-----------#-#----#-#---#------#--#----#-#-#-#-#--------#----#------###-##--#--#----#----###----
---#-#-#----##-#-#-----------#----#--#---#-#--#----#----------#-----#--------#-###-###---##-#--#----
#-------#-###-##---#--#-----#---##--#-------#------#--##-#-----#---####---#---#------#-##-##----#--#
#-##--#-----#-------##-#---#-###-##---#-##-##-------####------##---------##-#-----##--#-#-##-----#--
#-#------#--#--##---#-#-#----#--#----#---#---##-----------#-------##--#--#-#---#--#------#-#-####---
#-----------------------------------##----#-----#--#--#--#--#------#-----#-----#----##-#--##-#---##-
-#####--#------##-#--###-##-----#--#-#-----#-#---#---#---------####-#---#----##--#--#--##--#-#---#--
#--#--###----##-##---------#---#-#--#----##---#------#-----##----#--#--#--#--#####-------#----#--###
-----#--##-#--#--#---##-#-#-----#--#-----#-----------#-####-##---#---#----#-------------#-##--#----#
--#-#---#--------#--#-#--##--------#-----#----#-----##---#------#-#-#--------#---#-#-------#-----#--
--#--##--#--##-#-#-##--#-------##-#---##--##-###--#----#-#----#--#-###---##---#---------#----#--#--#
---#--------#-----##-----------#-----#-##-#----#--#------#-###--#------------#----##---#--#--#-#--##
-----#--#-##---------##---#---------##-#--##----###-----#-#-#-#---#####--##-#----####-###--------##-
-----#---#-##-#--#----#-#--#--###-#----------##---#-#------#--------#-#---#---#-#--#--##-----#---#--
----#-----#---#---#---#--------#-##----#--#-------#--------#-####------#-#--#------#------#---##-#--
#----------#---#---#-#-#---##-----##-#---#----#-#------##----#-#--#-#---#-------#-#-------#--#-#----
-#----#---#-#--------#--------#---#--------#----###--#-----#--#------#------#---##---##-#-#-#------#
#----#--##--#--------#-#---------##------------------------#-##--------#---#----------#-#---#------#
--#----###-##-####-----#-#---#-#------------#-#--#-#----#-##-#-------###---#--#-------##------#-#---
