------------#--##------##--##----##-#-#-#----#----#####-#--#---#-###--#####---##-#-------##---#-###-
---------##-----------#---###-####-#---#--##---##-#-#--------#----#---##-------#------#-##--#-##----
###-#-#----##-####---#----------###-##--#-##----#--#--##-----#----------#-----##--##--##------------
----------------#--#---#---#-----#-#------#-#---##-#--------------------#-----#----#-#-##-#-----#---
-##-#--#-###-#-#----#---#--##--#---#------#--#---------#-----#-----###-#------##-------#--#-#-##---#
---##-##-#---##--#---#----#----#--#--#--#--#-##-----##--#-#-#-----##----#-----#---#-----#-#---#-#-#-
-#-----#--#-#---#--#------##-#------#-------------#-#-#--#-#----#----##--#----#-------#---##-#---#--
--##----#--#-##-##----#---#------#--#-#-----#-#--#-###---##-#-#####-###--#-##------#-#----##----#-#-
----##---##-#-#-------#----#-----#---#--#----#----#------#------------#-----------##-----##-#-#---#-
-------------#-----#----------#--#--------#-------##------#----#----###-#--#---#-#-#------#----#----
##-#--#-#------#----#--------#----------------#--#-###-#-##-------------#--##------#---##-#--##---#-
####--#---#---------------#--#--#------##-------##---#---#-##-##-#--##---#---##----#-------##-#---#-
-#----#--###---###--#-#----##-#------##----###---###----#----###-----#-----#-------#------#-----#-#-
###-##--##-#--#-##S#-#-#---#-#-#---##---#---------#-##----###--#-----------------#------#----#--#-#-
###----##--#---#-------#---#-#-#--#-#--#-#-#--##-#-#-#------#--#----#---------##---##---#------###-#
----#---######---#----#-----#---##-#----##---##--#----#--#-##-##----------#---#--##----####--#-#----
-####-#--#-##-----#------#----##-#-------#----##-#--##--#--------##-#-----#--#----------##---#---##-
-#-----#-#----#------##---##-----###---#-###---#--------#-#---##-#----#--####-##-#-#-##---#---#--#--
-#--------------##------#------#---###---#-#-----#--------#-#-###-#--###--#--#---##----##-----------
---#-##-#-#-#-----#-#----#-------------#---#-----#------#---##--#-------##-###---------#---###-#----
---------#-#------------#---#-#--#-#--#-#----##-----#--#------###-#--#----###---##-----##-#-----##--
#-#-#-###---##--#---#--#####--#----#------##-----#----------##-#-#---#---------#-----##-##---#-----#
--##--##-------#--#---#--#-----#--##-----##---------##----#---#--##-#----##--###-#---#--------------
-#--##-#--#--#--#--#---#--####-###--#---#-#-#-----#----#---#-#--#-##-#---#----#----#-#---#-#-#-----#
---#--------#-#--#--------##-#--#--------###-#--#-#--#-#---###----##---#-#----#--#--##-----------###
--#--#--#--#------#----##---#--#--------#----#-#---#--#------#-###-----------#-----####---##----#---
-#-#-#-#----##------#---##----##-----####--#--#-#--#-----###-##--#-##-------------#####-#---#-#-##--
#-####-#--#--##--#----##--##---##--#-#--#-#--#---#-------#---------##-#------#----####--#------#----
##----##--##--##--#---######--#--#--#------#----#-----#--#------##-----------#-#---------#-------#--
#---#-------#--#--#-#--##--##---#---##----#---#----#-###--##----#-#----------##-------####-----####-
##-----#----##--##-----#--#---#--------#-#------#--#---#--------##-#-----##---#------#--##--#-----#-
#-#---#####--#-##---#---#----#---###--#------#-----#-------#-#----#-#-#--#-##----##-----#-##-#---#-#
--#-#------------##--#-###-----###------#-##--#---------#------##-#-----#------------###----------#-
###--#-----#-###-----#-------#---#-##-----------##-#--#-#----#----##-#--------##--------####--------
#--###-#-#-----#--------#---#--------#E--#-------#--#-#---#-------#--#-##----#-##----#----#-#------#
-#-#------#-##--#----##--#-##---------#-#-------#-----##--###-#------##--##--#--#-----#---#-----#---
#-----##-#----#----------#####-#-#----------#--#-###-------#---------##--##-##----------#--#--#--#-#
#--------##--#-##--#--##-#-##-#-#---#---#-##--------#----#---------##---#--#-----##---##-#---##-##-#
-#---------------#----#--#---#-------#--------##---#-####--------#-#-----------#--------#-#---------
---#----#-----#-#---##--###-#---##----#-#-#-#---#--#--------##-#-#--##-#---##-----#---##--#----#--##
#-----##-#-----#-##-#--#-#---#----#--------#--#---#--------###-#--#----#-#-##-#-----#####-----------
-#----##------#-----#--------------------#-----------##---#-#----------#--------#-----##---###---#--
-------#--#-#----#---#-#--##-#----#------#---#---##----###-------#---------##------#-----#---#---#-#
----#--#---------------###----###---#------#-#-#---##---#---####--#----------##---#--#----#---#-#-#-
------#-#-###----##-#------#-----##--#-#-##----#---####----#-#-#-#-##----###----#---#----#-#-#----##
---#------#-#-#-#-#-----###--#--##-----#-#----#--#----#-##----------#--#---#-###---#-###-------##--#
#-##----#------#--#-----#-##--##-#---#-#-------#---#----#--------##-----#---##--#-#----#------#-#---
--#-----#------------##----##--#---#----#-#--###-##----#----#-#-###-------##-###---#--------#-#----#
#---#--##--#---#---####----#-#--------#---#-#----#---##---#-##---#-####--#--#------#------#-#---#--#
------#---#-#-#-#-#---#--##-#-------------#--#---------#----------#--#-----####----#---#--#----##--#
#-----#--#-------#------##--#-##--#-#-#-#--------------#--#--#--#---##-----#------#---##------#--#-#
#-------#---#####---#--#---------------##---#-----#-#-#--#-#---#------#---#-#-######----#--#---##---
----#--------##---#----#--##-#---#------#--#--#----#--#-#-----#---#------#--####---#--#-#------#-#--
--#---#------#-###-#-#-#---#-----#----#-----#--#------####--##-#-#-----#--##------#-#-#---#--##-##-#
-----##-------------#-----#-####-------------#-----#---##-------#-#-----#-------------------##-#---#
----#-#----#--#---#---#-#------#------#-#-------#----####-#-###-#---#-#-#---#-----#-#-#---#-#-#---##
-#--##-#--##---#--#-##----#----##-------------#-------#####----#----#-###-#-#--####-##-##-###-----##
#-----#--#--------##-------------------#-#---#--#----#---#---##--#-#-##--###-#---#---##---#--#----#-
###----##--##-#--###--##-#-#----####---#----##---#-#-#------#-------##-----##-####------#----#------
-#---###--#-#-#--##----#-#--#-#-------##--------------#--#---#----#----#-#---#------#-###-###---##--
#--##-----#--------#-#-##------#-#--##-##-#------#-###-##-#--###----###-----##---#-------#---##--#--
--#----##--#--##-----#---###--#-#-----#---#-------#-----##----##--#------#-#-##--###----#-#--#----##
--------------------#--#--------#-----#-#-#--##-#-#-#----#--##-#--#-----##--##--#-----#-#-#--#----#-
#--##----#-#----#----------#--------#----#--#-----#--------------------###---------#---#---#-----#--
###----------------##------#####--#--#---##----------#-----#-#-------#--#-##-#---#-#----#-#-##---###
-----#-##------#---#-######---#--#--#---#-#--##----#---#--#-##-------###--------#---#-#--#---#---#-#
--#----#-#--##-#----#-###-----------#--------------#--#--------#--###--##---#-#-###-#-#--###------##
---###-#-----#----------#-----#--##-#-#--#-----#----#--#--#--#-###-##--##------#--------------##--#-
-------#-------###---------#-----##-#-#------#-##----#--------------#--##-##------#-##--#-#-##---#--
--#--------#-##-----#---------##---#--#-#--##--#--#---#---#-#-#-#------##-#---#----##--------------#
------###-#-----#--#----------------##-----------#-##------##----##--#----#------#---------#----#---
#---#-##----###--#-###-#---------#--#------#---#-#----#---#-#-#----#-#---##--------#------#----#--##
-#----#--#----####-#-#----#--##------#-#-##----#--###-##----##-#-#-----#--#---------#---#-#----##---
-##-#--####----#-#-#--#----#---#--####-------#------###-##-#---#--#-##-----#---#------#--#-#--#-###-
--#-------##--#-#-----#-------###---#----#---#----#--#------#-------###-#--#--#------#-----#-##---#-
#--#--#-#-------#-##----#-#------###-###--#-#-#-----##-##----##----##-#---###--#--#####---------#---
---#-#----#--------#---#-#---###----------######-----#-#-#-#---#---#-----#-#-#--###-#-#------#------
----------------#-#-----#------#--#--#-#--#-------###-----##-##----#--#---------###--#--##-------#--
----##-##--#-##---#-##---####-#--###-----------#-##---#-#-####-------#-#-#-------#-#---##--#-----##-
--#--#--##-------#-#--###---#---#----#-#--------#--#--##-##-#-#-#-###-#-#----##------#---#----#--#-#
-#----##-#---##--------#----#-----#--------##--#------##-##---#------#---#--##----#----###---------#
----#------#-#--#--##----#---#-#--##--#---###-##--###----#-##--#-#--#-------#----##-#---------#-#---
-#-#---##--##---#-#--#-------#----#----#--#----###--##---##-#-----#-#--#-##------#--#---------------
#-----##------#--#-#--#-#--##-------#----#----#---####--#----##----####-----#-#-#-#--#--#-----#-#---
#-#----##-------#----####-------#--#---##-##-#--#------#-------------#-#-#-#----#-----##---#--#-----
#-##------#--##-###-##---#-##---#--#---#-#--#----##---#--##-------####----#--#--##-###-----------###
---##------##-#-------#----#-----#-#--#-#-#####-#---#----##-#####---#--#-##-------#----##-###----##-
---#------###--------###---#----#--###-#--#---#---##-----#----###---#---#----#-#-#-#---#-------#----
###----------#--##-----#-----#----#------#-#--#--#-#-##------------#-##-----#-####-------#-#--#-#-#-
-#-#-#-##------------##------#-----#-----#-#----#---#------##--##-#-#--#-##----#-##--###-##---------
-#--##---#----###--#------#-#--##--#-#-----##--------#---#---#--#-------------#-----#-#-------#-----
---#--#--#---------#------##----##---#-#------##-##---#-#--#----#-------#-----#--####-##-#--####---#
-##------------##---##--#--##-#-------#-####-###----#---------#---#----#------##--##-#-#-#----#-##-#
#-#--#---##-#--#--##--#---#------##--#-#-#-##-###--##----#--#---#--#--##-##-#-##---#--#---#---#-#---
##--#-#-#--##-#------####-#--##----##---##--#-###-##-----#----------#---###-#-#---#---#-#-#-#-##-###
---#####--#---#---##----#--##----##--###--#-#--##--###--#--#-#-#--#-#-----#--------------#-#-#--#-##
##-##--#-----#--#-#---#---#----------##-####--#-------#----#-------##------#---##--#---#--#----#----
#-#----#---###--##-----#-######-#---------#-#--#---#------##--#-#--#---#---#----#-#-----#--#--#----#
---#-#---#---#-#-----#-#-#-#-#---#-##----#---###--##--###----#----##--#--------###--#--------#--##--
-##---#--------#-#-####------#---#-----#--#----#--#-----#--##------#----##--##----#--##----##--#----
