-#--##---#---#-#-#-------------------#-#-#--##--#------###----##---#--------###----#-#---#---------#
-----------##----#---#--#---#-#-#-#----------###---------##--##------#--#-----###-#---#-#--##--##---
--#--#----#---------##---#-----#-#--#----#---#--##---##-#-##-----#-#----#---#---#-#---###--#---#----
----#--#-#---#-###-----#----#--#---------#-##----#----#---------#--#---##-#-#---###--###--#------#--
--------##---#---#------#-#---#--#-##----#-#-###-#--#------###--#-#---##-#----#---#---------#--#-#--
#--#-##--#--------------#----####--##-#-#-#--#-#------#---#--------#------------##-#--##-#--------##
-###--#-#---#--#-#--###---#-#-#----##----#------------#-#--##---#---#-##----#-#-##---#-------#------
###-#---#----#----####---#-#-----------#-#-##-##-#-##--#-##---#-----#--###--#----#--#-#-####-#-----#
#----#-###-#-#--#-------#----#----#---###--#-#-#---#-------#---###---------###------#--------##-#---
-####-##-#--#-#-#-#------#--#-----------#---#-#-#----------#-#------#-###-----#--#-#--#-#----------#
--###--#--#-------##-----------#---#-#---##-#-##--#-------###---###-#---#-#-#-----------#-----#---#-
---#----------#------------#----#-#---------##---------#-#---#-#-#----#-------------##-#--###-#-----
-##-##---#----------##--------#-#--#--#--#-E#--#---#---------#-#-###--#------###--#--#-#--#--#---#--
---------#-##------#----#--##--###------#-##-------##-#-#-#----#---#--##-##-----##-#-----------#---#
----###-----#------####-#---#-#----#----------#--#-##-#--#---#---#-##--#-----#----#-##------#--#----
----#---##-#-##----#---#-----#---#---#------#-###-------#---#----###------##----#-#-#--#-----#-#--#-
---------#---#-#-------#--##-----#----#-#---#-##-#--##-#-#---#-#---#-#--#--#--#-#------#----##--#-#-
---#--------#--####---#---------#--#----#-#-#---#-##------#--#----##-----##---#---#---#-#-#---#-----
-#--#--##--##-#----##-###---#-##-##-----###---#---#---#----##---#--#--#-#----#------#-----#--#-##---
-#-----#--#---#---#------##-------#-------#----#--##--#-##--------###---#---#---#----#--##--#--#-##-
--#-------------#-#----#-#--#--####-------------#--#----#--##-------#-----##------##-###-#-##--##-##
##--#-#---#--##---#-#---#----#--#--#----#--####-#-#-#--#-#--#---#-#----#-------#-###-#---#----------
#---#---####-#---###-------------##-#-----#----###-----#-#-####-##-#-##--#----#--------#---##----#-#
-##------------##-#-##----#------------#----###-#----##-#-#-----##---#----#-#-------#-##-#---##----#
#-#---#--------#--##---##--####---#------#--##-#-------#-------##--##--#----------------#-#-#--#-#-#
-----####----##--#----#-##--#---------###---------#-#-#-#--#-##---#-----##----##--#-------##---#----
---##-#--#-----#-#-##-#-#------##--#####----#-------##-------#-#-------#-#----#------#---##---#-#---
-#---#-#--##-#---#-#------#-##-##---##-##-#-#---#---#---#####-#---#-#---#--#-##--##-#--#--#---------
-##-#--#---#-##--#--#-------#-----#------##---#---#--#--------#-#--------#------------------#-----##
-#-#----#----#------#----#----#-----S--#--#-------#--#---#--##----#----######-----#--##-#-#----#----
-----#---------#------------#-##-#----------##-#-##----##-##--------#-#--###--#--#-##--------#---#--
-----##-----#-##-------------##--#--#---#---#-##--#--##---#-##-#----#----#---#---##-#-#----##---#--#
#-#-###--------------#--#--#---#---####--##------#----#---##-------#---##---#----##--#---#-##-----#-
#--#-----###--------#--#-##--##-#-----###-#-##---#-#---##---------#-##----#--------#-#-----#----###-
-----#-----#-#--####-#---######-#---##-#-----#-#--#--------#----#-------------#-##--#------#--#--##-
----#--#----#--#-------------#-#------#--#-#-###-##----##-##----#---##--##-##-###--#--#-###----#----
----#-#---#----------##----##-##-----##---#-------#----#-#----------##-----#-----#---#-#-----#---#--
---#-#-----#---#--#----------#---##-#----#------#--#-####--#####-#--#--##-#-#-----#-#-#-----#-------
---#-#-##-----#--#-------------#--##---##------#--#--------#-#-#--#---------------#--#-------#------
-###----##--------#--#---#--#-#---#-#-------#-#----#---------##-----#--#--#--##-------#----##-##---#
-#-#-##---#--#---##--#-#----#-####-#----##----#---#---#--#-#--##---##-------###-##------#--#-#--##--
-----##---#--------#-----#--#---------------#----####----#-----#----##---#-#-#----#-#----###-----#--
-#-#---#------##--##-#-###--##-#-#----####------#----#--#-----#-----#-#--#--#------##-#-#---#-#---#-
----#------#-----#-#----------#------##---------##-#-----#---#-##--#-####-------###-##-#-##---###-#-
--#----##-##-###-##-#---#-#-#--#-#-#-#--##-#-#----##--#-###---###-----------#---#---#-----##-------#
-#------#---#--#---#---#-#-#-#--#---###-------------#-##--#-----##---#--#-###--#-#-##--#--##----#---
---#---#--##-##-##-###-#-------##----------#-#-##-#---#-#-#-----#-#-#--#----#-#--##-#---------#-##--
#-#-###-#-----#--#---------##--##-####-#-#------#---------#-#--------#--#--#-##--------------###-#--
---##-#-#--------#-#----##------#-#-----#-#--#--#-------------##----#-----#-------#-##-#---#---##---
-----##------##-##-#--#-#-----##-#----#--##---------###---#--#----###------#---##---#-#----#-#------
#--##--#--#-#--#--##------##--###---#--####-#---#-###---#---#-#--#--#-#----------------#-#----###-##
-#-#-#-#----##-#------#--#-#-#-----###-#---###-#--#-##-------##----#----##---##--#---#----##-#------
---------##----#---#--#-#---------####----#-----#----#--#-#--#------#--#----#-#--#-------#--##--#-#-
#--#------###-####-#--------##-#-#--#----#--#--#-----##----###--------#-##-#-#-#--#--#--#-----#---##
------###-#------##-##------#--#----#------------##-#--------#------#--#-##--##--##-----####-----#-#
##-#-#-#---#--##---#-#------##-#-------##--#-------###-##--#----#-----#-#--#---#-##-#-#-------###---
---------#-##-##-#----------------#-##---###----#-#---##-#---#---###-#-##-#------#-#--#--##-#--#---#
------#-----#---###---####-#-##--#-##------##----#-------#-#------##--#----#----------------------#-
#-#--#--#--##-##-#--#---------------#-#-----#--#-####----#--##---------#--##--##------#---------#-#-
---------------#-#-##--##------#----#-----#---#-----##-###--#---#-#-----#-#-#------#-#-------#-----#
---#----#--#-------#-#---##-#---###--##-----#-#--#-#-#-----------------#------#----##--#--#-#-#-#-#-
-------#----##-##--#--##-------#-#--#--#-----#-#-------#-------##----#---------#-###--#--#------##-#
-#---####-----#-#-##-------##-#--#---##---###-#----------##------##----#----------#----#--------#---
----#--#-------#-##-##---------#--##--#---#-#--#----##-------#-----##-#---#-------#-#-#-##--##-----#
---#---#--#---##--#-###----#-------#---------###-----------##-#-#--#-#-#-#-###-------#--#-#----##---
#---#----##-------#-----#---###-----------#---###---#------------##--##-#-#--#-------##-#---#-#--###
-##---#-#####--#----##----#--#-#--#----#-#----------#--#-#--#---##---##--#--#-----##-##-----------#-
--##---#---#----###--##--#---#-----------##-#-##------##-#-###-#-#----#-###--##---------------------
#-#-#---#--#-------------#----#-#-------##--#---#-##-#----#--#--------###----#---#-----#-##--##----#
--------#-#-------#---#----#--####----##-#----####---#-##-##--##----#-----#-###----------##-##-##--#
----#--#--#---#-------#--##-#--#------#-###---#----#--#--#-#---#-----#-##----#-#---###--######----##
##----#----#----#----------##---#------------#-#-#-#-##-#-#---##---#----------------#-#--#--#----#--
--#-----##-#-##-----#----#-###--#--##---------##---------------#-#-----##-#-----#-###--#--##-----#--
----#--##----#--#----#--#--#---#---#-----#-###-##-#------#-##-##--#--#---#----###--##---------#-#---
-----#-#---#---#-#----#-#----#-#--##---##------------------#-##----##--#---##---#-#------#---##----#
#----#-----#-##-----#---##----#-#----###-#-##--###-#-----##---###-------##--##-------##---#---##----
##--------#-#----#--------#--##-###-##---##----#-#--------#----------#--#--#-#----#--######--###-#--
-#-#--#---##---#---#---###--#--------#------#-#---#-------#---#---##----#-----##-------#-#-----#----
###-#-##--#----#-#------#------#-#--#---##----#-#------###--#-#--------#--##-#---##--#--####---##--#
--#--#------#--#-#---#--#-----#--#-##---#-------###--##-#----#---##------#-#----#--------#-------#-#
-----##--------##-#----#---#--------#---#--#--#---#--#--------##---###-#--#--##-----#--#--------#---
---###-##-#--##--#-----#-#---#--##-----#-#--#-----#---#--------##-#---#-#--------#-##-#------#-#--#-
-#---#--#-#--##---##-------#--#---#-------#-##-----#----------#---##---#-#----#-------#-##---##-----
-#--#--#-#---#--#-----#-###-----#--------#--##-#-#--#-##-#---#---#--#---##--#-#----####----#-######-
--##-#---------------#--##-#-#--#----#----###-----#---#--#-##-#---------#-----##--#---#--------#----
#-#-#-#-#----------#-##---#--#-#--#-###---#---#-----##--###----###-#---#-------##----------#--#--#-#
-##-##-#----#---#------#----------#----#-#-#--#-#-----#--##--###---#-----#-##-#---##-###---#--#---##
------#-#-------#---##---#--##---#-----#-----#---##--#-#-####--#--#-##-----##-#-#--------#-#-#--#---
---#-#-#-##---#-#--------------##----#-##-##--#---##---#-#----##----#-#--#---#-----#-##-#-#---##----
##--#--#-#----#------##-#-#------#-#---#-#--#---#-#-##-#-------##-####-----------#-#--##--#----##---
-#------------#---###-----###-##------#------#--#-#---#---#---------#---#-------#-####------#---#-#-
-#-#--#---##------#-##----#-#-#-#--###-----#-#---#-##--#----##--##---#---##--#--#-#----#--#-------##
-##--#-##-----##-##-##---#---#--#---###--#---------#----#--#----##-----##-#--------------#--###-####
-----#---#--#-#--#---------###----#----#----#-----#-#---##-----##--#---#-#-----#-#---#------#---####
--------#--##----#-#-----##-#------#---#-#---#-#-#--#--#--#-#------#-#-#-----#---#----#-#----#--#--#
#-------#---##----#-#------#---##-----##---#--#-#------##---#-----#--##--#-----#-#-#-#-#--#-#######-
#--##----#------#--#--##-------#-##---#--#---#-----####-------###----#-#-----------#---#------------
-##---#--#----#----#---#----#-#----#------##--##--#----##----#---#-#--------##--###--#--##--##----#-
#--#---#---#-##--#-###-----------###--#-----#-##-----#------#-#------------#-##-----------#---------
-#--#-#-#-###---#--##--#--#----#--------##--##----#-----#-#----##--#-#----#-###--#---####-###-------
