-----------#--##-#--#---###--#---#-#----#---#-#---#--------------#-#--------#-------#-#--#----##----
#-##---#-------###--##-#------##---#---#--#-##--##-#--##-#-----#--#-#-##----##---#-###----##--#-----
-#-----#--#-##---##---#----#------------------#-#--#--#-#---#--##--#--###--------#-#---#-###--#-----
-##---#-#--#-----##-------#---#-----------##---#--#--#----#---#-#-##-#-----##---#---#----#--#---#-#-
--#-#--#-#--##-#-#--###----#--##-#--##---#-----#------#----######--#-#-#-#-----#----##----------#-#-
#---#---##--#----#-------------##--#-------##--##-##-##-----#-##---#---#--------------#-----#-#---##
##-#---#------#-##-#--#---##-##--#--#----#-#------##--#--#-##---#-----#-#-###----##--------##-------
---#--#-#---#----####-----#-##-#--#-#-#----#---###--#--###--#-----##--#-------#####-#-##----##----#-
#-#----#---------#-----#---#-#--#----#-#-##------#-----##-##-##-#---#-----#-#-------------------#---
---#------##-#---#-###-----#-----------#--------#--##----#-#-#--#####---#---##-----------#--###--#--
--#------#----#-#-------#-------##-##---##--##--#--------###-##----------#-#----#-#--#-##--##--#-#-#
##----##-------#---#--#-#-#-#--#--------###---##------#---#---##-#------####--#---#-#---#--##-----##
-##--#-##--###-----#----##---#--------------#---#--------#-------#----###--#-#---#-#-#--###-----#---
#---#-----####---##-##------#------#-#--#--##---###----#-#-#---##----#-----#--##----#-----#--######-
-#--#-#--#---##------#---#-------##---#--------#----#----------#-##-#####----#---###-#--##-#---##-##
--#---#--------#---------#----###--#-#-#--##----#--#---#----#---#-#-#-#-#--#-#----#-##---##-----#--#
-##-###-#----####-#-#-#-####-#---#-#-#-##-#---#-##-##-#-----#--#--#-####-#-#----#------------#------
-#-###-#---------#---##---#-#--#-#------#--#---##--#------------#-##--#-----#--------#--#-#-#-#-----
#---#--##----##---#----#--------#----------#---------#-------##----#--##--#------#--#----#-##------#
---#-----#-----#--##-----#-#----#--#---##-#-##---#-##--#-#---------#------#-------#--##----------#--
----##--##----#-#-#--------#----##-#--##---##--##-#-#--#---#-#--#-#-----#-###--######----#---------#
-#--#---------#-#----#----#----#---#--------#-##-----#------#----#------###-#---###--#---#----#-##-#
#----------###--#--#---##---#---###--###----#-#--#--##-#--#----#------------###----#---#-##---------
#----##--#--#--------#-##--##-----------#--##---------#--####-#----#---##-##--#-----------####---#--
---------#----#----##---####-----##--##--#------#------#-##-##-#--#----#-##--#--#--#-#------#--#--#-
-###---#----------###-----#-#--------#--#-#------#-#-#---#-#--#--#-----#-##--##------#----#-##-####-
#-#---------#--##-#-#------###-#-#---#----##----#------#-##-------------#---#--##-#--------##---#---
--##-#---#-#-----#--##------#####-------#---##---#--#-----#----###--#--#--#----#-##---###----#----#-
-##-##---#---#---###-----------#---##---#---#--##--#-##----##-----#--#-#------#--#-----#--#-----#--#
---#-#-#----###---#--##-------###--##--##---#---#--#----#----#---##-###--#-#-----------#-----#------
-###--#--#-#---###-----#--##--#------##--#----##-##--#-----#-----#-##---#--#-#---#----#--##--#--#--#
-###--####-------#--------#-----###-#--#------#-#-----#-#---------#-#-###-#-----##-#-###-#---#---##-
-#-#-----###--#-----##----###---#---#----#----#-#-#---##-#--##------#----##-#-----#---------------#-
----#---#----#------#--###------#----#-------#-#----#-#-#-----#-#-#--#---#----#------------#-##--#--
###-#--#--#-#-#-###-#--##---------#---#----###------#--------####-#---#-#----##--#----#------#--#---
----#-#--###--#-##-##--#-----#-------#-----#--------##-----#----#---##---#---#-###--------##----#---
-###----#-#-#---#-##-#-#-#-#--##----------#-#-#-##---#--#####-------#-------#-----##-----###--#-#---
-#---#----------------#--#---#-#-###--###-#----##--#-##--#---##---#------#-#-##--#-E----#--##-#-#--#
-#---#-#--#-----------##-----#-#------------##---------##-------------##-##-----#-----##-#--##-##--#
-#--##---#-#------#--#-#--####--------#--#--#------#----#--###------#--#---#---####----#-------#-#--
-#------#---------#----##-#------#-#####--##----#---#-#-----#----#----###---###-------##-##----#--##
#-------------#-#------####--#---#-#--------#--##-----##-------#---#--------##---##---#--##-#---##--
-##--###-#--#-----#-##---##------------------#------------##---#--#--#---#-##--#--#--#------#-------
----##-#-#----#--#--#---S--------#-#-------###-###--#--#-#-----##-#--#-##-##-----##--##------#-#---#
------##--#-#-----#---#------##---#---#---#--#-#----------##-----#-##--##-#-------#--#-#----###--#-#
-#-----#-#-##--##---#--#-------#-#-#-###---#-#---##-------------------#---##-----#---------#---#---#
---###--#----##-###-#-#-##-----#-#----##----#---#---#-----#-###-#-#-----#-#---#-##------#----#------
-#----##----#----###------###-----#-#--#-#---####-----#---#-------#-#-##--##---#-----#--#--##--#----
-#-------##-------#-------------##-------#--##------##---#---#--###-#-----------------##----#---##--
---##-#-------##-####--#---#----#--#--#-##------##-#---#-#----#----#-#-#-##--#--------------#-#---#-
--#----#--#-#-----#---##------#-#-----------##--##---#---#--#-#--##---##-##--------#-----#----------
---#-#--#-##-------##--#--#---#-#####--##----#----#--##----------#-------#----#---#-#--#-#--##-##---
----#--##---#-#-#-##-##-------#-#--#------#####---#-----------##--###-----###--#-#-----##-------#--#
#---##-###-#-----#---#--#-------#--#---#---###--#----#------#-----#----#----#-#--#---#----##-###--#-
#-###-#--#---###--#####--#-----##----#----#-##----#---------###-#--#-##---##-##----#-#-#----#-----##
#--##---#----#----#--#--#-----#-#-#-##-#-----##-####---#-----##-#-#-------#--#-##-----#-------------
-#-----#-----##-#--##--#-#-##----##---#---#-------##-#-#-#--#-#-##-----#---#-#---###-#---#---#-#-#--
-----##------#-----#--#-#-##-----##------###-#---########------#-#---#---------#-------#------------
------##---#---#-#---##-#----#------#---#-####-#--#---#-----#--#-#-------#-#-#-------###---#-----#--
----#----#-#---------#-#-#-----##-#----##-#----#-#--#----#---------------#----#-#-#-#------#--#----#
---#-#-##----#--#--#--##----#--##----#-----------#--#--##-#-#--#-#------#-----##--#-###--####-#---#-
---------#--#--#---------#--#----#----###---#-----#--#--#-----#-##----#-------#----#---#--#--###--##
-----#####----###---#---###----------#-#---------------#--#---------#-#---#-######-----#-##--#--##--
##------#-#-------##--###--##------##----#--#-------##--##-----#-------##--#----------##--##-----#--
-#----#---#--##-----##-####--###-#-#--##---#--#-##--#--#-##--------####-----#---#-----#-----#-------
---#-#-#-#-#-#-#-#---------#--##-#----#-----##--###--#---#---#--#--#----#-#---#-#--##---#--#--#--#-#
---#--#---#---------#-------#--#-#---#--#----#-#-----#--##-#---#-----###----#--##----#-------------#
-#-----#-------#-####-#-----#----#--##-#-#---#----#-#-#----#-#---##---#-------#--------------##-----
#-#---#-----###--##-#-##-------------#--##-#-------###---#--#---------#------#----##-----#-#-#--##--
-#-------#--###--#-###-#--#------##---#--#-####-##--#--#-#-#--------#--#-#-----##--#---##-#---------
-----##-#-###--#--#---##---#------#-#----#--------##-#--------#-------#------##------####--###----#-
---#---##-----##-##-#---#--#-----#---------##-#----------#-------#------#-#-----#--#--#---###-----#-
-----#--#-#---###----#-#--#-#-#--#-----#--#-#---##---#-------#--#--#-###-#--#--------#------#--#----
---##-#-####--##-#-------##----#-##-#--##-#--#-###-----------------#--##-------##--#------##-#--#--#
----#------#----------#--###-----#--#--#-----#---#-##--##----------#-#-###-------#-#-#---###--------
-#-#-#-#------##------#--##--------#---#---##---#--#-#--########---#-------###-#------###-##-####---
########-#-#----------#-----#---#-#-###------#--#-----------------#---##------####--#--##----##--##-
--#-#-----##-##---#---------#------##-#-#-#----##-----##-##------#-----##--#---#-----##-#---#-###-##
--##-#--#-##-#-----#---###---##-----#--#--##-----#----#-##-#-------####-------#------#----#--#-#----
--##--#----#---#---##--------------#--##----#----#------------##-##--#--##-----#-#-----------##--#--
--#------#---#----###----#---------------------##-#-#-#-#--#--#--#-#-#---#--------###-#---#--###-#-#
---#----#------##---##-#---------#-----#---#-#-#---#-##--#--#-#--#-#-#---#---#-#-#-------#--#-#-----
#---####-#-#---#----##-##-------##---##---#------------#----#------------##-#--#-----#----##---#----
----#----###--#--#---#---##--#-------##----#-----#-##-----#-----#------#----#---#--##---#--#---##---
-------##---#-#--###-#-----#-###--#-#---####-##---#-#---##--#----#####--###---------------###-###-##
--#---#----#-----##-###--##------#-##----#----##-----#------##------------##------##--#--#-#--------
-#-#-#------#--##---#-##--#-#---#--###------###--##------#----#----------###--##------------##-#----
##-----#---##-----#-----------------#----#--#---#---#--##----#-----#--#-##---#--#------###----------
--#-----#-#-----#-----#-#-#######---##-####---##-#----###----##--#--#-----------#-----------#-#--##-
---------#-#-####-##-##--------#------#-----##---#-----#-#-###--#-------##--#--#--#----------###-#--
--##--##--#---#----#---#-#--#-----#--#-------#------##-###---#---##-##-#---#----##-----#--#----#-#--
####-#--#--#--##-----#-####--------#-#-------#---#---#----##-#-------###-###--##-----#----------#--#
--#-------#----#---#------#---------#---##-#-----###--#--#-#---#--#----#-------#-#--#--##-#-#---#---
-##-----###---#-----------##-#-------##-#------##--#--------------#-----------####--#--##--#--#-----
#--#-#--------#---#----#---------#----------#-##-###-----#-----#---------#-#--------##--------#-#---
------#--#------#--------##--##-#------#-#-------#---#-#-##---#-#-#----#---------#------#--##----#--
---##--#-#--#-##-#--------------------------#-----#----#--#--##-#-#-#-#--------##----#-------#---##-
-#---#----##--#--###--##------#####-#------#----####------#-------###-##-###-----##------###--#---#-
----#----------------#------##--#-#-----#--####---#-#-#####--##-#-------##--##-----#-#---#---#----##
------#--##-##-#-#---##-#--##--###----#-##-#---#------##------#--#-##----#--##-----##---#--##--#---#
