----#--#----#-----#-------#---##-#-#---#---#--#-##-#--#-#-##---#-#--#---#-#-#-##-----#-#-#---#--##-#
----#-#--#--#-##---##------------####---#---#-#---------#--##--###--------##-#--------#--#----##----
----####--#-#-------#--#-----#----#--#-------#--#----##----#-#---#----#--#--####----#---###-----##-#
##-##-----##--#--------------------#-##-#-#-#--#--------#----#-#---------------------#---------##---
-#-----------#-----#----#-----##-##-##-----#-----#------##---#---#-#-#-#---#---#-------###---#---#--
-----#-----#-###---#-##----#--##---#-#--#-##--#---#--#-#-#-----#-#-#-#------#----#---#-#--####---#--
-#--#---#--##-#-#--#-#--------######--------##------#-#-###-----#----#---#----#--#--#--#---#-----#-#
#-#----#-#---#----#--#------#---#--##-##----#------#-#----#-#----##---#-------#-#----------#--##----
-------#-#-#---#-----------#----##-##--#-#----##--------#---#-----#------####-----#-#----#---#--##--
#----##---#--##-------#------#-----##--#-------##-#--------##----------#--#---##----#-----#--#------
-----###-----#--##---#--#---#------#-#--#--#--#---#-----####-#####-#--#--##-#-##-----#-#---##-#-----
---##-#----#----##------#--#--#--#--#--#----#----#------####---##----#--#-##-----#-#--#-------------
-#####--#--##----#-#-#----#-##---##-#-##-#-##--#-###----#-#----#------#---#--#---##------##----#----
###---#-#-#----##-###-#---###--#-#-#-#-------#--##-#-#--##-#-----------##-#-------------##-------###
-#---#-------###-##-----#-#-#-----##-#--#--#---#---#-#---#--###------##--------#----#----#---#-----#
---#--#---#-#--------#------#-#--------#----#-#------###----##-----#------##--#--#----##-----#------
##--##------#-#---##-##--#--#---##-----####--##----#--#-------#--#-----#-----##-#--#--------#-#-#---
-##----#------####----#--#-#--##-#-----#-----#--###-#---#-----##--##-#--###-----#----#--------##---#
###-#-----#-##-#-----------------#----#-----#----#--###------##-------####---#-#-----------------#--
-#--#------##---------#-----#------#-----------#-##-----#------#---#--##-#--#-###---#----#----------
---##--#-----#-###--###---#--#-##-#-##----##---#----#--------#------#-#---#---#---------#--#--#-----
-#--#--#--#---#---#--#---##---#-#----##--#----##----###--#---#----------##-------#--#----------#-#-#
-#----#-----#-----###-------###-#-#---#-#---#-#-####----##------#--###---#-----#-#-------##------#--
#-#-##---------###-##----#--##--#---------##----####------#-#---###-##----####--------#--#--##-#----
--###----#---##-#-##-------#-##--##-------#-#-###-#---------#---###---#---#--#------##--#-###-------
--#-###-#--#---#--#--#---##----#----#-##----#-##---#-#-#--#---#----##-#-#-#####---##----------###-#-
#---##---#----#---###-------#---#------#--#----##-#--#-#----###--#----#---#--#-----##--#---------###
#-#-#-#-#--#-##---#-#--#-------#E#---###-#-#---##---#-##--#-----##-----------#---#----------#-#-#---
---------##-#-----####----##-#-#---##-#-#-###--####--#----#-#----#---------#--###----#####--#-#---#-
--------###--##--------------##---##---#--#---#-----------------#-#--#-##-#-----------#-#----------#
--------##--------##------#------##-----#-----#---------###-#-#---#--------##-#-----#----##-----#---
---##----#-##----------------##------#-#--#-##----#--#---#--#-------#---#---#-#-----#--#-#----#----#
-#-#-##-----##----#----#-#-------#---#-####-#-###-#---#--##---####-##---#----#--#-----#----#--------
#-#--#---##----#-#--###-----#--##-#---#--#------#---##-----#-------#-----#-#---#--#-----#----#---##-
##---#--------###------#----#-#--###--#-----#---#-----#----##---#-------#----#-##---#-#-##-----#-#--
-----------#------------#----#-------###--------#----------#------##-----#####-##--#---##-#------##-
------##-------##--#---------#---#--##----#--#-#--#-----#---------#----#-#--#------##----##--------#
-#-----------####-###------#-##-----#-#-###-##-----##-##-##-#-----##---#-----#-#--#####----#---#---#
--##----#-#--##---###-#-#---#-#---#-#--#-#-------#--#--#--#--#--------#---#-----#---#--#-#-##-##----
---#-#-#---#---------#----------##-----S--#-##-#------#-----#---#-------##--#-#-----#--#--#-#----##-
-------#-#-#---##----#--#-##-###-###----------------------------#--#---##---------#---#-#-#-#-------
-------#---#----##------------#-------##----#---#--#---###----##-------#-####-----#--#---#-#--#---##
----#-#-###-#-#-#---#--#-##-###-#-#-#--#---#-------------#--#--#-##-#---#-#-#--##--###-##-#-#---#---
-#--##-#-###-##-##--#-#-#-----##--#---#-#-#-----#-#-------##---#----##---##-##-#----------#--------#
-##--------##-----#---#--##-------#--#---#-------------#-##-#----##-#-#--------#-#-#--#-----###-----
#--#------------#-------##-----##----------##----#-#----##-#--#--#---#--#-###---#---#---###-#--#-#-#
##------#----###-##------#------------##----#--#----#--#---------###-------#-#------#------###--###-
-#-#--####--#--------#-#--#-------#-----#-----#----------------##---#-#----##----###---#-#---###----
--##--#------####-#--------#-------------#----#-#--#-----###-#--##--#----##-#-#-#----#----#----##---
#------#-#--------##-#-----#--#-#--#-----##----##------#-#####-#-------###-----#---#--#-#---##-----#
#-#---#-------#-###-#-#--#----#--####-##-#--#---#------###--#---#-#-#----#---#------##---#---#-##---
--#-----#---###---##--#------#--#-##---#----------#---##--####-##--###--#-#-##---------#---#-#-#----
--#-#----#-##-------##-##---#--###--###-#--####--------#-#---#-----##----#-#-##---#-#-#-##-####---#-
-#-----------##-----#--#---#---#---#####-#------#---####------#--#----#-#-----#---#----#-----#-#--##
---###-#-#-#----#-#-#-##--#----###-##--#-----#--#--------#-#-###--##----#-----#-----#--------#--#-##
-#--###-#---#------------#------#--##---##-#-----####-------#---#--#--##-----##------###--#---#--#--
#----#-#--##---###----##---##-#-#-#-#--#-----------#---#---#-##----#-----##------##----#------------
--#---#---------#-#-###----##-----##---#-----#---#--##----###-#---#-#--#---##--#--####--##--#---#---
-#-----#----#---#-#--##-#-###----------------#-#-#-----#-##--#-----###------#-#--###---#---#-#-#-#-#
---#-#-#--#----#---#---##-#---##-#--#---#------#-#--##----#---###-#----#-#---#-#-----#----------###-
----##---#-##--#-##--------#---#---##-#-#--#-----#-#--#---#-------##--#----####--#--#----##---------
-##---###--#-#---#-#-------#-------#-------#-#---#------#------##--#-##---#--#------#-##-#----------
-#----#-##----#--#--------#-#---------####---#------#--#-#--#---#--#--#-#-----------------#----#----
-#-#---#---#-#-#---#-##----#-#-##---#--#-#----#-----##-#----#-#-#---------#--##---#-##-###-###---#--
--#-#-##--#-##-#-#----#---##-----###----------#--------#--##-#-###-#-#-##-----------------#----#----
----#----###-#-----#--#-#-#-#--#----#-###--#---##--##-#-------#-#-###---#------#-#-#---#-----#----#-
#-#--#----#-##----#-#----##----##------#------------#----#--------#-#-#-#-#-#--#--#-##---#-#---###--
-#--------####--#--#--#----##---------#----#-##-#-#---#-#-#-###---------##--#-----###-#-#-----#--##-
-#-----#-#-#-#-#--#---------#---#-###-----#-#--##-------#-#-##---#-#--#----#--#------#---#-----##---
#---#-##-#----##--##----##--######-#--###--#---#-##---##-----#-####--##-#-----#-----#--##-#-##-#--#-
----###-#---#-##--#--##-------#-----#-#-----##-----#-#--#-----#--##-------------#-#-----#-----#-----
##--#-#---#----#--##-----#-------#-#--#-##-#--------####---##----------#-----###------#---###-------
-#-----#-#--#-#---#--##------------------#-----#-#-#-#---#-#---##--#--##--#--##-##-#----#---#-#-----
-#------#-##------###------#-----#-#-#--------#------##-------#-#---#----#---#-----##-#---#-#---#---
----##-------##----#----------#----#-----#---#-#-#---#--#----#--###--###-------#-----#----#----##---
#-#-#------------##----#-#------#-###-#-#------#-##---#-------#--##-#--#-##---#-----#---#--##------#
-----#---------#-##-#-#----##-#------#--#-----##--#-##-----------#--------#----#--#-#-##---#-##--#--
----#--#-###---#---#------------#---#----###---#---#-#---##----#-----##--##----#----#-#--------#-##-
-#--------------#--##-##---#---#--#----##----#--#----#####--#--#-##-#---#--------------------##--#--
-#--#------#-#-###---#-#----#-#----#-##-#-------#-#-------#--#-#----##-#-------------#-##-----##----
------##-###--#-###-##---#----#-#----------##-##--##--#-#-----#-#-##--#-#-----------------#----#---#
--#--#-----#-----#-#-##---#----#---#--------#--#-#-------#-----------#------##-#-------#-#-##--##-#-
-#----#--#---#--#----##-###-##--------##-------####------#----#-#-#------#---##--##---#-----#-#--###
--#------##-#-#----#--#----#-#--#-##-#-#--#---#----#---###-------#----#-#---##------##--#--------#-#
--------#---#-------##---#--#-#-##----------#--#------##-##--#--#-----#--#-#--#-#-----#---#-#---##--
---#--##-------------#-#----------#--#---##----##----#---##----------##-#----#-#-----#-----------##-
-###-####-#--##---#----#--##-#-#--#---#-#--#-#--#-#-##--#---#-#-#-#--#-##--#-#--##-#-##----#--##--##
-----#-#-##-##-#-----#-------#-#---#-#-#------------#####------#--#-#------#---#-#-#-#------###---##
----#--------##-----------#---#-#-------##---#----#--#-----#####-##-#-##-##-#-#----#---#-#--####--##
#--#-----###------#-#--#--#-------------#-#----##-----###-#-#-#--##-##-#-###---##-##-----#--#---#---
--#-#---##--#-#-#-------##----##--##--#----#--#-##----------##-------#-#-##-###-#-#----##----#-##-##
---#-------------#--------#-#-----#-----#-###---#-####-###-#---#---------#-#---#-#---##-##--#---###-
-##--###-----#--#---#-#------#-------#--#---##---##--#---##-----#-#-#------#--#-#------#--------##-#
-###-#---#------##-###--#------##--#--#--#-#--###-#-##----###---##-#------#---------------###-##--##
----#--#--#------##------#--#--#--#-#----#-#-#--#--#--#---#---#---###-----------#-----#--#---##-----
-#---#-#-##--------------#---#####--#-#-#-#-----#-#-----------#--#-####--##-#---##------#--#---##---
##---#--##-###-#-##-#------###-##----#--#---#--#-#------#--#-###-----#-------------#-#-#-##-----#---
-------#--##--------#-----##-#----#-----##---------##-------#-------------#---------------##----#-#-
---#---#-----#-------####--##-#---#--##-##-##----###-###-------#---#--------#----#-------##---#-----
##---#---###-#-##-#-#####-#----###------------#--###----##----#----------#--#----#--#-##-##-##-#-#--
