-#-----#-#----##--------------#---#--#-#---#--#-#------#----#----------##-----##---##-#--###------#-
---####--##----##------#---##--##-#--#-#-----#--#-#----#-#--###-#-#--#--#--#-----#-#--##-##--#-#----
###-#-#-----#-----##---##---#------#-#---#--#----#-#-#-#--#----#---#-#----#-------###---#------#--#-
#---#---#-#---#---#--###---###-###-#-----#-----#--##-####-------##-#---------#--------------#----#-#
--#-----#--###-#-#-#---#-#----#--#--#-----#--#-----#-#-#---#-###-----#-------#----#-#--##---#-------
----#--##--#-----------#----------------#--#--###---------#------#-------##-#----------##--#----##--
#---##-------#--#--#----------#-#-------#---##----#-----##-#-#----##--###-#---#-----##----#--#--#---
--##-------#----#---##--#--##-----------------#----#--------#-#-##--#--###-----------##-##-#---#-#-#
---#---##------#-#---###-####----#--##---#-#---##----#---##--##-----------#--##--#--#--##-#-------##
----##-#-#----#-##-#--##--#------##---#####-----##----#---#----#-#----##-#-#-----#-----##----#---#--
-----#---#--#-###-###---##---#--#--------#---#----#-#----#-###-###--#-------###-#--------#----------
----##----##-##--#--#--#-##-#-###----#----##-#--#------------#---------##--------#-#--#--#-##-##----
-##-#------##------#-#-#---###-#-#-#-##-----#-----#--#----#--##-#---#--##---#---------#------#---#--
--##---#--------#--#-----#-------#--##--##---#--------------###-##--#-#-#---#-----------#-##-###--#-
#---##----------#-------#--#--#-#---##-#---#--##----#----#--#--###---#--#----#--#---#---#-#---------
-#--------##-#----------#--#-#-----#--#---##---#-------#--####-#--#----#------##-----###-##-----#---
#-#-----#####-----#---##--#-----#----#--####--#----------#---###-#-##---##--------#--------#---#----
----#-----########-####--#-----#---#-#-#-----#---##-##--#####--##--##---#-#-#------#--#-#-----#----#
-#-#-#----#--#-##----##--#--------#-----#------#-##------------##-#-------##-------#----#-##--##----
--#-#-----#----#-#####-#-#---#--#-#---##---#-#------#---#-#-#--#------#-#--##---#-#---#------#--#---
#-#---##--###--#-#----#-##--##-#-#-#--------##--#-#-----#----##---#--#------#--#----#-#--#---##-#---
--##--------#----#--#---###---###-#--##-#---#-#-----#-#-----##-#-#-----#-#--#------------#--#-#--##-
#-#-##-##--#-----------#----#-#---##-##--##--#---#---#---#----#-#-#-#--##--#-#-###---#-#--#-#####---
---#----#--#-#------##-######------#---#-------##-#-##--##-#------#----##------------##---#-#-#-#-##
----#----#-##---------##--#-------#-----#-------#--#-#---#------#---#--#-##--#----##-----#----##---#
##--###------#####----#--#-#----##--#--##----##--#-#-#---##---#--#--##-----#-#--#---#-#----------#--
---#------#-#-------##---#---##--#--#------##----#-#---###------#-----#-##----####------#------#----
-#-#----#----#-#--##------#---#---#--#-#-#--##---#-----#-----#-#-#--###--------#-#--##---##-##-##--#
---#--#---#---###--#----#-----###--#----#-----###----#--#---##---#------#--##---#------------##-#--#
----#--------#-##-------------#-#--#--#---#--#--#---#-#-----#-#--##---#-#-##------#--##-##-#-###---#
--#-#------------##-#----#---#--##----###--#----#-##-#----###-#---##--#-#-#-#----#----###-#---#-##--
#---###---#-#-#------#-#--#-#--------#----#----#####--##-------####------#-#-----#-#-##------#-#----
----#-----------#---#---##---#------##-------#---##-##---##----#------#--------------###--##----####
-#--------#---##---#-#--##----#-##----##--------##--#-----------#--#-##-#--##-#--#-----###---#---###
--##--##--##--#---#-#-----#-#-##-##----#-----###-----#--#---#-#-#--#--#-------#----#--#---------#---
#---#-###--#-#--####-------#-------####--#----#--#-#---#--#---#----###-#-#-----###-#----#-#-##-##-#-
------------#---##-------#--#-#-#----#--###---#----#---#-----##--#------#--#--###-----#-#-#---##-#--
-#------#-###----#--####-------#-#--------#-#--#--------##-####---#---##--#---------#---##-------#--
#----#--#--##------#----##-----#---#---#--#------#-#-----#------#-#------#----#--##-------#---#-#---
#--#--------###----##---##--##--#-##--#---#--#-#-----#-#---------#-#--#------##-----------#-----#---
#----#----#--#---------#--#--#-#--#---#---##--##-##--------#-#-#-#------#----#-#--#-###---#---#-----
-#-#----#--#---#--#---#---#--##-#----#####-###--#---#----#------##---#-#-#---#-#-----#-##------##--#
#----#-----------#-#--#-#------##-#-###--##-----#---#------#--#---#-----#--#---#-----#--#------#-##-
---------#---#----##-#---#-#-----###--##--#------###----#----#-#--####-------#-##-----#-#--##---#---
---#--#-#----#---#--#------------##-------#--#-#----#----###---#--#---#-#-----#--#-#----#-#------#--
##-###-#------##--#---#-#----#-----#-###---#------##--#-----#----#--##---------#-##------------#----
------##--------------###-------#-#-#---########---##------##-#---#---#--------#--#------------##---
--#---------#---------##-#------#---#----##------------#---##-#-#-------##--#-#----###--------##---#
-###-----#---#---#---#-#--##---------###---#-#-----##--#-----##---#---##-----#---#--------#-#-------
-#-#-#----#-----#--#--#------##-##-#--###-#--#--##----#--#---#---------##--#--#-#----#-#--#---##-###
----#--------#--#-----#-#-----------------------#-###----##-----#---##--##-------#----#-#--------##-
---#--##-##--#--#--------#------#-#--##-###------------#-----#--#----#---##---#--#--------##-#--###-
#-#-#-#---#---#####-##-#--#-#--#-#-#----##----#-----------#----##--#-#--#-----###------#------###---
---##--#-#-#----#--#---#--##-##-#----#-#--#--###-#--#--#####--#--------------#-#-#-#--#--#-#------#-
---------------#--#------#-##--###-----#-#--##---#-----------------------#--#-----#----##--##--##-#-
#-#---#-#-#--#---##--##----##-#------###-#----##--#---#---#--#-#-#--#---#-#--#-###----------------##
----#-----------#-------#-#-#---#-#--#----#---##---#-#-##----##-##---#----#-----#------#------#-#-##
-----#-#--##---#-#--#-##--#-------#--##-###-##--#---#--#------#---#--------------#----#----##--###--
-###-#--##---------#--##------#--##----------#---#---##---###-#-----#--#-#--#-#-------#-----#-#--#-#
--#--#------------#--------------##-###--##----#--##------#--#-----#-#--#-#---#-##---#-----#-------#
-#---#-#---#-##-------------##--###-#--#-----##---------#--###---------------#-##----##-----#-##-#-#
--------#-#-#-----------##-------##--##--#--#-#----###--#---#--##-----###-#---###--###-#####-#-#----
---#----#-----#---#----#-----#-----#---#-#-##-----##-##------#----#---#---#-##----#-#-----------#--#
-#----#-#---##--#----------#-###--#--#-#-###-#----##----#--####--#-####--#-#----#-#-##-#-#--#-##-###
-#----####----#####-#-#-#-#--#----#-----##---------###--##-#---#-#------#--------##-----#----#----##
#-----#--#-#--------#--#-------#----##---##----#-#-#-----#-##----##-----###------#------#-#---##---#
---#---##-#--------#--------#--------##-#---#--##-----#----#-###---#--#--##---#-------#-----#####--#
-#----#-#--#---#-----#----#-----#--#-----------#----#-#-#--#--#-#--#--##-------#---#--###--##-------
###--###-#--###------#-#----#-#---##----#---#---#----#---#--#---###-#-#---#----#-#-##--#-----------#
------------##---###---#-------#--#------------------#----#-#-##----#-##-###-#-#----###----##-##---#
------------#--##--#----##--#-----#--------#-#----###---#-#--###-#-##--#----------#--###--##--#-#-#-
###---------#--##----#--#---#-##--#----###--##----##----#-#---#--###-#--#--#--#-#-#-#-#---#------#-#
-#----##-##-##-#---#---#----#-#-----#--##-#-##-----##-------###-##--##---#--#-------#---------##----
-#---------#--#-##--#-#-##--#--#-###---#---------#-----#--#------#-#--##--#---#-------##----------#-
-#-#----#-#-#-#-#-#-----###-------##--##------#------##-----#--#--#-###---#-----#--#---#------#-####
---#--#---------#----#---###---##--#-----#-#-----##-----###-----#-#-#-##---#--#----#-#-#------###---
---------#---------------#-##--#---#--#--------#-#----#--------#-#-##------#--##---#------#---#-#---
-#-#---#------#--#-------##-###-#----#--##-----#-#---#--#---##----#----###----------#-#-------------
------#---###-----##---#---#-------##----#-#-#------#--##--------#--#-----------#-####--------#---##
-##-##-##-----#-#-----------#--#-------#--#------#-------#------#-#---###-----##-#---##-#--######---
#--##--#----#-#####---#--###-----#----##---#-#---#-##-#-##-#-#---------------#-#--------#--##-###---
---#----#----#-----###------#-----#------#------------#-##--#--------###----#-#---##--#---#---#---#-
------#---###-#----#----#--##----#---#-------#------#-#--#---#--#-##--------#-------##---#-#--------
##--#-----###---##---------###-----#--###-#--###----#-----#-#-##-----#-##---#---#-#-#---###-#--##-##
-#-##---##-#-----##-----##--#---#--#---##---#--##--#-#-----#------#-----#-##-#---##-###-##--#-#--#-#
-#------###--#--##--#--------#---##-##-###-#-#-#--#-----#--#---##-#--#-#--##--#--##-------##----#---
----#---#-#---###----#-----##-------##---------##-#----#-#----######------#----#-#-#-##-#--#-#------
----#----#------#-#--------#--#---###--------------#--#--#-#----#-#--####-------#-#--------##-#----#
---#--##-###-##------#---##----#--------#-#-#-#-#-#---#-----#--#--#--#----#--##-##-#-----#---##--#--
--####--#--##-----#--#-#--#----##----#-----#-#--##-##-------##--##----#-----##-#---#-##-###-#--#-#--
#---#---#-------#---------#----#---#--#---#---#-#-#------#---#-------#--##-----#-----#-------#--#---
##---##----#-#-#--#-------#-----#---#----#-------#---##-#---#----#--##-#----#---#---------------#-#-
####---#--#--#--##--#-##------#--------------#--##----------#-#--###-#---##-----#-------#---#---##-#
--#-##------#-----##--------##--##--###--------#-#--##---##-#-----#----####--------#----#----##-----
#-##-#-#-#-#-#------#----#-----------------#---#--#-----------##--#--#-#-##--#---###---#---#-#--#-#-
#----#--#-------#---#---###-#----#--#---#---###--##---#-#----##-------##-##-#-----##--#----#-----#-#
--#----#-----###--------#----#---#----#--------#----#----#----#-----###-#-#---##---###-##-#-##---#--
---##--#-#---#------#-#---#-###--#--#---#-#---##-#-##------#----#---#------#-----#---#-##-##-##--##-
-----#---#--#-#-#-##----#-#--#-#--#-----###-#-#---#-------##-#-------##-#---##--#---E-###----------#
----#----#--S-##-----#-#-------#-#---#-#--------#-----------------#---##-#---#------#------##-###-#-
