-----#--###-------#-#-##--#-------#--------#---#-------##---#------------##-----#---#-----#-----#---
#-----#---##---#-##-#-#-#-##---#-##--###-#-#-#----#----#---------#-----#--#--#--###-------#---------
-----#-----#--###-#----#--#-#-----###-----#-#----#--#-#---#-#----##-------##-#-----#--#-#-----#-----
--------#-------#--------#---#--#-----#-#-#--#-----#---#----#-#-----#--#---#-----#-##---#-----------
---#--#---#--##------##-##--###-#----#-#-#-#-###--##-#-----#-##-----#-##---#-#--#--#--##-#----------
-#-#-##--#-----------------#-#-------#-#-#--#------#-------##--#---#-#-------###-#-------#----#-#-#-
#-#-#-##--#-#---------##--###--#--##------##-----#--###----##---#----#--#--#--#-##-##-#-----#-#--#--
-----#-------##--##-###---------#---#---#---##---##--------#-----###---##-------##--##--##---##--#--
---#--#-##----##-#-----#--#-#-----###---#--##---#------#--###---#---------###----#--##--#-----------
#-----#-#--#--#--#----#------#------#----#----#-#------###-----#---#----#-----#---#-#---##---#--###-
----#-###---##---##----#-----#-----#---####----#---#---#---#--#----##-##-#-##---#------#-#--#--###-#
-###---######-###-#--#-#---#-#--------#---#--#-----###--------#----#--##-#-#------####-###--#---#---
-----##---#-#--------#-----#-#--#---#-----##-#--#-##-#--####-#-#-----##-##----------##--##---#-##---
--#------#-###--#----#--##------#-----#---#--#-#-#-#---#---------##-----##--##----#----#--------#-#-
#----#-##-#--##---#####-----#-----------#----#---##---#---#---#-----#-#-##-####-#--#-###------#--#-#
--##------#-----##-----##--#-#---#--#-#----#-#---#----------#--#-#--##--###------##--#-#-##---------
#-#----#-#--#-#-##------##---#---#--#--#-##--#------#-#-#---##---#----#--#-------#--#-----#----#---#
#---#-#-----------#---------#----------##--#--#-###-#-------#-----##----##--#-#-#-##-##----------#-#
#-----#-#-----------#-----#-###-####------###-----------#-#-##-----#---###-#--##---#-#-####-##--#---
#--#-----#------#-#---#---------##---#-#--###--#-##-----------#--------------#--------#-#---------#-
#-----#---#----###-----#--###------#-#--#----#--#-----#---------#-----##-#--##---#---###-#---#-###--
-##-#-#-#-------#-#--#-#--#----##-#-------#-----##-#-----------###--#---#-#---#--#-#---##--#--##-###
-------#-------#--#---#-------#--#-##---#---#-#--##--#------#-#-#-#--------#---##-#---#-------#-#-#-
---#-#-##--#------#-#-#---###--------------##---------##---------##--###-----#--#-#-------#---##--#-
-##-------#--#-#---##-###------#--#--#---##------#-#---##-#-#--##--##----#-#--#####---#-##-#----##--
##-----#------#-###------#-------#----#-------##--#---#--#-##-----####----#--###---#--#---#----#----
---##--#---#--##-#--###------------#---------#-#-#---#--------#-###---#--#----##--#-#---#----#------
---#--#--#--##--#-----#----------#-----#-###--------#-#----#-#-##-##-#-#------#-###-#----------#---#
-#----------##-##-#---##--#-#-#-#--#--##--#-#--#-#----------#-#-----##------#----#-------#-#-#--#-##
#--#----#-#-#---#--#-----###-###-#-#-#---##--#----#--#-##-----#--------#---#-----#---##---#----#----
-#------####-##--#----------------#--###---##---#---#----#-----####-----#--------#----#--#--#---#---
-#----##--#----#-#-#--##-------##---#-----####-#---#--#-##--------#--#-#----#---##---##-##---#-#--#-
##-#----##-#---#-#---#--#--------#----#-###----#----###--##--##-#-#--##-##--------#--##--###--#-----
-#--#-#--##-#----#----###------###-##--------#-#---#-#-#-------#---#---##-#----#----------------#-#-
-----#--------#-------##--##--------#--#-#---#-----#---##-##-#----#------#--##----#-##-----##-------
#--#---------#-##---#-#--#--------###--##-----#-#-#--##-#---##--##-#-#---#---#--#---#-#--------#--##
#--##-##--------#----##---#------#-#-#---#----#-#--##-----------------#-------#--##-#-----#---------
#--##-#----##-----#----##----------#-#--------#--#---#------#-#-------------#--#-----------#-#--#--#
---#----------#--#-#-#------#---#-#----#--#--#-#---#----#-----#-#---#------##----##----#---#-#--##-#
----#-#-----#-#--##-#-----#----------#-----#----##----#----##-#-#-----#-#---#----#-------#---#------
#-##-##-#-#---------#----#--#-#--#---#--------###----#-----------#--#--#-#------##-##--##---#--####-
#-#--#--#-------##---#--#----#---#-----#-----###-#-------------#-----#----#-------#-##-#-#---#------
---#-----------------#----#-#--#----#-#----##--##-#---#----#--#-----#-#---#-#---#-----##-------##-##
#--#-##-##-----#--###-#-####---#----##--###---#-###-#--##---#---#-##--##-#---#-#------#----##--#--#-
-##--#---#----#---##----#---##----#------#-#----#----####----#--##-------#----------------#-----#--#
--###--#----#-------#-#-#--------##---#------#---##--#-#---#------#--#-#-##--###-#-#------#-#-#-----
#----#-#-#-S-##--#-----#-###-#--##--###---------#--##---------#------------#--#--###--##---#---#----
--#----#-#--##----#--#-#---#----#-#----#---#------#---#-#-#-----##----##-#---#----#----#--###-------
#-------####--##-------#----###-#--#--#----#-##-#--#---####--#-#----#--------#-#------##--#--#--#-#-
----------##-#---------------#--------###--#####---##-##-##---#-#--#--#-#--#--#----#--#----#---#----
---------##---#---------#---#----###-----##--#------------#-#-#-##-----#---#-#------###----###--###-
-#-##-#-#-#------------##--#---#---#-#-#----##--------##---###----------#----#--#----#---#---#-#----
#----#---##-#-#-------#-----###----##-#------##-------#--------#---#-----#--##-#-#---##--##-----#-#-
#-#---#--#-#-#--#-##-----#-----#-#----#--#----#---#-#-##-----------##--########---#----#--##-----#--
#---#--#--#-##-##-##---##-#---##-#-##--##-#-#----#------#-#----#----------------#------##--#-#--###-
---#-#-----#---------------#-#-#-#--#-#--##--#--#----##----#----#-#-##---##-------#-#-------###-----
#--###---###--#--##-----#-----##-##-#-##-#----##----#---#------#-#-##--##-###-#-----#-#--#-#-#-#-#--
#---------#-----------#-##-----#---#----#----###-#---#---####------#---#----#-###-----##---#---#-#--
#-#------###---##-#----#--#--#-------#-----#------#--#---##-----#--#--#--##--#-----------#-----#----
------#-------#---------#-----#-#---#--------#-------------#------##-#----##--###--#--#--#-----#----
---------#----##----#-#-#-----#-#---####-#-##--#--#----#--#-#----#-----#-#---##--#----#---------##-#
-------#----------#--#--#------#-#-#-#----#-#-----#-#--#-##---#---#---#-##--#---#--##-#--#----#-----
######-##--####--#----------##--#-#--#-----#---#-###----#-#-----##-----#--#--#-----------#-#------#-
----------#--##-------#---###---#----#--#-#----#--##-----##-----#------#----#-----#----#----#--#--#-
#----#--#-#-----#-#-----#-#--------#----------#-----#-##--#--##---#-#---#----------#--#---##--##----
#-#---#-#-#--##----#---#-###-------#-#-#--##---##---#--#------#-#-#-#--#-#--#---------#-##---#-#--#-
---#-------#-#----#---#-#----#----##---###----#------#------------##-----------##----#---##------#-#
-#--##-##---#-####-----####--##----#--#-##---#-#-##-----------#-#-#--#---#-#-#--#------#-------##--#
--##-#----#--#-#-#-----#--#--##-#--#-#-#--#-#--#----##------#--#-###---###-----#-#--------#-##---###
##--#-#-#-#-#-#---#--#-#-----#--------#----##-#---#-#---#---###-#-----#------##--#--###---#--#----#-
#--#----------#--#-----#--##-#--#####----------#---#---#--###-#-------####--#---#-------#--------#--
-------#-#---#---#-----#---##---#-#----#-#---#---------#------#-----#---#-##------#------#-#-#-#---#
-##--#------##----#---#-----#---#----#---#--------#--#---#-------##--#------##-#--#-#----#-#--#-----
-##------#-------#--#---#------#-#--#-#----###---##---#----##-#----#----#--#--#---------##--##---##-
-#---------#----#-#--##-----####----#---##---#---------#---#---#-#----###-#--#----#--#####----#--#-#
#--##--##----#-##-##---#---#--------#---#-###--#-#-###-#------#----##-#----#--##-###----#------##-#-
--#--#--------#----#--#-#----##---#---------#----------#----#-----#-#-##-#--------##-----#--##--##--
#------###-#-##---#---##--#---#--##---#--#--#-##-----##--##---#-#-#-#---#--###---#---------------#--
-#----##---###---#-#---#--------###-#--#--###-#-##----#-#---------#-###-#--#-#--#-----##------------
-##-----##---------##---#-#-##--------####-#-#--#-##--##-----#---#---#--##------#-----#--###--#-#-#-
-#---#---#-#---#####------#--#-#-------#-##--#-##--------##--###--#---#---#-#-##---#-#---#-#-----#--
---#--#--#-##---##---#--#-#-##--#--###-#--#------#---##-###---#---#-----##-#--#------------#--------
##-#----#---#-----#---------#----#-------------------####-----#--#-------###-#------#--#--#-##---#--
-##----##-###-##-----------#-#-###--#----#---##--##--#----#-------#----#----#-##-#-#-#----------##--
---##-----#--###-#-#--#---#--#-----#--#--#--##--#-----------##--#-###---##---#-#-#----#--#-----##--#
-----#----####--------------#------#-----#-#--#---##---##--#--#----###-##---#----##----#---###-#--##
--###------####-##---##---#-#-##-------###------##--##--#-#---------#-#--------###--####---##--#-##-
---#---------#-###-##-----#-#---#----------------#-------#-#----#---##--#--#---###---#-----##-#---#-
-###--------#--##---#-#---##---#-#-#--##---#-####--#---#------##-#--#-------#----###--###-###-#-----
-#--##------#E####--#-#--##--####-#----#----#-#--##--####---#--##-#----#---###----#------#----#-----
#----------##----#---#-#-##--#----#------##--#---###-------#--#--------#------#-----##-----#-------#
#--##-#------##--#--------#----#----#-----#---##----#-------#--#-#----------##-------#--#---#-------
----#-#----#----#--------#------#----###---##-##-------#-#---#-#-----##--#-------##--------##---#-#-
---#-#--#-#---#-----##------##-----###--##-#-----#-#-##----#--#--#--##-#-#-----#--------#---------#-
--#---------#--#-#---#---#--#----##---#-#---#----------##----#---#------------#--#----#-#---##-##-#-
------------#----#-----#--###-##----####--#--##----#--#-#----##-#---#--#--##-#-##-#-#----###----##-#
##--#-#---#-#---###---###---#-------##-#--#-------##-----#-#--#-##--#-#---#--#-####-#---##-#--#-#---
#-------#----#---#---#--#-#-#####---##--##--#---#-----#-##--#---##-------###-#-#---####-#-----#--#--
#----#-#----##----#---#---#--#--#--##-#-----#----#----#-####--#-#----------#--#---#-------##-#-#-##-
--#--##-#-------#-#---#-----##-#-#---#-######--#-#--###----#----#######-##-#-#---###-#-----#--#-#-##
