-#-----------#-----#------#----#------#--#--#----##---#----#----#--#--##--#-##----#-#----#-#----#--#
-----##---##--#-#------#-##-#---###-#------###---###---###------#------#---#---#------#-#-----##--#-
-#-#-------#-#--#-#-###---###-----------##---###--#--#----#-#-----#--#-#---------#-#-#-----##-----#-
--##-#---#-#---#-#------##---#-##-##----#-#-----#--#--#----------##---#------#------------------#---
#-#--#-#-#---####-------##--------#-#------#-##-#--#----#-#-------##-----#-#----------####---#------
--------#--#------#-------###-----#--#--#-#---#---#-##----##-##---#-----#----#-##-##-#--#---#----#--
-------##-##-#-----#-#---#----##----#----#-----##---##--##---#----#---------##-###--#--##-----------
--#-#-##--------#-----#-###----#-##-##-----#-----#-##-----###-----#------##--#-#-#-##-#---#------##-
------#-#----#----#----------##--------##-----##-#-------#---##---#------###-------#-###---#--#---#-
------#---#-##-----#-------##-#-----#-#----##--#-#-------------#-------------#-###----#-#-#-----#---
--------------#------#-#-####---##-#-#-##---#-##-#---#-----#-----#------#----#-#--#-#----####-------
##--#-------#--#------------#---#---------------#-#----####------#---##-----#--#----#--#---#-#---#--
--#---##--#----#---#----##-#-------#-#--#---#-##-------#----------##----#---###----#----###-##-#-#--
---------#-----#-###-----#--###-#-------#----###------------#-#---#--#---####---#--###------##----#-
-#----##---------#-----#----#-----#---#-----#-#-#-----##-###-##----#-#---#-#--##--#--------#---#--#-
--#-#-#---#-#-#-#------#--#-##-#-#---#-####-----#-###----#--##--#-#-----##------#--##--#---#----##--
----#--#-#------##-----#----#-#---###----#-#----#-##-#-##--#--#---##------#-#------#----#-###----#--
------#-#-------###--#---#--##-------------##-##-----#-#------##--#-#-#--#--#---###--#-#-#---#-#-###
-----#-#---#-#----##--#-#--#---#-----------#----#--#----#--#-#------------------------#-##--#-##-#--
------#-#-#-##-##--#-----##-#----#-#-#---##--##---#---#-###-#--#---#---###--####-----#---#-###----##
--##-#-##--#-##------#-#-----#---##----------------#----#---#------##-#------##--#-#---#----#--##-##
----####-##--#---------#-#--##--#----##---#-#--#---#-#---##-##------#--#-----#-------##----##-##-#--
#------##--##-----#-----##-#-#-------#-#------#----#--#---##---#-#---##-#-----------##-#---###------
#--#--#----#---------#-----##-------------#####--#-##-----#-----#-----#--##--##---##-##------###----
---#-#----#--#---#------#---##-#-----#--#-#------#-##--#--------------#####-####--##-#-----#-------#
-##--##---#---------------#-#-##-#---#---#-#---#------#---------#--#-##-#-#--##----#------##--#----#
#---#-#--##------##-------------#--#-------#--#---------##-##--###--------#-#-----#-----#-#-----#--#
-##---#--#-#--------##----#-#-----#-#--#----###----#-#-####---##-#---------#-##-----######-##-#-#-#-
-#-#--###-#--#-##--##----#--------##--##------#-#--#-#-#---##---##----------##-----#--##-#--#-#--#--
-##----##--#----#---####-----##-----#-#--##--##---------#------#----#------#----#----------#-#-----#
--###--------#--#---#------#-#------#--#----##--#--#--#---##----#--#---#----------####-#---##----##-
#------##--#-------------#----#--#---##-#-#####-#---###----#---------#---------#-######-#-#-#-----##
------------#---##-#----#-#-###--#-#-##---#--------#-##-#--#--#-###--#------------#------##------#--
--------#------#-------#-##-##-#----##--#--#---#------##-#-#---##---#--#-#---#-#---#######-#--#--#--
--#-##-----#---#-------#-#-----------#--#--##------#--##---#-#-#--#-----------##---------##---###---
-##-----#-#-#-----#----#-#---###-##-#--------#--#--#-###-#--#----#--#-------##-----#-#----------#--#
--#--#-#--#---##-#--##-#-#--##---#---##-#--#----##-#-#-#-#---#----##-----##--#----#-##--#--#--#--#-#
#--##-----#---#-----##-#-----#--###------##---#-##--#-#-------#-#-##----##----###--#-#--#-#----#---#
--#---##-#---#-#-----##-###--#--##--------###----##---#---##---##--------#-#------#-------##--##----
---##---#------###----##-#---#------#-----------#-#-----####--#--------#----##--#--#--#--#-----##--#
--#--##-#-##--#-#----##--------#--#-##----------#-##---------#-------##----------------#--##--##----
##---##--#--##--#--#---#-#-----------#-##---------#---#--#---#-#-#---#------#----#---------#--#-#-#-
-#------------#-#-#---#---###-#---##------##-----------#-##---##--#---###---#------#---##--#-##----#
--##-#--#-#-----#-#-----#-------------#-#----#----#----#-----#--#-##---#-----#---##-#--##--##---#---
------#-#-#--#---##--#-#---#------##-###---#--#------#-##-#----------------#####---#-#----##-#----#-
#---##-###----#--#-----###--#-##--#-#-#-##------#---#-##--####---#-------#-----#--#-###-####-#-##--#
----#---#----###-----#-#-#-#-----#-----#-----#----#-#--------##----##-###-#------#----##-#--#----#-#
----####-----#-##-##-----------#-----##---#-##-----####--#--#-----##---#-#----#---##----###-#-#----#
------##----------#---------#-##--##--##---#---###----#--#-#-----#--##---#-------------#--#------#-#
-#---#-#------#---##-#-----#------#--##-----#--##--##--#-#------##---------#--#--------###-#--##-#--
----#----###--###---#-##----#--#-#-##-----##----#--#-------#--#--#-#-------#-#--#----##---#--#------
#--#--##-#--#-#---#-----#-##------#---#----###------#------#-##--###-#--#-#####----------#---#-#----
------#---#---##-##--#-#--#-#-#-##--#-----###---###---#-#-----##--#-#-#-----#--##---------------#---
--#-----#--#-#--#----------#-##--##--###------##-----###--#---------#-##---#-------##-##-----##---#-
--#--#-#-#--#---#---------##-#-#-#-#---#----#--#------#--#-#---#-#-------##------#-##-#----#-----#--
------###-#--#------#----#--##--#---#---#--#------#---#--##-------####-#-##------###----##----------
-#---#---#----#-#---#-###-#-##-#-#--#--#-#-------##-##---###-------#-#----####-#-##-#-###-####------
##------#---#-#--#-#-------#---##------##-----#-#-#--##---#-#--#------#--#-----#--#------#-----###--
-#--#-----#--#--#-----#----------------##-#----#---#--#---#-------#--##---#--------##--#-----#-#--##
---#-----#---##--##-----#-#--#--#-----#---#------##--##--#-##-----#----#------#--#--#--###-#-------#
##-##------#----#-----#--#--------#-#---#-#-------#-----#--E-##--##-#---------##------##-#-#--##----
------#---#-#-------#---#---#-#-----##-#--##--#--#-------#-----#----------#--#--#-------#-#--#------
#----#----#--------------#-##--###-#--#-#--##---#--###--------------##----#---##--#-##---#-##-##----
#-----##--#-----#--######-##-------------#---#----##--#---##---###-----#-#-###-#---##--#----------##
-----------------##-#----#-----------#--#---#-#-#--#-##--#-#--###--#----###---##-#-#--------##---#-#
--#----###-#---#--#-------------#--####---##---#-#---#-------##-#--------#----#-#-----#---##---###--
-----##-----#---#-#----###----------#---###---##-##----#--#---#-##-###---#-------#--#-#--#-#--------
-##-#-#---###---#------#-#------#---#----##-#-#--##-#----##---##---------##----#-----#---#-#-#----#-
---##-----#-------#----#----#---##-###-#-#------#-----#--#----###----------#-#-----#-#------#-#---#-
#-#--#------#--#-------##---#----##---------##-#--#---#-##--##-##-------#-#---#-#-----####---#---#--
#-#-#-#-#--##-#------###--#---#-#----#-#-----##-#--#-#--#---#-#--##-------##-#--##-#------#---------
#---##-#----##-#-#-----##-####-#-#----#-----#-###----#----#-#--#--#-##-#-#--##----###-#--##----#---#
---#------##-#-#-------#----#---#---#------#--#-#--##--#-----#------##-###-##----###-##---##--------
#--#--#---#---#-#-----#-##--###---#--------#---##---#----##-#--#-#------##-#-#---#---#---##--#--##--
-----#---##---------#------#--##--##-----#------##---#--------#--####-----#-###-----##-------##-#--#
##--##--#-#-------#-##-#-#----#----#--#---#-####-#--#---#------#---#---#-##---#--#---##-#--#--#-----
-#-#----#-----#----#----##-----#-###--###-------#------------###------###-----------#--#-#---#---#--
##---###--#-##---------#-#---##---#-##-##-----------#---------##-----------##------#--##--------##--
#####------##--#--#--#----##---##---#-#-#--#-----------#-------##-#-----#----#-##----------#---#----
-#--#---#---###------####---------#--##-----#-#---------##------###----#-#--##-##----#-#-------##---
-#####-------#---#-#-------##---#-#--------####----#------#----#------#-##---------##-------#-#-#--#
-----#---###--#-------#-----#-------------##-#---------------##----##--##---#---#-##-#--#---##--#--#
-##-#--#-----#-#---###-#--------##----##-----#-#-#--##-#----#---###-----#--#-#----#-####----##-#--#-
#---#---##-#-----#-#------#-#--#-------#-#---#-----#-----#----##-#-----##--#-#--##--#-#--#---##-#---
-#--##-###--#-----#---#----#--------#-##-#------#---#--###--#-#-#--#-------####---#---#------###-#--
#-----#--#-##----#--#-----#---#--#-##-------###--#-##---#-#-------####-#-#-#--#####-##-#-#-#-#---#--
---#--#--##-------------#------##--#-#-----#-#---##------#-------#-#----------#----##-#-##--------##
##---###--#---#-##-#####--#---#-##--------#--#-#-----#--#--#-------#####---#--#-#-##----#-#-#--##-##
#---#-##----#----#----#----#-#-#---#-##-----##-#-------#-#--##-----#-#--#-----###--###------##-###--
--#------#--#-##-#----#-#---#--------##--#--##--##--###---#---------#----#--------##----------#--#--
#---##---#-##-----##-----#--#--#-#--#-#----##-----#--#---#-#--##-#-###-----------#---##--#--###--##-
---#-##----#----#-#---#---#---##-------#-#-##-#-#-#----##-------#-------#---##---------#--##--------
--------#-------------#-----#--##--------##-##-##-#-##--#-#--#-##----------##-------#-##-----#-----#
#-------#------------#-#---###---#--------#--------------#----#-------#----#-------#-#---#-#------##
----#---#----#----------#-------#---#-##---#----#-#-------##---#-----##--##--#-----##---##----#-##--
#-#---#--#-#-#---##-#------###------##-#--#-#--###--#-----------#---##--##---#---#----#---#--#-#-#-#
###--#--##------##-#-#-#--##---#--------#---#-------#--##-#--#-----#-#-#----#-----##---#--#-#-#-----
-##-----###-#-----#-----#----#-#--#--#-----#--##--#-----##-##----#--##-##--#--#---------#---#-##----
-#-S--#-----#-###------#-#----##--##-#-#---#----#-#--##--------#-#--##---------#-------##-#-#--###-#
#-#---#-####--#--##--#--#-#-----##-#------##--#####----#--#---------##------#------#----#-##--------
