##--###-##--#--#--#-#--###-#---#----#-#----------#-#--#-#--###-##------------##-----##----#####--##-
-#-#---#--#--------##------#---##-------#-----#------------##-###-###-##-#-#------#-####--#--##---#-
#--------#-##---#---#----##----#-----#-#-###-#--#------#-----#--###-#-------#--#-#---#---##-#--#--#-
##------##------####----##--#-#-----#---####-#---------##----##-#--#-#-----#-------#---#--#-------#-
#------##-##--##---#-#---#-#-----------##----#-------#-#-----#--#------#---------##-#----###-#---#--
##--#--#---#-#--#---#--#-#-#--#--#----##---#--#-##---#-------#--##---------#--#----#--##---------##-
--#---#---##-#--###-#-----#--##-#-----#------#------#---------##--------##-#-#-#--#######---##---##-
-##--#-----#-#------#---#--#------##-#---#-------#--#-#----#---#-#----#-#--#-#--#---#----#-##--###-#
------#---###----##-##---##-----#--#------##-###---------#-###--#-##-##--------##------#-#---#----#-
-#-#--#---#---------##---#-#--##---#-#-#----#--####----#---#------#------#-----#-----###--###--#----
#-##--#--#---###---##---#---###----#---#-----#-----#-##---##-#-##------------#--#--##-###------##--#
------#---------#-##---#-##---#----#--#-------------------#-------######--#--------#--------##---#--
---##----#--#----#-------##----##-#-###-##-##-----##--#-##-##--#-#-##---#----#---###---##-#--#---#--
-##--####-#-#-##-------###--#--#---------#------##-#-----###-#---####-#-#----##--#---#----#-----#--#
---#---##--#---###--#--#--#-##-###----------#-------#----#-----#-###---#---#--#--E#------#---------#
---##--#-#-#-------#-#--#-#-#------#--#--#--------#-##---#-#----#-##--------#-##--#-----#-------##-#
-#-#--#-#---#----####-#--#--#-----#-##-##--#--###-##-----##-#--------#--#-------#---#-#----##-----#-
--#-----#----#----##---#-------##----####--##--#---#---#-#----#--#--------#-----##--##--#-#-##------
----------#---------##-------##---#-----#-#-#---##--###----#-----------#----#-#---#-#-------##--#-#-
---------#--#-#-#----#--#--------#-------#---##---#--#--##---#-----#-----#----#--##---#-----#---#--#
--#------#-------#-####-##--#------#----#--#--#-##-----#----##-#-#----##------#-#------#-#---#---#--
------#-#-----#-#----#-----------#-----#--#--#--##----------##--#----#--#-#-#---##-#-----#-#-#----##
--#----#-#-#--##--####--#---#----#---#--#-#--###---##-#-------#---------##---###---#---------#----#-
###--#-----##-----#---#-#-#------#-#-###-----#-----#-----##--------###-##---#----##--#--#-#--------#
-#---##-#--------#-#-----------#-----##--#--##-----#-------###---#------------#--------##--#-----#--
--##---#--------#-------##-#--#---#--##--------#-------#--#-------------##---####--##-###--#-------#
-----------###----#----#-----#---------#-----#---#--#--#-----##---#---#--#-#--##---#--#----#-----#--
#----#--##----#--------##--##-#-#--#--#-#---#----#----#------#-----#--###-###-##-#-#-#----##------##
---#--#--#--##---##--#-#-----#-#---##---#---##--#-------#--##-#--#--------##---###--#----##-#-------
#----#--#-##-#----#------#---------#---#-------#---#-----#-#---#-#--#---##-#--#----###-#----##--####
-#---#--#-#-------#--------#----#-----##--#--#-#-##---##-#--#------#-------------#----#----###-#--#-
#-#---#----#-----#-----#---#-#-##-##--##---#--#--#--#----#-#-#---#--#-#-----#--#----##---##-----#-##
--#-------------###-#-----####-#----#-#----#----#---##---------####----#---######---------#--#-----#
-#--#S-##--------###----#----#-#---------#---------#--#--#---##-#-----#----#----#-#--#---------#--##
------#-----##--#-----####--#--------###---#---#--------##----------#-----#--#----#####--#-----#--#-
---#--#---####-#--#-##-#-#-#----##-#---###-----#--------###---##----###-----#--###---------#-#-#--##
-----#-#---------#---------#-------#---#-#-----#---#-----------------##-#---#####-------#------#----
#--#----#----------#---###-##--#-#-#-------#------#-----#--------------------#---#----#-#----###----
-#----#--#---#-#-----##---#---#-----##----#---#---#-------##---#---####-#--#------#------#-#-##-###-
##--#-#--#--######--##---#-#---#--#----#----#---#---#--#-#-#---#--#-----##------#---#-#--#---#-##-##
#------#---##---###---#-###-#-#--#------#-##---#-#---#------#---#-##-#----#--###-----####-#-#---#---
--#-#---##----##--##-----##-------###-#-#--#--#--#-#---##--#------------##-###--##------#--####--###
--#--#-#---------##-----------#---------------##-#--#----#--##--#------##------#-----------#--#-#---
--------#---#---##-##---#-----#-#-----#----#-#-##-#-#-#-----#-###-#--##-----------##-##-----------##
---#---#--#----#-----#---#---##-#--#--#-#-#------#--#---#---------#--------#-####---####----#--#--##
#----##--#-##-#------#-----#----#######------##---#-----#-##--#-------##-#--------#-#--#---#--#----#
--------##-#----------##-#-#------#-#----##-#-------#------#---------##-#----##---#---#---#-#-#-#--#
-##-#---#--##--##---#--##-------####----#---##---------#-------#--##----#---#--#-###------#-----#-#-
#--###----####-#---#-#-#----#--#---##---##---##----#--#-----##-----#---###---##---##-----#--#-#---#-
-----#-##---#---#-------#-#-#-------#---#--#--#--#--#--#-#-##--#-#-##--#----#---#-#-----#----#-----#
-####--#--#------###--#-------------######-----##--#-#-#-##--#-#----#-------##----#-#--#-###--#-##-#
#--#-----#-##-#--###--#---#-###----##-----#-#------------#-#-------##-----#-#-#---------------#-----
------#--#-#------##-#-#--##--###---------#-#---------##------#----#--#---##-#-#---#-------#-#-#-#-#
--##----#-#--#-----#-----#---------#---#-#-##--------#--#-------#----#---#----------#---#----#-##---
-#--#-#----##---#---#----#--##-------##-##-###-#---#--------##-----#---#---##---------###--#-##-##--
--##----#-###-------##---------#-#---####--#----###--#--------#----#-#-----#-##--#-------#-#--#-----
-##-#--#---##---####-##------#------------#-###-------#------###--------#---#-#-###-------------##--
#--#-##-----###--#-#-------#-#---#--#-----##---#---#------##---##-##---##-#------------------##-#---
-##------#-----------#----#-#-#--##--#--------------##---------#----#--#-----#-#----#-#---#-#-------
#--#-#------#-#-##-----#--###--##------#-----##--------------##--#--##------------#-#-#----#--------
-------#--#----------#-#--##---------##---------##-#----#----#-------------#-#-##-##--#----#--------
-#-------#----#---###--####-----##-##-#######----##------#--#-------#--##------##-##-##----#---##-#-
---##-----#------#--#--#--##-#-##---#-----#-#-#--#-#-----#----#---##--#-----#-#-#-----#--#-#----#--#
---#---##--#-------#--------#----#--####--#---#-#-----#----#----------#-###-#---#---##------##---#--
---#-#--#-#----#---------##-#--#-##-##-#---------#---#-##-##----#--#---###---#----#--#------#--#----
-#--------#-#--#----#-##---###----#--#-#-----------#--###----#-#--###---#----#-#--#--#-##--#--------
---##--------#---#----#-#-#-#-#-#---#--####-#-------##--#-------##-----#-----####--#--#----------#-#
-#-#-----#-#-#-##-#---#------------------##---#--###-###--#--#--#---#----#---#--------------------##
--#---#-#-#--####-------#--#--#-----#-#---###-#--#-#-####----------##-#------#--#----#-###--##--##--
-#-#--------#--#----#------##--#----###-----#-##-#--##--#--#--#--##-#--#---#---##-#--------------###
---#--------------##----###--###--#--##--#-------##-#-###----##---#-----#-#--#-##-----#-##---#---##-
-#------#------####----#---#--#---#----#-----#---#-#--##-#-#-###---#--#--#-------##--#--------#-----
---------#-#-----------##---#-#--##-#----#-#--#-----#-----##-#----#-#---#---####----------##--------
-#----#----#--##-##-##-#-#-#-#---###-----#--#---#---#-----##-#--#----###--##---#--#------##--------#
-#-#-#-#---#------#----#-----------#--#-#-------##------#--##-----#--#-#------#-#----##---#---##--#-
---#--#--#---------#-----##-###-#------#-#-#-----###-#--#----##----##-##--#----#--------#----------#
-#----###------------------##-#---#---#-#-#-#--#----##------#------#-##-#--------###--#--#--#---##-#
#--#-##---###-#---###-------##-#-#------#-----#-#--#-#--#-----#--##---##--##------------------#----#
-#---#---##----###-#-#-##-#--#---------#--#-#--#-----##-----#--#---#-#--#----#---##----##-----##-#--
##--------#--#-##-----#---##---#----#----#-#--------#-----#--#----#-#--#-----#-----##----#-#-#-#----
#-#--##------#-------#-#--#----------##---#-----#--------#--#-----#--#----##--##-#-----#-----------#
----##----#--------##------##-##--##---#-----#-###-#-------#-----#------#--------###-###---##-#--###
--####--#--#-----###---#-#----#-#----####---##-#-------##--#-#--#-##-------##---#-#------#--#---##-#
-##-----#-#-##--##------####-##---#####--#-----#---#-##-#------#-#---------###------#-----###---###-
##----#-##------##-#-----###--##-----##-##--##-#-----##----#----#----#------#-----##--------#-#-----
---#-----#-#---#--#-#-----##---#-#-#-##----#----#-----#-#-#-#-##-#--##------#---#--######-#--------#
-##---#-#-------##-#-##--###---#---#-#--#-#------##-#--#-#---##--#-#-----#--#-#----##-----#--##-----
-#--#--#--##-##--##-#--##--#---#-#-#-##--#-----#--#---#-#--#---#----#-----#-------####-#---###--#---
-------##-##-#---#-----##-##------#-----#--###------------#----------##--#-----###-###-#----#---###-
-#-##-#---#-###-#-----#-#-------##----#-#-##---##---------###-#-#-------###-##---##----#-#--###-----
-----------------#-------######-#-----#------#-#-###--#-##--#-#----##--#----##-###---##-----#---#---
---####--------#---#---#----#------#-#--#----#---###---------------#-##-----------#-#---#--##-##---#
##--------#-##--#-----#-------#------###-###--##-----#------#-#---#---#----##--##-------#---#---#---
##----##----#--#-------#----##----#--###------##-#-#-#----#-#-----#---###--#-#-#------##--###----##-
-#---##----#-#----#---##--------#---------##-#---#--###-#------##-###------#-#--------##-##---#---#-
#------#--#-#-#--##--####---#-#--#-####-#----###---#-#-#------#---###-------##-#--#--##--#-##--#-#--
------#--#-#-------------#--#-#-#--#--#----#--#------#--#-----------#-----#--#--####-#-#----##--#--#
---#-----#-----#-----#-----#--##--#-###-###----##----##-##-----#--#-#-###---#------#--##------#---#-
-----#-####----#--#--##----------#-##-#------#--#--#-#--#--#---#----#-----#-#-#----------------##--#
--#---#-#----#-#-##--#---##----#-#-#----#--#-#------#--###----#---#-#-----#---#-#-#-###---##-#----#-
