#-####-###------##---------#-----#---#----#---#-###--#-##--#----##----#---#--#---#-##---#--#-#----##
-#-#--#-----##---#-##---#--#-----#--#--#-#------##--#--#-----#----#-----#--------##---###---##---#--
----#-----#--#----#-----#-#-------#--###-#--#---##-#-------#-----#----#-#----#----#-##--#----------#
#----------#---#-#---#-##---##-#-##---#--#--#-----##-#-----#-#---#---------#-##-#---#-#-#-#---##----
---#---#------#--#-#--#-#--##---#-#------#-----------#-#-#-#---#----##--#--#-#-----------#---#--##--
-------#-###--##--##------#----####--###--##-----#-------##---#-#--------#----###---#---#----##----#
----#----#----#--#---#-#-#--#-#---#---#-#-##----##----#--#--------##-###----#-----#-----#-------#---
-#---------#---#-#--##---###---#-----###-#--#-----#--#------#--##----#---#---####-##---##----##-----
##---#--#--#--#----#-#----###----------##-#-------####--#---##-#-----#----#---#-----###-#---##------
-#------#--------###-----#---#----------##------##--##-------#------#---##-------#--------##-----#--
--#----------##---#---#-----#----###-#------#-#-##--#---#---#-#-----#---#--#-------#######-------#--
--###-----#----#-##-------#-##--###--###--##-#--#----#---##---#-------#-##----#-----#-###---#--##--#
---#-#--#--#------#--#-#---####--#--###---#----#--###-#--------#----#----#-#-#--#-----####-#-#--#---
#------#-#-#--#--#---#---#--####---##--###---###--#-#-----#-#---###-##-------------#----#---#-----#-
--#----#-##-----------#----------------#-#----#-##-#--##-##-------#-----#---#--#--------#---#-#--#--
-----#----##------#-###-#-----------------#---###-----#-#----------##-----------####---#-#-#-#----##
--#-----#-------#---##-----#------#-----------#--------##-#-#-##-##--#----#-##-##-####---------#----
--##-----#----#-#-##----#--#---#---##--#--#-#-----#-----#----------#--#-#-#--#-#-------##----######-
-#-----------#--##-#-----##-##----##----#-#--#-------#----#--#---#--#----#-#--#----##--#--#-##--#---
--#--#-#----##--#----#----#--------##-#---#------------#--#----###--#---#-#---#------#-#-----#-#-#-#
#----##----###--------#-#------##------#---##--#-##-#-##--#------#-#---#---#--#-#-#--#-##-----#-##--
#-##-#-----#----#--##-##-#-#-#####----#--#-##----------##-#----#--------------#-#--#----#-#--#---#--
-##-#-#--#---##-#-####-------##---------#--##--#----###------##----#--#--#-##---#-#----###-##--##---
-#--##--------#-----##------------#---#--##------#---#--#-##-#--##-----##---------##------##---#-##-
---#----###--#---------#--#--#--##--#---#-#-##--------#----------#---##--##----#-------##----#---#-#
#---#-#-##-###------#--##-#----#---#----#---#-#---#-#-#-#--##---#--#--#---#----##-#-#-------###-----
----#-#--##-#-#-#-#-#------------#---#------#-#----#--##-#--#-----------#---##-###-##-----------#---
##--#----#----#---#--###-#--#-#-#---#-#####---#------##----#--#-#---#--#------#-----#----#---#-##---
------#--#--#---#-#----##----#--------------##----------#-#----#-##--------#--#--#--###--#---#-#---#
----#-----###-----------#-#-#-#--#-----##-##---#--##-##------##----------#-#---##-#--#-#---#----#---
---###--------#-------#-----###----##---------#---#----#----#-####-#--#-#---##-----##--###-#----#-#-
#----###-------------#-#--###---------######-----#---##---#--#-#-#-#-------#--#---#---##-------###-#
----###---#-#--------#----#-##-----##---##----#----##-##--#---#--#-#----##-#-----#-----------#-#-##-
---#--#-#----##--#-#-#-#--##-#-#---##---#----#---##------#-----#----##----#-#-##---###---#--#--#--#-
#-------#--####--#-----#-----##---#--#----#----#-#-#-----#--##-----##--#-##---##-##--##----##----##-
-------#----#--------------#-#---##---------#----#---#-------#--##---#------------#---#-##--------#-
##-------#---#-----#----#-----#--#---------#---#---#---##------###--#-----#-#--#---#----##-----##-#-
-##-----#-----#--#---------#-#--##-------------------###---#--#----##---#-#---#---#---#-----###-----
#--#-#--#-###---#----------##----#--#---#-##-----#--#-##-#--#-#-##----------#---#-----##--#---###-#-
###-##-##----#-#--##-#---##-#----#---#-#-------#-###---#--#-#----#--##--#---------#---#---------#---
##-#-#-#-####------#----#-#-#-##-----#-#-----#-##-#-#-#----#-#-#--------###---#-#-----------#-----#-
------------###-##------###-#------#---##--#-#--#-##-#--##-----#------###--------#---#---#--------#-
-#-----#--#-------##---#-#--#-##-#--#-##----###-----##---#-##--#---#-----#---#---#----##----##-###--
-#-#------##---#--#-#-#-#-#-----------#--#---#-#------##-#---#-------#-------#--###---##---##-##--##
------#-####-##--#--#-#-----------#-#---#-#-#----#-#---##-------#----#---#-####---#--------#-##-#-#-
---##------------#----#----##-------#--#-#---#--#--S--##-#-#--#-------#-#----------#--#---#---##----
##---#--#----#-#-##---###--#---#---#---##---#-----#-##---#------#---#-----#--###---#-##-##-#-##-#--#
---##-#-#-#-----###---#-####-##-----------#---#-##----#----#-----#---#-#-#-#--#----##---##-#--------
##----##---#---#-#----#---##-#-#-#####---#-#----------#----#-#------#------#-##-#----#--##--###-----
----#---#---#-----#--#------#-------------#-------#-#------#----#####---#--#--#--#--#-#-#---##---#--
---#-----###-----##--#----#-#-#----------#-#--#----#----#--#---#----##-#----#----#-#-##----##---#-#-
#-#-###--------#--#---#---#-##--###--##--#------##-#----#-----#--#----##---##-------#-#-----#---#--#
--#-------#-#-##----#---##--#-#-###-#--#--#--#---##-------------##-#----#-#-##--##--------##--#-----
#-#--------##-#---#-------#------#--------#####-#-##-#-##------#---#---------#--#--#-#--#----#------
---#----#---------#---#---#----#-#-#--#--#---##---#--#####-------#-#--#-----#-#-#------#---#--------
-#--------#---#--#----##---###----#--##-------##-#--#-##-#------#---#--#----##--#--#-----#-#--#-----
-#--##----####-#--------#---#---#----#--#-------#----------##--##-----#-#---##--##-#---#-#-#----#---
---#---##-----#-#-#---##--#---#---#---#------#----#------------------#-#---#-#--###--##-###-##-##---
-----##---##----#-##--#--###--------------#--##-#---#-####----#---#-#-#--##---#-#-#----#--###-------
--#-##--#-###--#-##--#---#-#-##-#-----#-#---#---#------#-----#--##-#-#-----###-#------##--###-##--##
--#-#------#-#-##--#----##--------##--#---#-#-----#-----#---#-#---#-#---------#-#--#-----#-##-----#-
---##-#-------###-#-##---#-#-#-----#-#--------#-#-##-#---------###-#----##-###--#--##--------##--#--
------#-##-------#----##-#-----#--#--##--#--#---###----#----#--#----#---#-#-#-#-##-----#-###---#----
-#--#-#---#--------#--------#--#--#----#---#-#-------#-#---#--#-##---#-#-------#---##-#---#-#--#-##-
---#-#---##--------#-#---##--E------#--##---#--##---#-#-#---##-##---##--#-----#--#-#--#-#------#----
--------------#----##---#-#---#---#-#-#-##-###--##--#---#------#--##----#--#-######---#---#-#---#--#
#-#-#--------#----###--#---------#--------#---#-##--#-------#-----#--#-##---#----#-#----#---#-------
------#-##----##-----##-------##--#---#-#-------#---#-###---#--#---###-#-#--#----#---##-#-##--##----
-#--#--#-#---#-#-#-##--#--###-#---#-#-##-###-------#------##---#---###--#--#-#--#----------#-#----#-
-----#------#---#---##---##-------------###------#-#--#-#---###----#-##-#-----#-#-#----#-#----#-----
-#--#-#--##--#--#--#--#------------#------###----#--#--##---##-------####--#--#---#-#----#----#-----
-----#----##-----#-####--#---#------#--##--#------#--#-----#-#--###---------#-#-#--#-#----#---#----#
------#------##---###-----#-#-#--#----------###-------#-##---#-------#---#----------#---#----##--##-
##--##--#------#--#---##---#----#-##--#--#--#-####-#-#-##---#--------###-#---#----#----#-#---#--#-##
##-----#---------#--#---#--#-#-###-------#--#-#---#-------#-------#---#-------------##-----#------#-
--##-----##-----------------#---#----####--------#---#--#-----##----#---#---#-##-#---#-------#-----#
----#--#-#-##--##----------##--#-#--###-----##------#---##-#--------##--------##---###---#-----#----
----#---------#-----------##---#----##--##--#--#----#-----#-#---##--#----###------#-##-#--------#--#
------#---#-----------##------#---#--##----#-----####-#--------------#---#--#--#-------#-###----##-#
###-----#--#-#------##---#-#--#--###---#--#----#----##-#----#-------------#-##--#-#----------#--##--
--------#-##-##--------#####---###-----##---#-##--#-------#--#--#-#--###-#-----#-#--#####------#-#--
-#---##-###-#-------###-##---##---##--###-#-###--#-###-----#----#-#-#--#---#--#-#--#---#-----#-#----
-##-##-#---#-#-##-#-#-----#-##-#--#---#--#---#----##---#------#--#-#----#--#-#----#-#--##---#--#----
-#-#-----------#--##--##-#-------#-####-#-#--##--##------#--##--------#-#--#--#-#---------------#--#
-##-#-----#-#-----##--#-##-####-----#--#----#-------------#---#-##--#-#----#-#---------##-#----###--
-#-####--------##---#-#----##-------##-#---------#--#--#-#---##---#---------###-#-#-####---#---#----
--#-----#--#-#--#-#-----#----#-#--------##--##----#-##-##-#-##-#-##----#----#---#--#--#-##-#--#-----
------#-#------------#-##--#--#---##--------#--#-------##--#--###---#-------##------------#---------
-#----#-------#----#---#-###-###--#-##--------------##-#-##--#--#--#------#---##-#------####-##---#-
---#-##---#---###--#---#----#------#------------#-##-#---###--#-###-----#-----#-##------------##---#
-##--------#-----#--#-#--#-----#-#--#-#---#-----##-#-#------#-#----#--#-##-#---#------#####---##--#-
-##--#--#----##---#--#--#-#--##--------#---------#-#---#--#-#------##-#-##---#-#-#----##--#####--#--
--####---#------#-##-#----#---#--#-#-----#-#------#-----#---#-----#-#----#---####--#-#-#--#---------
------------------#--##---#---#-#-##-------------#-#--###-----#-#----#----#-----##--#---#-#-#---####
------------#-----#-##-#--#--#-#-------#---##-#-##----##-##----##--##--------#-###-###----#---#-----
##--------###----#-#-#--------#-##------#--###-##-#----#-##-##--#---#---#--#-#---##--###---##--#---#
----##---------#--#---#---------#-##----###----#------#----#---#---#--#--#------#-#-#-#-#--#--#-----
--#-#-#-#---#--###--#----#----#---##---#--##----##---#-#--#-#---#------------#--#-#--#------#-#--#-#
-##---###-###-#-#----#-#-------#------#-#------------#--#---#-------##---##--##-#------#-#---##----#
--#-##----#----#-####-##--##--##-#-#--##-#--#-#--#--------------#--##-#----##---#-#------##--------#
