###-#----#--#-##---#--###-#-#------#-##--#-----#-#-#---#--#---#--#---#---####--#----#--#--#--------#
-##-#-###--#--#--#----------#-####----#------##-###--#--#----#-##----#-#--#--###-##--#------##-#-#--
-##---#--#------##---#--------#-#####--###--------------#####--##------#-#####----###---#-#--##----#
-#--##---##--#----#---#-------######----#----#-----#----##--####------####---#------#-#-#-###-#--###
#-----##--#-#---#-###---#------------#------#--#-#--#----------#-----#---#--#-#-#------#-#--####----
-##------#-#-##-#-#---#-----##---------------------###-------##-#------#-#---##--#------------##----
-#-#--#--#--###-----#----------------#--##---#----------#----#-----##----#--#-##-------###-----#----
---#-----##-----##-#-----###-#------##-#--#------#--#---#--##--#-####-----#--##-#--#-##-#-#--#------
--------#-#---#--####----#--#-#-----#-##---#----#--##------#-###-##-----------#-#---##----#------##-
--#-------##------#--##---##-##-##-#------#-----#---#-#--##-#-####--------##------#-#----##--#----#-
##--#--#-#-##---##-#------#--##-###----#--#--------##-##-#--##--#-----------#--#-#--##-----#---####-
#----##----####-----------#----#----#--#----#--#--------#-----#-------#---#-#-#------#-#-------#---#
###--##----##----#--##-##------#------#-#-##---#---##---#-----#-#--#-----##-----#-------#-#-##----##
--#----------####-#-#-####--#---##-#-----#--#------##------###---------##-##---#-----#------#----##-
-#----#--#---##-###-------##----#-##-#-#--##-----#--#-----#-#-#-----#-#---#--#--#--#-#----##-##-----
--##----#-#---#-----#----##---------#-##----#-#---#---#-#-###--------#----#----------##-###-------#-
-#-##---#------#-##--#-####----------#-#------#-#---##-----##-#---#-#--#----#--#-#--#-##-###-#------
#-#--#-#-----#--#--###-#--#-----#-#-#---#--------#-#-#---###-----#-#----#---#--#---###--------#-#-#-
-----##-#--#-#-########------#-------#---------#-#--#--#-----------#-----#--#-##------###-----#-##-#
---##----######-------###--##---#-----#---#--#--##---##-----#--#-#--##--#---#-------------##-#-----#
---##------#-----------------###---#-#----##--##-##--#----#--#--------#---------##-------##--#--##-#
--##--#-------#-------#---#---##--#--#----####--#-##--#-#-##---------##---#--##----##---#----#---#--
-#----#------#--#--#-##------------#-####------#------####----###-#-#-#-#------#------##---------#-#
##----#-#-#-#-----#---#-#-##--##-----##-##----#--##--#--#--##---###--#--#----##-----##------#-#---##
-##--##--------#----#-#--##--#-##----#-----####----####----#-#-----#----#-#--#--------#-##-------#--
#-##--------#-###---#--#---#--#--#--###--##-#---#----#--##--#--#---#---#-#--#---#----##--#------#---
-#--##-##-----#-----#--#####-#-----#-##--##---#--###---#--##-##------------#-------------#---###--#-
###-##-----##-------#-#----#--#-###-#-#-####--#---#-##-#---##-----##----#------------#--#-#-#-#----#
----##--##---#-------##--#----##----#--------#----#-#--##-----#--##---###------##---#-----##-----#--
--#-----#--#--------------##-#--##--###-----#---#-#---#-##---##-#----------####--#----###--#---#--##
-#-#-##---#----##------#-#-#----#--#---#-#--####-----###---###--#--#-#--#-----#--##---#-#---#--#---#
-#-#-----#---##--#------#-#--#--#---#-------#-#-#----#----#------------#---###--------###--#----##--
---##-----#---#----##--#----------#-#-#----#-----#---#-------#-------#-#----------#----#--#-#----#--
-#--##--#-###-#---#---##-###---#--------#-----#------#--####-###------#---------#--------#----#-#---
--#--#-----###---##----#--##-#-###---#-##---#---------#-###-#--##-#-#-----##--#-#-----------#-------
-####---#--#----##--#--#------#-##---#--##---#--##-----#-------#######--###-#-----#----#---#-#------
--#-#----##--#------#---#-##--##---#----#----##-###-#-#-#--------#-#--#-#----##--#-------#--###---##
#------#--#--#----##----#####-###-##---#--------##--##--##--##--------#----###-#--##------#--##--#-#
##-##--#----##-------#----------#--#---#-#---#--##-------#-------#-----#####---#-#---#-#------#--#-#
----##-##-----###-##----#---#--#-#------##----#--##----------#-#-#-#----#-------------#-#--#-#--#-#-
----#----------#-#-#----#---#--#-------##------#--------##--#-------------#-#-#------#----#--------#
----#----#--##-#-#-#---#----#-#--###---#--##-#---------##---#--#-------#-#-#-####--###-#--#--#-#---#
#-#--#--#--#---#--#-##--#--####--#--#---#---##--#---##-#-#---------#----#------#--#---#--#----#--#--
-#-#--#-###-----#--#-##-------------#--#--#------##--##--##---------#--##-------##-#--#---#-#-#--#-#
--------#-#--------------#-------#-#-----#---#-#------#--#---#---##---------#---#----#--#---#---#---
---#------#-##-##--#--#--#---###--#--------#-#--#----##----##------#-----##----#-##--#---#-#----###-
----#--#--------#-#-##--####--#----#---#-#-#------#-#----##-##---##--#---##-------#--#-#-#-------#--
-##-#----#-#---#---#--###----#-##-#-#-#-----#--#-##--##--#----#--------#-#----##-----------------#--
---#----###-#--#-#-----####---#------#-----#-#-#--#-------------###--#-#---###-----#--#-#-------#---
#--#----------#--#---#--#--#--##-----##----------###-----#--#-##--##---#--#---##-#--#-#-#-----##---#
--------##--#-----#----#--------#----#---##-#-#-#-##----#---#--#-----#---##----#---------##--#------
--#-###-#---#-#------#----#---#-#---#-#--##---#------------#-##-#---##---#----##--###----##------#--
---#---#-----#--#---#-#----#---#-#---#----##--#--#-##---#------#--#-#----##-###--#----#-#---#----##-
--------#-#---#--#------#---#-#-------##-##-#--#----#---#----#-------#------##-#--#----##----#----#-
------##-#####--#---##--#---#-##-------##-#------#-#-#-#---#---#--#-#--#-##--#------####-#----#-#---
-#-#--------#--#-#---#---#------#----#----##-#----------#---#-------#----#-----------##--#-#----#---
----#-#---#-#-----#---#-##---######-#-##-#-#---#--##-##-#--###--##-##-#----###--#---#-##-##-----#---
-##--##--#--#--#------##--#-#--#--#--------#-#----##---#---#-#--##-##---##--#--#--#-#-##--##--#---#-
#------------##--#--#----#----------##-#----------#-----#-##-#----#------------##--#-#-#####-####---
----###---#-#--##--#-##-------##-#----#--------------------------#--##---##----------#-#------------
-----#----#---#-#-#---#-#---###-#---#--#---##----#---#-----------------#--#-------#-##----##----#--#
#---#----------#----#------#-----#----##--#----##------------#------------##-#-#-------------------#
---#-#----#---#-#---#--#-#--##-#--#---------###--#-#------#--#---##----#------##-----#--#--------#--
##-##---#-#--#---#----#-#-----------#-#--#--#---#----------#----#-#-#---##-#-#--#--#------#--#-#---#
#-##------#---------####----------#-#-----#--#--#--------#--##--#--#---#-------#---#-#--------#-#--#
--##---#-----#---#-------#-#-#-#-#----##------##--#-#-#---#----------#-#--##-#-----###---##----##--#
-###-------#--#---#--####-#-#------#---###-#--#---------#---#----------#-#-#-----#--#--#----#-#-----
---#---###------#----------#-------------##----#--#-#---#--------#--##-#----#------#-##---#---#-----
---##-------------------##--#-----#-------------#-#-####---#---##-#--##---#-#--#----##--#------#--#-
#--##------##-##-------#-----#-#--------#----------##----#--##----#-##-#---##--#------#-#------#----
--#-#----##---------##--##---------##-#--#---##-#----#---#-#--#---#-##--##-------###-##---------#---
--##---#---##-#---##--#-##-#-----#--#-#----##--------##------#-#---#--##-------#--#--#-#-#---#-##-#-
###--#-#-##---#-------##--#---#-----#-##---#--#--#--------------------#-------#--#-####---##--##---#
-#----##-###--#--------#---#--##-#--##-##-#-#--##----#-#-#---#-----###-----##---#--#-#-#-#-#--###---
--#---#--------#--#-------------#------#--##----###---#----##----#--#---#-#----#-##-----#--#-##--#--
-#-#--------###--##------##--#------##--#--#-------------##------#-#------------------#-#---#--#---#
--------#-----##---#----#--#---#-#-##---------##--#-#-----#-##---#-----#--###----##-#-#-##---###----
----------###--------------#--##-#-##--#-#----------#---##--###---------------#---##---#---#-##-----
-#---#------##-##--#------##--##--###--#-#--#--#--#--#-#------#-----#-#--#S-#------#----##---##-###-
----#-----#------#---#####---####--#---#--#---##-##-#---#--#---#-##-##-##---#-#-##----------------#-
---##----#-###---------#E##----##-#---#---#--#-#--##-----##-##---#--#-#--####---#-##------#------##-
#--#------------##--####------#--#-#-------#-#---------##--#-#--###-----#---------#-##--#-##---#-#--
------#-#---#--------##------#-----#-------##---#----#-----#-#---#-#--####---####------#-#--##------
-------#--##-##--#-##-#-#-----#--#------------#--#------##--#-----#--#-##---#-#--#----#--#-#--#--##-
----#----##---##---------#----#-#--#-----##--#-#----##-----#-#--#------#-#----##---#------#-##----##
#----#----------#----##--##-#-#-#-------##------##----##-#-----#-------#----##--#--###--------##----
##-----#-----##--####----#--#--#-----------#-#-#-#-----###-------##-#-#---#--#--#-----#-#---#-----#-
--#--------##-----#-------#----#####------#--##---####-----##--------#--##--------#-#----#-#-----#-#
-#--###--#-#--##--#---#-#-#-#---##-#--#-#---###--##-----#--##----#-#--#--###---#---##----------##--#
-#-##---#-#---------#--#---------#-#-#-#--------------#-#-#----#####--#--#-#------##----###-#----#-#
#-------#----#-#--#--##---#-#----##---#--#--#-#---##--#-##-#-#--#--#-------#-------#-#-##-#####-####
------###-#-#--#-------#----#--#-#-##--#---#--#-----#--#--##------------#-------##-----###-#-----#--
---#---###---#-----#----#-------##--#---#--##---#--------#---#-#-#-#---#--#--------#-------###-#-#--
-#-####-###-#-#---##--#---#------#--##--##---##--##-#----####----#---#-----#----#-----#-#------#-#--
-----##----###---#-##----#-#---#-##---#----#------------#-#-##--#---#--------##-#-#----##-###-##---#
---##----###----#------#--#-#-#-#-#----#---#---#----#-----#--#-#---#-------------#-#------#------#-#
---#-----#-----#-#--------------#---#-#-##--------#----##-##----#-####------###-------#-##-#-#--##--
-#-##-#--#--##--------#---##----##-##---#-----#----------#-##-#--------#-##--##-----#-#-------#-#---
#----##----#-------#----#--##----##--#---#--##-----#-#------#-###-#-----#-#-#----------###---#------
-----#----#-#-#------##--#-#--#--#----#-##-#----#---#--#--------#--------#-------#--#---#--#-----##-
