--#---------#--###------###-----###-#---##-----##---#------###-#---#------##-----##-#-#----#-##--#--
---###-#-#--#--###----##----#--#----#---------##-#--#--##-#--------#-#---#----------#------##-------
-----#------#-#-##----##-###--------##-----#-##--------#-#------#---#-#----###-----###--#--#--------
-#---#--##-#---------#--#-###-#-##----#-#-#--------#----#-#--###-#---##-#-#---##------#-#-----------
##------##---#-#--##----------#--#-----#----##---#---#-###---#--#-----#-----##-#####-##--####--#-#--
--#-------##-#--###--#----###-----#-#---#-#-----#-#-#--#---####-#--##----#-------------#---#####--#-
#-###-#----##--##-#-##--#---##---#--#--#-##--###----#---#---------#----#--####-##-----#------------#
-#---#----###------#--#------###-##-----#--------###-#-#-##-----#--#------###--#--##----#-##-##--#--
#-#--##--------##-----#-#--##----#----#--------#---#--#-----##----##----#--#-----#-##-#---#-#--#----
-----------#--------###--#------------#--#-----#-#-------#--#--###---------##--###-#------#-----#-#-
--###--####-#-------------#----#------#-#-#--#---##--##----##---#-#--#--#---#-#---##-###-#---#------
#-#-#--#----#-----------#--#--###-#----------#-----###-#-----####--#-#-#--#---#--#----#-----------#-
-#-#-##-##--##------#--#-----#-##----##--#---#---#-#--#---#--#---#-#-###-#-----#-##-#--###-#--#----#
-#-#-##---#--#---#--#---#-#---#---#---##--#--####--#-----#----##-#-#-#----#-#---#-#--#-#----------#-
#--#----#-#---#--#-#-#-##--#-----------##-----#-#-------#-------##---------#-----#-#----#---#--###--
----------#--#-----#---###---#-#-#--###-###----##--------------#-#--#-----#-###-###---##-#--##-####-
-#----####------#--#-#-------#-#----------#---##-##--------#--##---#-#-#----#-----#-#-#----------##-
##---#--#------#---#--#-#------------##----#-##--#----#-##--###--##--##----#--#-----##---#--#-###-##
#----###--##---##-#-#-##---#------------#-----#-####-#----#-#--#-----##-#-#----#---#-####------#---#
--#------#-#----##----#-----#-#-#--------#-#--##---##--------#-----##------#--------#--#-##-##---#--
-------#-#--#------#----------#--##-----####--#-----##---##---###---#---#--------#--#----#---#------
-#---#----###-#---##-#--##--------##----#--#-#-##--##--#---------#--#---#-----------------##-----#--
##-----#--#--#-----#------#---#------#---#--#---#--#------##--#-------#---#-------#------------###--
###---#----#------##E--##----#-##--#-#--##-#----#--------#---##----#--##--#-#----#--------------#--#
#----#--##---##-------#--------#--#--#---#--#-----#---#--##-##--#--#-----##-#-----#-#--#-#--#-#--##-
----###-##-#---#----#-#-----------------##---------###-#---##--##---#---#----#--#----#-#------#---##
-#-----#-----#-#-#--#----#----#-#--#---##-----------------#---##-#-#-#-#-#-##-----#---##---------#--
-#---#--##-#-#------#---#-#-#---#----#-#-#-----#---#----#---#--##---#----#---####-----##-#---#-##---
#-#-#---#-------------##-#--##---#-##-------#--#------------------#-----#--#--------##----#----#-#--
#---#-------#---##----#---##-#--#--##---#-----##----#---#---#--##---#-#-#----#----#-##-###-##-#-----
#--#------###---#-#-#-----##----------##-----##--#------------##---#--##---#-#----#--------#-------#
##-----#-#----#------##--#-------#-----#---#------------###----------##--------##---##--#---##-#--#-
--------##--##-#----##-#-------#-#-#-------#------#-#------#----####------##----##--###-###--------#
--#-#-##------##-#--#---#---#---##--##--#-------#-#-##-##-##-----#--#--#-#------#--#---##-#--##-#---
---------#-#------##----##------#-----##--##-----###-----##-##----####--#-##---#---#----#-------#--#
-#---##----#-#-####-#-#-------#--#--#----#--###--------#--#--#-------#---#-#--------##-#-#--#----#--
-##------#-#--#------------#-#----#---#-----#------#---#-#-----#------##----####-##----#-#---#####--
-#-##-##-##-#-#--#-#------#---#--####-#----#----###----##--####----#---##------##--#--#-#----##----#
---#---#-#--------#--#------####--------------#-#---------#---#--#-#--###--##---#----#-####----#-#-#
#--#-###-###--#-#----#-------#--###-#-----#---------#--#----#-#--####--------#-#---#---##-#--#--#--#
-##-#-----#---##--###-##--###-#-----#---##-------#--#--##--##-----#-##--------------##-#---#--------
##----#-#---#--------#####--#----#---#####------------###-#-#-####--#---#-----------#---#--#-----#-#
---#--#-----------#---------#--------#--------##---#######----###-#---#-#--###--------------#----#--
---------#-###-#-###-##-#--#--#--#---##--#-#-------###-###--##-------#-#-##----------###-------#----
----#--------#--#-#-#--#----#--##--##---#---###-----#-----#---------#-----#----#--#-##-##----#------
#-#------##---#---#----##----##--#-#---------#---#-#----#-------#----#--------#--#---#-#--#--#------
---###-------#----##---#------#--#--#-##------##-----#---#---#--##------##-------#-------#----#-##--
##-----##--------#----#-----#---#-----#------#-#------#-#-#-#-#-------#-------------#---#--##---#---
---#--------#--#---##-----##--#-#--#--------#--##---------##-------#-#---#----------###-##-##--#----
---#---##-#-#-#--#-------------####--------#--#-#--###-#---#-#-----#--##----#-------#-#-------#-#--#
-#------#---#-#---##----#---#--#-###----#--##-----##-----#-#--#-###--#-#-----------#------##-#-#----
##-#---#-#--##-------------#-##-###---###---#--#-#-#-----###-----####-----#---#-#-##-#-----#-##--#--
-------##--#--##----###-----###-#-##-#--###-#####-#----##-##-#------#--------#----#---#-#--##--#--#-
#--#---#-------##-#---------------#--#--#----#------#-#-----###-----#-----#-###-#--#------#---------
#--#--###--#-#-##----#---#-----#----##--#-#----##-####-#-##---##-------#----#-#-##--#--------##-----
#-----------####---###-##--#-#---#---###-----###-#####-#------#----#--#---#----##-#--#-#-----#---##-
--#---##-----###-#---#-###------#---#--#-----#--#-#----#-----#-#--##--------#--#-----#----###--#--#-
##-##--#-#--#--#-#----##---#####------------#------#-----##--#-#----#--##-#----###---#-------#---#--
---#-#-----#---#------##--#------###--------#-----------##-----#-----#-##----#---#----------------#-
-###--#-#---#----##----------#--#-#-#-----#-------#--##-#--#-##--##---##-#---#---------#----#-#-#---
----###-#----#-#---#-#-##--###--#-###-----#-##--#----##-----#-#--##--##----##------###--------------
##---#---#----#--#-#---##-##--#-------#--#----##-----#-#---##--#--#-#-#-#---##---#-#-#---#-#-#--##-#
-##-#----#---------##-------#--##--#-#----##-#---#---#----##--------#----------#-----#-#--#---#---#-
--#---#-----#---#-###-#------#-#-#-###-#------#---#----#--###--#-#-#-#-##-###----#------------#---#-
--#--------#-#------####-#----#--#-----------##-#----##--##--#------##---##-#----#---#--#------#-#--
#-#--###--##---#-#----#---#-#----#-#----#----#####--#---###----#--#-#-------#---#---#-##-------#--#-
--#-----------#---------#-#-------##--#-----#-#-#----#----#--#----#--#-----#------#--###--##-#--##--
--#---#---#-#--#--------#----#--#---------#-#---##-##-#-------#---#--#---#-#-------------------#-#--
####-#-----#####-##---#---##-----#--#-------#---#----#-#-------#--#--#-----#------#-#---#######-----
###----#-#-##--###----#---------##----#-#---#-#-#-----##---#---##--#--#-#-----#--------------#---#-#
###S#-#-#-#----------#-#-#-#------#---#------#-#-####--#---#-#----#---#----#-#--#-#-###-#----------#
---#-#-#---------#---#-----###---##--#-###-#--#---#-#--##-#-##---###-#-#--##--###--##---#----#####--
#-#-----#----#-----##--#-#--##-----#--#-####-#-##---#---#------#--##-##-----#-#####---##-#--##-----#
----#--#-----#-------###---#----###-#--#-#------#-------#--#--------#-----##------#--#-----##----#--
#-##-----#-----#----------#-#-#----#------#---##--#----##-#-------#----#-#--#--#---##--##-------#-#-
-----##----#-#-#-------#--##---#---#-#-#-######---#-#---#--#----#-#-------------------#---##--#-----
##---#---------#----------------------#--#----######-#----##--####----###----###--#-##--#-#---#-#-#-
---------#---------#----------#--#--##---#-#--###---####--#-#-#--#-----#---#-#-##-#----###----#-----
--##-##-##--#-#---#--#--#--#-----#--#----##-#-------#-##----------#------#---#-----#-#-----#-##---#-
-#----#-#----#-##--#----#-#-----#-#-------#-#-------#-#-##-------##-----##---#-#---#--##-#--##---#--
#--#--#-----###------#-##-----#-----#---###-----#-----#--#--##--#--#---#--#-----##--#-----#-##-----#
##-#-###-----#---#-#------#--##-#--------#------#---#--#-----#-#--#-----#-#----##------#---####----#
------#---#--#--###-----#---#-###--#----------------##-#-##-----#--#-----##--##------#---#-#--------
---##--#---------#---------------#--##--#-#--#-##-###------#----##-----#-###---#-###-#--#-#-##---#--
--#-##--#------##--#--------##---#----------#--#----#---#-#--#-##--#-#---#--------#----#--#-#-#-----
---#----#----##---#---#-----#---#--#------------#-#-#---#--#-###---#---#---#--##-------------#-#--#-
#-#---#--#----#--#------#-##-----####--#-----##--#--------#--#-#-#---#-#-#---------####------####---
--#---#------#--------------#------##---------#---###----------##-##---#------#--#-#--#-#--##-----#-
#-##-----#------------#-#---#--##-#-------------#---##-##--##-#-#---##-##--##-#-##-###----#----#-##-
#-##----#-----#---#---#--#-#---#-##-##--#------#-#--##---#--#--------#---###-#--##----------#--#--#-
-###-----#---#---#-----#-##--##--#-----#-----##--#---#----------#---#--#--#--####---##-------#-#-#-#
#--#---#--------#-#---#---#-----#---#----#----#--#-#---##-#-##---#---------#-#-#-#----##-##------#-#
-##-#--#-#-#------##----#---#----#-------#---##-----#---#--#----#--#------####------#---#----#------
##---#----#---------#-##-#-----#-----#-----#----###-#----#--#-#--##-#-#-----#-###-##-####-#-----#---
---#-###-#--#---#---------#-#--#--#------#--#---#-#-#-#--###----##--##-#-###--#-------#----#------##
---------#--#------#-----#-###-#-##-#----###--#---#----------#--###---##----#-##---#-#-#--#--#-##-#-
-#-------#-----#-#---------##--#--##-------##-#-#---#-#---#---#---------#---------##----#--------#--
--#---#-##-#---#---#-#-#--#-------##---#-----##--##-#----#-#----#--##---###--#--------###----#---#-#
---##---#---#-#-----#-#---#------###------#-----##----------#-##----#---#-###---#---#----#----#-#--#
----#---#-----#--#---#-##---#-#----###--#-#-----#-#-#----##-#-------#-#----#-#-#--#---#--####--#-#-#
