-#---######--#-#----#--###-----#--#------#-#--#----#S##-#---------###-###-#--#-#-#------##---###----
#-##---------#--#-#-#-#-----#--##--###--#-###--##-#--#--#-#---#-#----#--------#---#-#-###-#---------
---#---#-#---#------#-#--#--#------##---#-#-#---------###-------#-----#--#----#-#-##------#----#---#
-#-----##------##-----###-#--###--#---------#-#----#-#----------#-----#--##-#-----###-----#---#-----
---#-#----#------##-------#-#-----#--------------#---#--#-###-##-#---------##-#--#-#-----###--------
---------##---##--#-#-#----#-##-#-#--#--#-#-------#--#-#-#--#---##---#-----#-#--#------##------#----
----#---#-#-#-#------------#--###--##--#-#--##--#-#---------#--#--###--#-------#-##---#-#---#---#--#
#-#----#---#-#--##---###-##---#-----##-#--#-##-##-#--#####-------#--#------##-###---#-##---#-------#
-------#-#--#-#---#-#-----#------#-##------------------#---#----#-----#---####--#------###--#-----##
-#-#-#--#---------#-###-----####--#--#---##--#--#--##-#------###----#------#-##----#-#-#-#--##----#-
-#--##-#--#------#--#-#-------##---------#---##--#--#--#----#----##----------###--###--##-------##--
-#-#----##-#--##---##----#---###-#-----#----##-#-----##---#-####------##---#---#------##-#-#---##-#-
--#----#--------##-##-#-#-----#----#-#--#-#---------#-#-#--##--#-#--------------#----#--#----#-#--##
--#--#-#---#--#-#--#-------#-------#---##-#----#----#--#----#--#---#-#---#--#------#-----#-#--#--#--
-##--#----#--------#---##---#---#--##--#--#---#----#-#-#----##---#--#-##----#--#-----#--#-##---#--#-
-----##-#---#-#-#---------#----##--#--#--#----#----#-##------#-#----##--#-------------##-------#--#-
#---#---#--#---#-#----#----###---#--#---#-#-#------#-#------#----#--#---#--##------#--#-#--#--------
#---#-#--#-------------#------#--##--#--##--#-#-##-#------------#-##---#-###---#-##-###-##-#----###-
---#-######-#---#---#--###--#--###-#-#--#-##-------###-----##-##-----##-#----###--#-----#-#--#--#-##
----------##--#--#---#-##-----#--#----#-#-####---#-#-----#-----##---###--#-##------#--#-------#-#---
-----#----##-###---#------------#-----#-#---#-#--##--#-----#--#---#--##----#-#-----#-###----##---#--
#-----##----#-#---#--#-#-#--#--------#-####-##---##----#--#----##---------#-##--#--#--####----#-##-#
------###--##-#-#-#---------##-#---####-----#------#--------###----#--#----#----#-#-----##--------##
--#---#-#---##-#----#--#-#-##--#----#-#-#---#----------#--##-----#---#---------###--------#---------
---------##------#--#---#-####----##---#---#--#-###--------#------#-#------##-------####-----#------
-##-----#-#----#---#--#--#----#--------###----#-#-----#---#----------#-----#-#---#----#-##-###-##--#
#----#----#-#-----#--##-#----#--#---------##--####---##-##-#--#--#----#--##-----#-#----------#---#--
--#---#---#-##-##--#####-#--##-----#--#-##--##---##---#-#-----------------##--#-#---##--#---#-#-#-##
#-#--#--##--###-###----#-#--#----#---#------#--#---------###--#-##-##-#-#--#-------##-#--#-###------
--#------#-#-------##-----#####-#------#---#-#--#----------#----#--#--#-#-###--##-###----#----------
--#---#---##-#---#-#-------#-------#---###------#---####-----##--#--#--#-#----#####--###-##---------
---##-#-##---#-----#-#--#---#---------#----#-----#---#------##---#-#-#--#---##--#-----#------#------
--#----#-##--#-#--###--------####---#-#-#----#---##--#-#-#-##------#--#--------##-##---#-#--------#-
-###--#--#--------#-----#-#--#--#--#-#-#-#--##--------#----#-----#-#-#---#---#-------##-###---##--#-
--#----#-----######-#--#--------##-----------##----#----#----#-----#-----#-------#-------------##---
----#--#----##-#------#---###---#-#---##-#-#----###-##------###-#--------#----#-#--###-#----#--#---#
---#-#------------#---------#-#---------#-#---------------------##--#--#-#-#------##-------#--#---##
-##---#--##------#--#--##--##----###---##---#-#-####-----###-----##-----#-#-#-#---#--#--#-##--##---#
--#--#---#-##-#----#-#-#-#---#--#-----#--##---#--##--------------#---#---##-#---#--------#-#--------
-##-#-#-#-##----#--#------#----#---#--#--#--#--###------###---#--#--#--###--#----#---#--#--#------#-
#---------#--#---###--##--#--------------###---#------#--------#-#---#-#-####---#--##-------------#-
##------#-##--#-----###--#-##--#--##-#----#-###---#----##----#---##-##--#--#--##--##--#-##--#-#---#-
-------#--#-------#-##-#----##--#---#----##---#---#---------#-#----#--#--#-#--#---------#-----------
#-#-----#--------#--#-#-#----#---##------#--##-#------#------#---##---###-------#-#-----#----------#
-#---#-----#-#-#-#-##---#---#---#--#-------#--##--#---#-#--##---------###-------#----#####----#-#--#
-#-#E----#-#----#--#------##-#---#--#--#--#-#----#--##---------#-----#-###-##--#--##-##------------#
-#---###-------##--#----#-#--#----##-#--#---###--##---------#-----------#--#-----#--#--##---####---#
--#-######--#--##--#--#--##--#-###---#-##--------#----#--###-#-##--------#---#---#-#--##--##-#---#--
--#------------#---#--##--#-#--------#-#----------#-##--------#-#---##-##-#-##-------#-#----##---##-
##--#---#-#-#-----#-#------###---##----#---#---------#----#---------#-#--#---#---#-------#---##-#--#
-#-#--#---##---#--#----#####-###------#-#-#--#--#-##-----##-----#---#--#-#-##-##---#---##-----#---#-
--##-#-#---------------#---#--------##-##-#--##--##--------##--#-#-#-###--###-#-----##---#-#-----#--
-----------#---#-----###------#-#-########-##-#--#-#--#-----#--###-----##-----##-----##---------##--
##--##--#-#-#--##-#-------##-#-------#--#---##----#-#-----##-#----##---##-###------#--#----#----##--
---#-#--------#----#-##--#--#-#------##-##-#-------#--#-#----##----#--#----------------#------------
----#----#-#---#---------#--####-#-----#-----#--#---#--####-#------#-#-#-------#-##-##--#--#----##--
##---#-#--##-#-#---#-----#-#-#--#--#--#-#-#-##------##-----#---#---#-#-#--#--##-#----#----#---#-#-#-
-----#-----#-------#-#-#-#-#--------#----#---#-#--#-#--###-#---#--#---------#----##--#----#-------#-
-----#--#--------#-#--#----#---##-----#--#----#--#-#---------#------#---#----##-##-#-#---#--#--#####
##-##--#---######--#---------#---#--#--#--#------##------##--#----------##-#-#-#---#---#----#-----#-
#---###--#---##--###----------------#----#-#--#--#---#-###---##-#--#-----#-#---#-###--#---#---##----
---#------#-#-----###--#--#-----#--####-##-----#---#----------##-----##-#-###--#----##----#--###----
#-#----###----#--##-----#--------#-#-#--#--#-#-----#-##---##---#-###------------##-####-------------
-#-#-#------#-#--#--#-----#--#------##-------#-#-##-#-#-------##---#---#---------##--#-------#---###
---------##---#-------#----#--#--##--##--#---#--#-#----#--#------#---#----------#--#-----##-#-#-####
----#--#-##---##--#------#-#---##-#-##-#---#-#####-##-------##----#------####------#---#--#---#-#-#-
-#-------#--#-#-#-----#----###--#-------------##--###--------#--####---###--###-#-#--#-#----#---#---
----#---##---#-#-#---#--##------#---------#-#------##---#--#-------#--##--#-#-#--#--#-#--#-#--------
--##-##--###--#----####----------------#------#--#----#------####--#-##---#------#---##-#---####-#--
----#----------#--#---##--#--##--##-#--#-------#-###-#--#----#--#-##-##-----#--#----------------#--#
--------#-------##--###--##-##-------#--##--#-#--------------#--#------#-----#-##---#--#-#-----#----
-######-----#----#-------------##---------#---#-#-#------##--------##-------#--#-------#-#---###-#--
------##--#----#----#--#----##--##-#----#-#-##--#---------#-#-#--#-###-##----#-------------##--#-#--
-----#--####---##--##----#-#-------###--###--##-----#--#-##--#----##-#---#-------#----#-----##--#---
-##---##-----#---##--#-##-###--##-###--#----#----##---##---#----#------#-#-#--##--#-------------#--#
--#---#--#--#--##----#---##-#-#--#--###-------#-#--#--#-#-------#-##----#--#----#---#------##-#-#-#-
--#-##------###---#--------#-----#--#----#-#-------#-----------##----####-----#-#--------#-----##---
----#---####-##---------#---#-#--------##-#--#-----#---------#---##-#-#----##-#--------##--#--#-----
#---##----#-----####----#-#---#----#-#-#-#--------#-#------------#---###-----#-----#---##---##------
#--#-----#------#--##-------#-####--###---------#--#-#-#------------#-###-#####-----##-----###-----#
#---------#---------#-#-#---#--------#------------------#--#---#--#------------#---#-#-###---#-#----
---#---#--#----#-------#--------#-#--####-##--------###---##--####----------#------#---##------#-#-#
----#-------#####-#---##-#---#---##--#------##------#---###-------------#--#-#-#--#----#---#----###-
-#--##----#--####-#--#--#--#--#----#-----#-##---##--#----#---#-#--#---#-###-##-#--#--------------#-#
-#---#--#--##--------##------#-#-----#-#---#----#-----#---#--##-#----#---------------#-##---------#-
--#-----#--#----#-#-##-##---#-----#-#-----###-####-##---#-----#--#----##--#--#--##--------##-#------
----#---#---#-#----#-------#-#----#---#-#-#-#----#-##--##--------#-#---#----###-#-#--------#-----#-#
-#---------##--###-#-#----###------#--####----#-##--#----##-###-#--##-####-----#-#--#---------------
-----#----#-#-#---#--#----##------#-#---#--#----#--###--#--#-#-#-----#---#-----##-------##-----##--#
---------#--------#---##----#----##-##-------#--#--##-##--#-#-------##--#----##--#-##-------#-----#-
-###-##-#------##---#-#--##-#-#-#------#--#####--#-#-#-#-#------------##--#----#---#---##---##------
----------##--#----####---#------#--###---#---#-#---###--#---#-#-----#-#---#--###-#--------##------#
--##-#-##-------#-#-------###---------#-#--##-------#-----#------##----##-----#----#-------#-----##-
-#---###-#------#--##-##-#---#--------#--#-------#---#--------#-----####-#-#--#--##-------------#---
-#---------##-#--------#--#---------##-#-#----#------####--#--##--##-#----#-#---#---##-#----##------
--#--#-#------#--#---##---#-----#----------#---##---#--#------##-------###-----#--##---#------##----
------##----##-#--------#--#-##-#-------#--##---------##-#-#-----#-----------------------#--#----#--
#-#-----#--#------####-####--###-##-----#--####----#----##--#-------#-#-----#---#-----#--##--#---###
---##---##-#-#--------##---#-#--###--#----#---#-#--##--#-----#----#----#-----##--##-##-#---#--#-#---
----#----##-##-#--##-#---#----------#-#---#---#-##---#--#---------------#-##-------#-------#--#--##-
