-#-##------#-------#--#---##---#--#-#--#-####----#-#------##-#-#-------#-##--------#--#-----#----#--
-----###------#-#-#----#-##--#--#--#--#---------#-#-#-------##------#---#-#-####--#-#--###--#--#----
-#--##--##--#------#---###--#-------------#----#----###-#-#--#----------#----#----#-------###---#---
-#---#----#----#-#-----#---#--------#--#--#-#-#------##-#--#--#-##-------##--------#--#-##----####-#
--#-----##-####-##------#-------#-----------#-##-----###---##------#-#-#----###--#----###-##-#-##--#
----####--#----#--#---#----##-#-#-#--#------#----#--###-#-----##----###-#-#-------##-#-##-###-#--#--
----#---#-#---##-------#-#----#----###-#---#---###-#--#-#-----#-#-##--------#--#-----#----#-------#-
#-###------#----#----##-------##-#-----###-#--#--#--------######-----#------#-#-##----##---###---#--
-----##----##--#----------#-##---#----#--#----###-###--#----#--#--#-##---##--#----#-####-#-#------#-
--#----#------------#--#-###--#--##----#--##---##-----#-------#----#-----##-----##---##----------###
--#--------------###---##-##-#-#--#-#----#-#-#-#--#-----#-#--#--#------#----#---##---#---------##--#
-#---#-----#-------#--#-------#----#-#---#----#---#--#---####---#-------#--#-----##-#------###------
#--#-#------#-##--#-#-#-#####----#-##--#-#--#-##---#-#-#-#--#-###--#-#----#---#---------#---------#-
-##-----#-#####---##--#-#-----##-#--------###-----##-------#-###-####--#----#--#####-#--#-#----##-#-
#-#-#-#-#---#-#--#--------------##---#-----#----##-##-------#-----#-#--#--#-#--#----#-##---#-#--#--#
----#-#-##------#-##-#-#--#--#--#-#-#--#-#-#--##----#------##-##-------####-#--###-##--###-#--------
##--##----------#-#-#--##-------#-------#-#-#-#--#-#--##----#---#----##--#---#-------#----#----#-#--
###--#-#-#-#--#-#-#-------#-#----##-#-----------#--------------##-###-##-#--####-----------#-##-----
----------#####------#-##----#-----#---##-#-#-------#----#---##----#--#--#---##-##-###---#----------
#--#---#--#----------#-----#------####-----------#---#-#-#--#---------##--##------#-#-#------#----##
#-#-####-#-#-#-----#-#--#-------#---#-#---###---#-##---#---#-----#-##--#----###----#--#--#---#--##--
-#------##--------#-#----#---#--###---#----#-----#-#--#--#-------#-##--#-#-----#-#-#--##-------#----
##--#-#-------#---#--#--#-------E#----------#-#--#--#-------#-------#--#----#----#-#--#-------#--##-
#-#------###-#--#-------#--#-##-----##--#---#-#----#---#------------#-------------#-#---#--------##-
#-----###----#-#--#-##----#-##-#----#------#----#--##-#---#-#-#-###---##--##-###---#--#--------#----
--#-#---#---#-#---#--##---#--#-#---##-#-#-----##---##--#---#---#--#-------#--#------#---#--#-##-----
---##-----#-------#--##---##-##---#-----------#--#----#-##--#####--#----#--#####-##-#-#-#-##----##--
-----#---#----#-#----#-#-#---#-#-#----------------#-#----#-##-#-#--#------#--#--#-#--#----#---##--#-
-##-###---------#---##----#----##----#-#-#---------##-#----#----#---#---#---#----##-------##--#---##
#---#---##--#--#---#----#-#-#-----#----------#--#--#-#####-###--#--------#-----#-----#--#---##------
--##-##-###--#-------#---#--#----------##-------------#--#----#-----#-#----#-###-#---##-####-#---###
#-#-#-#----------#-##--##-#-----##---####-------#---#--##---------#-------##--#----##--------##-#---
----#-#---#-#-----#--#---#---##-----#---##-------#-#-#-##----#---#-#---#-----#-###--#----##-#-------
--###---#--#--##-----#--#---------##---------###---#----##--#--------#--------####-#--##--#---###--#
--------###------#-----###---#--#-##-#---------#------#-#--###---#---------#----##-----#-#--#------#
##--#-------#------##--#-#---#---#-###--#---##--##--------#----#--#--###----#--#------#----#--------
-----#-##-------#------###--##-##-----###--#---#-#-#----#-##--#--#-##---##-#--#---#-----##----#-##--
----#--#-##---------#------#----#------##--##--#------#---###----#--###---#-#-------##-----#-##-----
--##--#-###########----###---------#-------------#-----##-##---#-#-------------#-#--##--#--------###
##-------#-----##-##--#-#----------#--------##--##-#-#-#------#--#---#------#-------------#-#--#-##-
##-##-###----#---------##--##--#----------#-###-#---#----###-#--##-#-----###-#----#-#--#--#-#---#---
##----##----#----#---#-###-#------##------#--###-#---####---#-###----##-##-#--#---##----------#--###
---#--#---#---#-###--------###-#---------#-#--#---#------####----##--------#---#--#--##-###-#-------
-#---#--#----#####-----#---#----#----#------------#---#S#--#-------#----------#-#---#---##-##---##--
--#-###-#-------#-#-##------##--#----#-###--##-----#------###---#--#--##---#-#-##---#--#---#------##
----#-#--#-#-----#-##-#--------#-##-#-#----#-#--------##--#---#--#-------#--#------##--#-###----#--#
------##--------#-#------#-----#--------#-------#------##--#-------#-----#-----#-####----#--#-----#-
--#-#-##----#--------##------#-#-#--#-#-------#-#----#----####------------#-#-###---#--####--------#
---#-#-#---#---#-##-#--#--#---#---###-#------#--##--##-####-##-###--#-#-#---###-----------#-----#---
##----###---#-#--#----#-#--#---------------#-##-##--#-##--#--------##----------#-##------##--#-#----
---#-#-------##---------#--#--#--####----#--#------#--#-#-#--#-#-##----#-#-##--####-------#-##-#-#--
--#-#-------#---#------##-------#------------#-------------#-##-----#--#-#-----#---#-----#--#----#--
#-##-#---------#----#--#--------#-##-----###---#---##---##--#-#--#--#--###------#-##-----#-#-###----
#------#-#---#--#-----#-#---##-#----##------------#--#--#------#---#--###------##-#-#--#-----#-#--##
##----##--#----#------#-#--#---#-##--#----#--##-#--#-#-##-----#----#------#-#---#-#-----#--------#--
------#-###-#-##----#----##---#------##---#---##-----------#------#-----#-#----#------#--#------#---
#----#--#---#--##--#---##-#-----###----#--###-#-#-------#-#---##------#----#-----##----------#-#--##
------##----------###--#-----##----#-##-----#-------##-----------#--#-#-#-----------------#-----##-#
-----#--##--------#--------#-##--#----#-----##--##-#----#-##-#-#-----####---#-----###-##--##----#---
#-#-----#--####---#--##-------#-------#---#----#-----#----#-----##-------##------#--#-#--#---#-#----
------#-#-#-#-#--------#--#-----##----------#--#------------#--#---#---#---#-#---#--#---#-----#-#---
--##--#-#-----####-##----##-#----------#-####------------------#--#--#---##-#-#----#-----------##---
#-----##--#---##---#-#---------###---##-#---------##-###--------#-----#-------#----#-##-#-##--##---#
--#-##-#---##--#-###-----#-----#----#--#--#-#---#-#---##-#---#---#-##--#--##----#--------#-#-#-###--
#-#-####--#####------##-------#---#-#---##-##--#-----#-#-##-#-#----------------##-#---#-#-#----#---#
-##------------#----#----##-----#-#-----#--##------#----#-#--#-----------#-#---#-------#---#---#---#
#-####----###----##--------#----##--#-##-#-----#-----#--#-----##--###--##------##----#-----#--#-----
-----##-##------#-----##-#----#-#---#--------###--##---#--#-#--##------##--#-----##-----------##---#
---#----#-#----#-------#---##--##----#---#--#-#---#####--#-----#-----#-----------------#--------#--#
--#----##-------#--##-###---#--###-----#----##-#---#-#---##-#-#-#------##--#---#-#----#--#---#---##-
-----#-##----###---##-####-#-----------------#----#-#--------#---------#-#-#-#----#---#-#---------#-
--#--###------------#----#--###-------------##----------#----------#---#--#------#-##--#-#----##-##-
-##--###---#-#####--------#-----#-##--#-#-#-#-#-##-#--##--##-#--#-#---#---#--------##--#----####-##-
#---#--##-#-#----#-#-----###-----#-#--#-##-#-------#---#-#-#--#---##-#---#---#----##---#--##---#--##
------##-#----#-#-----#-#######--#------#--#-#--#-----#-##-------#--#--##-----#-###---#-------------
-##-###-----##-#--#-----#--##----------#-###-#--##--#---#-##---##---##-#-#---##------#--#-------#-#-
---##---#--#--------#----#----------#--#--##--##------#-----##---##--#-##--#---#---####-#-#-##--#--#
#--------#----##-#--#----##--#----#--##-----#----#-----#-------#---#-----#----#--#---#-#-#--------##
-##-------#--#-#-###----##--#------#---#----#--##--#---#---##--##--#---#-----##----#-#------#--#--#-
#--##---#----#---------------##--##-##---##------------------#-##-#-#--#----#----#---#----#--------#
-#----#--#---#-#-#-##-#####-##-----#-##--#-----##-#---#--#--##-##-----#-#------#--#----##---#--#----
#------##---#----#------------#--------##-----##-#------#----##-----##---##---#----#----##----#-----
###--#-#----##--#----#-#---#-##-###----#--#-#-#---#--#-#---------#--#--#-##-----#---------###--###--
-#-#--####--#------#------#-#--#-------####---##--#-------#-----##-#--#--##--#-#-#-#---#-#------###-
-##--##-##-##-----#--###---##--------###-----#---###-#-#-##----##----#--##-#-#---#-#-##-#---#-----#-
---##-----#-#-#--###-----#-#-----#--------####---##--#----#-##--##-#----#-------#----#-----#--#-###-
------#------------#--#----##---#--#------##-#----#----##-##---#---#-#--#--#-##---#--#--#--#------#-
#--#--------------#-####----##-------#-#----##----##-#---#-----------#----#-##-------#--##----------
#------#----------#--#---#----##--#----#####------##---#-#---#----#----#--------###---##--------#---
---###--#--------#----##---#------#-#-#-#-----#--------##--#-#--##----#------##---#--#-#----#-#-----
---##----#-----------#-------#--#-##-#--#--#-----------#-----#-#-------#-----##-##---#---#--#---#---
--------------#---#--#-----###-----##----##------##--#-##---#-----------#-#-#---##--#---##----------
#--#--##-##--#-#--##--#-----#------#-----#--#--#--#-----------#--#-####-#----#------#-##---##---##-#
------##-------##-###---#------#----#---##-#------###--#--#-###-----###-#-#--##-######-#-#-##-##-#--
-------#---#-------------#--#-#--##---##----#----#-----#------#------#--#-#-##---##--#-##-#---#---#-
---#--#----#-#-#---#-----#-#---#--#-#---#------#---#-----#--------#---#--#------##-----##--#--------
#--#######--###------#--#--#--##--#---#-------#---#---#--#--------##--##----##-##---##-------#---###
--#--------------#---#---#####--##-##--##--##--##-#---##--##---#-#-#-##--------------##-------#-##--
-#----##-#-------#-#-----#---#-----#----------##-#-----#--#--##------------##---#-##-#-#---##------#
-------#--#------------------#-#-##----#-##-#----###------#--####--##-#---#-#--##---------###---#---
