---------##--#---------#----#-##--###--#---#-#--#-------##---#--#--#--------#--####--#--------#-#---
#---##---#-------#--------#-###--#--#-----#-#----##--####-------#------------#-#---#-#-----#---#----
------------#---#--#---#--------#-###-#--#----#---##------#-##-#-----#-##--#-#------#-#---#--#----#-
-#--------##-#-#--##---#------##-####---##---#--#-----#--##-#-#---##----------#-###---#--#--###----#
---------#---#---#-#--#-#-##-#-----#-----#-#--#----#####-#---#----------#-#--------###---###--#-####
------####---#---------#----###-----#--##--#-#--#----#------##--#-#-#----##-------#--#---#------#-#-
----#-###-#-##---#-----#-----#-#-------####-#--------#--####---#---#---##-----##----#--#-##----##-##
-##---#-##--##---------##---#--#---#-----------#-#-#---------#-#---#---###--#---------------###---##
-#---###-#------#---#---------#---#-#--------#---##--##-#----#-----------##-##-#---#------------##--
---#---#----#---#--#--#--------------#-#-##------####-##----###---#-------#---#--#--------##---##---
---#--#-##-#--###-##----#-#-#---#####-###-------#-----#-##--#-##-#---#-##-#--#--##-#-#------------#-
--####---#---#-----#-#-#--#-#-##-#------#-#-#-----###-------------#-#-------#--#-#-------#-#-#-----#
-#-#---##-##-------#----#---#----##--#----#---##--#------#-#------###--#----##----##--#---#-#-----#-
---##---#---------#---#------#----#---##--------#-###--##----#--#-#--#--#-----------#---#-#-------#-
#----#----##-##--#--#--##-#---#####-------##---#---#-#--------##----#-#----#--------#--#--#-###-#---
----#-----#--#-----------##-###-##-####---------#---#-#-#---#--#--#--#--#---###-#-#-#----#---#-#---#
-#--##--#-------#---###---#-##---#-###--#------##--#-----##-##-#----######-----##------#--#--------#
#--#-#--#-#----------#-------###-##-#--#-#------#-----#--####--#---##--#-#-###----##-#--------#--#--
-#----##------#----##-##-----#--#--##-#-#-------------------#-----#--#--#-----#--#--#-----#--####--#
-#-----##--###-#-------##-#---#---#-#----#-#--#-##--#-#---#---------#-#--###-#----##---#-#----##---#
---#-##-#-----#--##--#----##-##---##---#---#----#-#--#--##--------#-----###----#------------#----#--
##-#----#---#----#-----#----#-#---------#------#-#-#--#----#--#---#--#---#--#--#--##--#-----#--#---#
-#---#---#------#-#------#-#-#--#-##--#--#------------#--##--#---##--------##------#--###-------###-
#---##-----------##-#--###-##-#--#-#-#----#-#-----#--#--#------#---------#-####-#--##-#--#------#---
-#--------------------##-#-#-----##--#-##-----#-----------###-----#---#--#------#--#-##----#---###--
--###-#-------#--#####---###--#------######-###-#----#----#---#-#--#---##---#--##--#--#----##--##---
---#--#-##----------##--#----#----------##--------##-#-##--##-----##---##----------##-----#--------#
------#------#-----#---#---#---#-#--#---#---#------#--#--#---##-###---#-----#-##-#--------#----#--#-
--#-#------------##------#---------##-----#----##-----------#-----#------#---------#----#--####-##--
----#-#-#---#----#---##-#----#----------##---#------#-----#-##--#---#--------#---#-------#------#-#-
-#--------#-----#----#-#-##-####----##-#-#-##----------#--#-----#-#--#--------###--##--####--#------
-#--------------##--##-##----#---#-------###---#---#-##--#---#---------#------#---#----#---#------#-
---#-------#-##-#---#-#---###-----#---#----##-#--#-#-##-#------##--#---#-#---###----##--#-##-------#
#-##-#---#####----#----#---#---##--#--#--#-#-#-#--------##---#----##---##-#-#--#-----#-#-#-#----##--
-------------#---#-------##----#---#----#--#-#-#--#--#--#--#------#--#--#---#---#------------#------
---#-#---#-#---#-#---#---------#---###-##-#--##--#---#--------#--#--------#--#--#-###---------#-#--#
#-##-----------#--------##--##-##---####-------#----##--#--------#--##-##-----#-##-#--#-#--#-##-#--#
----#-#--#-##----####-------------#-#-#----#--#####-##-##---#-----##--#------#--#---####-#---------#
--##-----#--##--##---##---#-----#---#------#------#----#---------##-#-#--------#--#---##--##-------#
----#-#-----#---#----#-#-##---#---------#-#----#----#--#--------##--##----------#-#---#---#-------#-
#--###--##-------##-----------#-----#------##-#-#--#-##--##-#--------#--##-###-----#--##---#---#-#--
#-----------##----#--#----------#---#-#-###-##--###-#------#-#-----------#----------#--#--##-###--#-
--------#---#-------#-#----#--##---#-#-----##-##-#------------#-----#-------#-----##---#-#-#--##-#-#
--#-##---##-------#---------#-#-#-------#--#----##-##-#------------------##-#-##----------###-#--##-
#--#-#-#--#--##----#---#------###--##---#---#-#-#-#-#--#-----###-#--#--#-#----------#-#---#----##--#
----#---#-#--#-#------###--------##----#-#-##-----#-#-#--#-----#---##---------##--#-----######--#-#-
##--##-##------#----#--#-#-#---#---####---##---##--#-#--#-##-#------###-----------#---------#-------
--#----##-#----#--#-#--##--------#---------#--#-#-##-###-##----#--#-##----------#-#------#----##----
--##-----------#--#-#-##---#----#--#----#---#-------#-------##------#---#-####--###-----------------
#--#--#-#--#-------------#####-###--##-------#-##--------#--###-#-----#-----#--##-#--#--------#----#
------##-#-----##-#-#--#------###--#-#--#-----#--#--------####-#--#---##-#-E-------##----#---#--#-#-
---------------##----##----##---#-#--#-----#-#--#---#-----#------#-----#--#-#---##------#-####-###-#
---#-#-##----------#-------------####-#----##-#-----#--#---##------------------#----##--------#---#-
---#-#--------------##---------##-#-#--#-#---#---------##--#----#--#---#------#----------#----##-#--
-#--------#---#--##--#---#-#--#####-#---#---#--#---------#--##-----#-------####---##---###--#------#
-##------#-##------#-----#-------#-#----#--#-----##-------#--#--##--#---##---#-----##-------##-#----
----###-#-#----#-#-----##-------#---##--#-#--##--------#---##-#-#-#-#-----#--##-#---##-#----##---###
-#--------###-#--#---#--#----#-------#--#-#####--------#-----#####-#-##----##--#--##-------#-#----##
#------#-###-#-#-#--##-#-#-------#-####-#--------------##-------#-#--#-##--#--#----#-##---##--##----
##------#--##---#---#----------#---#-##----------#---#---#-------#-----------#-#-##---#-#-#--#----#-
---------#----------##------#-----##-#-###--------------#-#----------#------##--##----###---#--#--#-
--#--------------#----##----##-#-##------#--##-#------------#-##-#--##-#--###---###-----##---------#
--------###-#----#---#--------##-#---------#-##--#---####----#-----###------#--#---##--##----##----#
----#--#----###--#-#-#-#--#--#-#--#--#-#---#-----#-###------------###--#---#--#---#--#----#--#---#-#
#------------------#-#----#-#--#---##----##---#---#--------##-###--#--#---#-#--#---#-###-#-----#--##
--##----###--#---------##--#--###---------#-#-####-----#-----##-##---#----#---#-#-----###------#----
#-#-##---#--#--###--#-#----##--#---##-##-#--------#---#-###-#-#--###---#-#--##-#-#-----#-#--#--####-
----##------#-#-#-#---#---##-#-#-#---#---##---#-#------###-----##---##--#-------#---##-#--#-----#-##
-----------#--#-------#--#---##-##--##----##---#-----#-#--##------##------#--###-#-----###---#-#-##-
#----##--#----#-##-#-#####---##-#--------#-##-------###--#-----------#-------#----------#----##---#-
-#-###----#----#-###----#-----#---#--#----#-#-#-----#-##-#----#-#-----##-------##--##----#-------#-#
-----###--##-#--S-#-#-#--#---#-#--#---#---#-----##-------#--##--#---###-#-##-#--#---#-#---###----##-
-##-##---#-#-#---#--##----#-#--####--##--#-#-----#---##---#-#-#-#-#--------#---##----##-#-----------
--#-#------#---#---#-#-----#-#-####---###--#-------##--#---##-#--#--##---#-------------#------#--#--
------------##----#-#------##---#-#--#---#----#----#-----#-#---#-###--#--#-----#---#--##---#-#-###--
--#--#------#---#---##-#-----#--##-#--#--##-#--#----#--#-#--#----#---#-#--#-###-#---##--#---#--#--#-
-###--#---##-------#-#---------#-#-##-------#-#-#-#--#-#---#-####--##-#-##----#-#-#-##---#----------
#--#------------#-#--#-#--#--####-------##--##--#---#-#---#----#-----#--------#-##-#------#-----#-#-
#-###-#---#----#---#---#----##-###----#--#--#-------#-#----#--#-##------#-#-----------#-----#--#-###
#-#-####-----#--#--##-#-#----#-##-#---#-#-####--#--#--#------------#-#----#--#--------##--#--##-----
-#-------#------####--#---------#--------#-#-##-#-#--#--#---#-#--------#-#---#-##----------#----##-#
-#--------#-#--###-#-------#------##-#-#---###---#-#---##--------##--##-#-#-#-#----#--#-----#-------
#---#-#-#-#-#-#------#-#----##--##---##--#--##-##-##---#---#-----##-#-#--#---##---#-##---#--#----#--
-------#----###-----------#-#---#--#---##-##-##---#--#--#---#-----------#----#---------#-##---#---#-
----#--------#-#---#-##------#-#-#----#-------##-#-#-#--#---#-#-#--#---#-#----###--#--------##-#----
---#-------#-#--#----#-#-#---#----#-----#-#----#-#-##--#---#-#-#-#-###-#--#------##-##---#-##--##---
#-#--#-----#-#---#-----#---##------#---#--#-----#------#-#------#-######-##--#-##-###-#-#-#-#-##-#--
-##-#-------##-------##--#--#-------------###--------#------#--##--#-#-----#-#-------##---#--------#
#-#--#----------#-#-#---#-#-#-##-#---------------#----#--#--------##---###--##-#-#----#-#----#--##--
--##-#-####-#-##--------#-----#--##------------#-#-###-#--##---------------#---##-#-#----#--#---##--
-##--#-#--##-----#--#--#---#--#-#-#--#----#-----##-##---#--------#----------------#-####-####-------
#-#--#-##--#----#---#-#--#--##-#--#-#-----#----#--#-###--##-#----#-----#--##-----------------#--#-#-
----------#--###----###-#--#-----##----##----#----##-#---###-#---###-----#------###-#------#----##--
-#-#--#----##---#--#------#----#---#-##-#-##------#--------##---##-###----#---#------###--#-##-#-#--
--#-#--------##---#-#-##--##-#---#-----##-##-##-##-#-#-----#-#-#-##-#------#-#-#--#----#---#---#-##-
---------#----#----###-#--#--##----#-##---#----#------##--#--##-#-#--#-------------##-##------#-----
-------##------#-###-#---##-----#-#------#--#------##-####--#--###-----#-------###----------##---#--
-#----##----##--#####-#-------#--#--#-#---#---#-#----###----#--###-##---#------##----#-------#--##--
###------#-----####---#-----#--#--#-#----#-------#----###-----###-#----------##--###-#--#---#-------
-##----#----#-#----#-##-#------#------#-------##----####-------------#-#---#------#-##--#--------##-
