-#--###-----##---#--#-##-#-------#----#------##-#--#-#-#----#--#-##---##-###--------#-------#-#----#
-------#----#---#-#--------#-#--###-#------##---#-#-#---#-###-#---------#--#-#-------#-------#-#--##
-#---#----#-###-#----###----#-#-----#-#-###-#-###--#####--####----#-#-----#--#----#-##-#-#--#---#--#
-##-##-#--#-##----##--##--#---#--##-#----#------##--###--##---#-#---#-#----#---#--#--#------##-----#
----#-#--------##-#-#-----##--#----#---##-#--#---#--------#-#-#------#----------#----------#--------
-#-------##-#----#---#----#--#-##---#-#--------#-----#-#-------#-#------####--#-#---##--#-#--##-#---
-------##---#-#------#-#-------#----#-###---###--------###-##--###-#-----------###--##-------#------
##----#-#---##--------#----#------#-##--#-#--#-#--#--------------#------#-#-#---#-----###--#----##--
--#---#----#---#-#-###-------#---###-----##-#-#---###--#--##-##--##-----#---#-----#--#-#--#----#----
--#----###-#--#---#-#####----#-#-#--#-##--#---------#-#------##-#-##------#-#--#-###-----##--#--#-#-
#--#---#-#---#-##-#-----####----###----###--#----#--##--##--#-----#-##---##-##-#-#----#---------#---
--#----#-#---##-------------#--#---#--#--##---------#---##-------#--#-##-----#-##------------#-#---#
----#--##-#---##----##-----##--------------#----###---#----------#--#------#-#-----#-#--#-#---#--##-
------##--#--##---#-#-#-#--#--#-#--#--#-#---------##---#--##----#-#-#----#---#--##-####--#----##----
---###-##------#---#-----##--#--##E---#--------#--#----------#-#-----####----#---#-------#--##------
-#--#----#-#---#-------------#-#---#-##--##-#-#--##--##--------#--------------##-#----#----##-----##
#---##-----#-#---#--###-----#-##-#-#---##-----##--------#-----#---#---#---#-#--------##--##----##-#-
-#---#--##------##---#-#--#-#---##--------------#-----------##-#-----##------##--#--##------------#-
-#---#------#----##-####--#--#----#-#-#----#-#-#---#-#--###-------##-#----#-##---##--#------#---#---
#------------#-#--#--#---#---#-------#-------#---#-#-------###----##---------#-#---##-#-#--#----#---
---#--###--#-----###-----#----#-#-##---###----##--#---##-##--##--#----#----#-----###-###-#-##--#----
-#---#---##---###-#-#---#---##--#----##---#---#--#----##--#--##--#-#----##--#-#-#-#--###--#--#-##---
-#-------#--#-----------###------###-----#-####--#---#------#-#---#---#-#---#----#----#----#-------#
#---------#--#----##--#-##---#--##--------#---#--#-##-#--##-#-#---#---###--##--#--#-##---#-####-----
#--##-##-----#---##-----#-------###--#-##-##-------#--#----#-##-------#--#--#----##---#----------##-
--#-------##-----#---#----##-##-#---#---#-#-#-#----##------#----#-###--#------#--###-----#--#-#----#
------#--##-------###--#----##--#--##--#--#-------####--#--#--------#-#-##-#--#--##-----------###---
###-#--#------#-#----##--#-#--##-##-#--#-#-##-#--###----#-----#---##-------#---#-#--##--#--#-##---#-
-###----#----#-#----#----#----------------#---#-##---------####----#-#----#---------#--------#-#----
#----#----###------#-----#--#--###------------#---##-##-----#---##--#---#---#----##-#-------##----##
-#-#-------#---#---#--#---#---------#--#--#----#-##------#--#-------#----------#----#------#-#------
-----##------#-#--#-##---#---#------------#-#------#--#-#-###---##---##-------##--##---------#---#--
-#-#----#-----------#--#----------#--####------#----#----#--##-#--#----------#---#--#-###----##--#--
------#--#----#--####-#------#-#-##-####---#---#-#-------#-#----------#--###----#-------#----#----#-
#-###-----#---##---------------##---#-##-#---#-----##-#---#--##-----##--##-#----#--#--#---#--------#
-##-#-#-#----------##---#---#------#-#--#---------------#--#---#-#--##--###--#--------#-----##------
-#----#----#-#-#------#--#---#--###-------#---#--#-#---###---#-##---#-----##----#---##---#---##-----
---#-#------#----##----#---------##--#-----#----#-#-------##--#--#--##-#-----###-#-#----#----#------
-###-##----------------#-------#-#--#--#---###--#----##------#-##--#---#--#----###--#--#---#---#-#--
#----#-#--#---#--##-#-#-#-----#-#-#-#-#-#-#----####-#--------#--#-#-#----#-#-#-#--#---###---------#-
-#---------#--#--#---#----#-------#-#-##---##-####-###---#---#---#---#--#---#-#-#-----#----###-#--#-
--#------#------#----###-#---#--#------##-#-#-##-----##----#------#-#-#--#---###-----##---------##--
#--------#--------##-##--#--##-#----###-----------#----#---#----####--##---#---#----##----------#--#
--#------#--#-#-##--#--#---#---#-#-##----##--------#-#-----##------#----#--#----------##----#-#--#--
#-#-#---------#--#-###---#---#-#-###--##-----##--#---#-#-#-#-##--#---#--##-#-#--#-----#---#-#----#-#
-#-##-##--##----##-----#-----------###--##--##-#---#--#-#--###---------#-----------#-----#-----#----
#####-#-##-#-#----#--#-#-----##-#---##---#-----#--#------##-----#-#------##--##------#---#--#-####--
---#####--#--#--##------#-------#-----##--#-##--#-####---#-----------#-#--#---#--#----#-------------
--##-#--------###--##------#--#-##---#-#-----#--#---#---##---#--#---##---#-##-#---###-----###-----#-
------##-#-------#-#-#-##-##-#-------#--#-#-#-#---------##------##--#---#---------------#--#-###--##
-##-----#-#-#-------#--###-#---##-#-#---##-----##-------#---#-#-------#-#--------##--##-------------
---##-#-----#-#-------#---##--##-----#---#-#-------#--###-##---#----#-----------#-#-##---#----#---##
#----#---------##-#-##-#--#---------###--#-#-#-###---#-#####-#-----##---#-------#---#---#-##------#-
----#-##---###--#-#-----#--#--------#-#-##-#-#-----#---##--------#-###-----#----------#----#-----###
-#---------##-##----#----#----##--#-------##----#----#-##---#-------#-#---###-#-##-----#--#---#--#--
--#---#-##---#-##----#------##---##-#-#-#---#----#---------#-#-#-#-----#--------------#--#-----#--#-
---#----#---#--#-----------##--##-#-#----#------------###-#---##-----##--##--##---#--#--#-#---#----#
#-#------##-##------------##-----#-------##--##----#---#--#--#--#--#-#----------#------------#----#-
--#-#---##--#-------#---#-#----#-##-----##---#--------#--#---#-#-####--#-#-----###--#--###--#----#-#
---#-#---#----#-#--------------##----#---#------#-#--#-------####-#-#-#-----#-------###---#----#----
--#-#-----#---#---#------#----##------#--#-##-----#--#-#--#--#--##---#-#-#-#---#--#---#-#---#-------
##-#---#---#-#-----#-------#---#----------#---#--##-----#------#---#---#-#--###--------##---####-#-#
-#-#---#--#-----##----#-#----#-#---------------##---#-#--###-#-#--#--###--#-#-#------#--#---##--#-##
---#---#-------#---##---#-----#-#-##------#---#--------#---#----#--##-#--###--#-#--#--#-#--#-#--##-#
-#--#--#--#---#-#--###---#-#--##----#--#-#-###---#--------#--#-#-###---#--#-------#-----#--------#--
---#-##----#--#----##----#--####-#-#-----#-#---#-###---------#---------####--###---#--------###--###
-#-----#-----#--#-#-------#--#----#--##--#-----#-#-----------#---S------#-#-------#---#--##---#---#-
-------#---#--#--#--#-##----#----#-#-#------#------#-----##-#----#-------###-------##-#-#---###--#--
--#-#----#--##----------------#------#--#--------#------##----------#-###-####----#----#----#----##-
--#-#-------#-----#--#----##-#-----#---#-#-#-###---#-#-###---#-------#-------------##---#-----#--##-
---#-#----#--#---#------#----#-#-##-#--------###-#------#-------#--#-----#-----#---------#-#-#####--
-#---###-----#-##---#---#--##---------##-##-#--#---#-#--##----#-##-#---#---#---#---#-#---######--#--
-#--#---#--#-###---#---##----##-###-##-------#-#-------####-##-##-----#--#--###---#---#---#-#-#--##-
-#------#-###--#-###---####---#---------#--##--#-#-####---#---##--#-#--#---##--#---#-#------##----##
-#-##-#---###-#-#--##--------------#-#-##--#------###------###----#----#---##--------#--##--#-------
---#-#---#---#-####-#--#------#-#---#---------##---#---##--------##-------#-####----#-------##-#--#-
####-#---#------#----#---##---------#-#-#--##-----###--#------#---#--------------#------#---#---####
------#-#---##----#-#----##--#----#------#---------##--#---#--#---#-#--#--------#-####--#--#---#-#-#
-###----#-#--#----#----#-#-#--##-#--------###-------##-#----#####---###-----###--#-------------#-#-#
##-#---#-#-#---##--#-----#-#-##-----#----#-------###-#----##-#------#-----###-##--#-#----#---#----##
#------#-#--------#----#-------#---#-#--#--##-#----#-#-#---#-##-#-------#-----###--#####-#--##-#----
-#-##-#----#-#----------#--------------##-----#----##--#---##-##-##-#----#-#----#-#--------------##-
----##--------#---##--#-#--#---#-----#---#---#--------#----#--#------#---------#-##----##-----#--#--
##-------#--------#--##-####-###---------#-#-----##---------#------#--#--#---#-------#--#--##---###-
----#-----#---##-#-#-----##-------#--#-#--#---#--#----##-----#------#-##-#-#-#----------#--#--------
-###-##--#----##--#------------------#----##-----###---#------#--###---#---#---#----------##--#----#
-#-#---#--#---#----##-#-#------#--#---#------##--#--#------##--##--------##----##-------#----#-##---
#----#----#-------#-#--#--#-####---##------##-###-#---#----#---------#--##----#--#-#-#---#-----#-#--
-#---#----#--#-#--------###--------#--#-##-----#-##-#--#-##----------#-----#---##--#----------###---
##--#-#--#-##--##------#-#-##-#----#-###---###--------###------##-###-#-#--###-##--------##--###-##-
------#-#--#------#--#####-#---##--------#-####------#-----##---#--#-----##---#-###-##--##----####--
----#----#---#--#----#-###-#----##-##----#----##--------#-----#--###--##---#---##--#---####--##-----
---##--#----#---#-#------##-##--#---#--#-##-#--##--#--#-#-#####-#-#-#--#-#--#------#----#----------#
--##----##-----#----#-#----##----#-----##---#---#--#-------------------------##--#--#-#-----##--#--#
--#-----------#-----#-#-#--##--##---###--#--###---##-#-#--#-###----###-------------------##---------
-----------------#---##--#-##---#-#-####---#---------##----#-#--##---##-----#-#--#-###-#---#-##----#
-##-#-###---##--------##----#-----#-#----##-##--#------#------##-----##---#--#----#-#-##------------
----#--#---#-##--##--#-----##---###--#-#-----------------#-----#--#----##------#--###----##-#-#-----
------------##--#----##----#--##---#---##--#----#-#-#--#--#-#------##-#-----##--#-----##-#---#----#-
--#--------#----#--##---#-##-#---------#-------##----##-----###-----#--##---##--##-#-------#-#-----#
