--#-----#-#-----------#----------##-#-#-#---#---#-#---##--##-#----##---#-#####-##---#-#-#--#-----#--
-#--#--#-##---##--##--#-##---------#---#--##-#-#---#--#---##--##-###--#---#---##-------#----#-------
-#-###-----#####---#-----#--#----------#----##--#---##-----#-#--#----#--#---#-#------------#-----#--
-----#--#--#--#--#--#---#------##---#-###-#-##--#--#-##--#----#--#--------##-###-##-#-#----#-##-#---
-----##------##----###-#--#-----#---##-#-##--#--#-#---#----#-----##--#---#----##-#--------------#---
---#--##-##------#---#---#--##---#---#-#----##-#----------------#-#-------------------#----###---#--
#----#--#----###-#-------------#-#--###------#--#--#-###-#-#-#--------#-#--##-#--###-----------#----
-#----------#----------#---#--#-#-#--#-#--#-----------------#-#-#--#-------#-#----#--#-----#---#---#
#-#-#-##----#--#--###---###---#-----#--##---####---#-----##-------##--#-#------#----##--#-##--#-----
---#--------#-----#----###--#--#---#-#---------#--##-#--#----#--#---#-#-#--#--#-###-##-----#--------
--#-#--#---------#-#-#-#----------#---#--------##-#-###------#--#---#-###------#----------#---#-----
--#-----------#------#-#--------------##--##----#----#-----####--##----#--#----##--#-#-#-#---##--#--
##-----#-#--##-#-------#-------##-----#--#-#---------#---#--#---#-#--#-#-----#---#----#--#-#-#-#--#-
--#----###---------###-#---#--##--#-----###---#------#--#-#-----#-#--##-##--#-#-#-#--#--##-----##---
--##-#---#----#--#-#------#-##--##---#-#--##-#-#-#-#--#-##------#------####-#-----##----#-#---#-#-#-
-----#---##-----#----------###--------------#-------##--##--#--#--------#----#-#-###----#--##-#--#--
---#---#----#----#-#------#----#-----#-#-----##---#-----##---#----##-#--#-----##--##-##--##-#-#-##-#
-----#-----#-#--#--#---#-----##-#---##-#------##-#----#####-#-------#------#-----#--###--##---#--###
##---##---------##-----------##-----#-------#------#-#---###-#-#------#----###--##--#---#----#--#-#-
-##-##---#---#---#---#---#---#---##-----------#-------#--##-##--------#-##-#-####-------#---#------#
--#----#----#-##--#----#-#--#-----#----#--#---##-###------##-###---#----------##-#-#---##--#----##-#
-------##--------##--#--#--------#----#--#--------#---------------#-----#-#-----#------#---#----#-#-
#-----#----#--##-##--#-####-#--#--#-#--#---#--#------##----#-#-------#-##------###--------#--#-#-#--
--#-#--#-#---#----##---#--##-----#-#---#----#---###-##-#-#---#----##-#--#---------#-----#---#---#-##
-----#---#---#-------##----#-#---#--#-##---#-##---#-#-###-#-###----#-----#---##--#--#-##---##-#-#--#
----#-----#------#-#--#--#---#----##----##--##--##-----##-----##--#--#--#-#--E-#-----#-----#--#-#---
---##---#-#-##------#---##--##-#---#--#-#---#-#----#----####-#-#-#-##-------#-------#---#-#-#-------
----#-#------#---###-----#---#--#----####--#---#-----#-#---#-----##--#--#--#--#----#------------#---
--#-------###-#--##---#--####--#--##-------#-#-----##----#--##-----#------#-##--#--#--------#-----#-
------#-#--####------#--#-#----#-#--#-#---#--##---#-#--##--#--#---###----##-------#------------#-##-
---##---##-----#----##-#-#-#----##-------#--#-##--------####---##-#---------#-#-#--#----##-##----#-#
----#----##--#--##-####-------#------#---#------#-------#-#-----#----#--------#--##---###-#---#-##-#
##--#------#---#-----#----------#-#----------------#-----------##---##---#--##--##-##---##----------
-#-#-#-#---#---#------##------#-#-#-----#---#---##--#----#--------------#-#-####--#-#--#----#-#-#--#
-#-----#-#-#-##--###--#-#----#----#-------------#----------##---------#---##--#-#-#----#-#---#--###-
---#--#--#--#----##---###-------#--------------#----------#------##---##--##----------------#-#-#--#
--#--------#---#-#---##---#---##------#-----------#----#--#---##---##---------##-#-#-#####--#--###--
--#------------#-------#-#-----#---#-------#-#--#---#------#-#--#----#----#-##-#----##--------#-#---
####---#-#-#---#-#-------#-----#--#---#--#--#--####-#---##--##--#--##---#-##-##-#---#--#---#--###---
-#---#---#-##-----#---#--##--#--#---#-##-#-#-#--#--------#-#--#---#----##--#-#------###-#-#---#-#---
---###---#---#--##-#--#----##-##----------#-----##--#-----#--#-#--#------------------##---#--##-----
---##-##-----###--#---###--#--##-#---#--------##--#-----####---------#--#--#-#-----#-#--##----#---#-
#-#-#-#-------#-####-##-##--#---#-----#-#####--##-#------###--#-#----#-----#-------##------##-#-----
--#---#----#-###-----#-###----###-------#----------#--#---#----#-----------#----#---#---#-###---###-
-----##---###------#--#--#----#-#-##-#---###-#----#-#----#-#----#---------#---#-#--##----#------#---
-#####----------#---##-#------##-----#-#-----####--#-------#--#--#-----#---#-#---###-##-#--------#--
---#--#####---#---#---#-----#--#-##--#--#-#--#-#-##-------#-#--#--#-----#-#-#--#----#----#---#------
----#----##-##-##--##-#-#--#-------#--#--#-#--#-#---###--####--###----#--#-###--##-###-#-----#--##--
----#--#--##--#-----#-#--#--#---------#---##--####------#------###------#--##---##---#--#######--##-
----#----#-------#--#-----#--###--##-#---#--#--###---------#----#-###-#-----#-#-----#----###--#-#---
#---#-----#---#--##----#---------#---#------------#-#-##---##----------#----##-#-#--#-----#-----####
-#-#----------------#-----#-----------#-----#-#------##---------###-------#--#--##-#---#-#-------#--
#--#---##--------#---#-------------------#--------#------------#-#-----#--###---####--##-----#---#-#
##--#--#####------------#--##---#-#-##-----#-----#----------#---##-------#-#----#-#-----------#-#--#
---#---#----##-#--#-#---#------#-#-------##--#-#---#-#---#---#---------#--###--#----#-#-------------
--#-#-##----#----##--##--#--------#--##-##-#---#-#--#-#---#-#--##---#-#-#-##---###--###----------#--
---#-####---#-#-##--#------#---###--###---------#----#------#-#-##-#-----##-#-###-#--#####-##---#---
--#------###-#----##---#----#--##-----#-##-##----#-#--#-#-------#--#-----#--##---#--##-##-##-###----
----##-----------#----#----#--#-------------#--#-#-#---#-#-#--#-#-----#--#-#----#----#-#--##-#----##
--##--#--#---#---#---##--#-#----##----##---------###-----------#-#-#-#-#--##-##----#--#------#----#-
--#---#-#--######-#--###-#-#---#--#---#----#-##---------------#-#---#-##--##-##-###-#--#-----#---#--
#-------#----##--#--#--#--##-#----#---#-##----#------------#---##--#--##--##-#---#---#---##------##-
-#-##---#-----##------#----#-#--#--#-------###----#--#-#--#-###-##-#--#-#-#-#-#---##-##-#---------##
##--------##----#---#------#-#-#------#--#--------##-#-#--#-##--#-----#-#------##-#-#-#-----#-------
#-------------#----#-#---#-----#--#-#-##----#-#-##--#-#---#---#-##-----#-----#-----##--#--#----#-#--
-------#--###--##-##--#-#---###---------#---------------#-----------#-#---#--##-#----#--------#---#-
-------#-------##-----#--------#---###---#----##-##-#-#-##--##---##----##---#--#-##------#-----#-#--
#-#-------------######----------#----------------------#------##---#-#-#--#--##----#--#----#----###-
#----###-##---#--#-----#---##---#------#-#-###-#---#--##------#-##--#-#-##--#--------#---#-##---#-#-
#-#-##-----####--##---------#---------------###----##-#-----------##--------#--###-##---#-#-----##-#
-####----#-#-----#-#-------##-###-###--###---##--#--#------##-----#---#---#-#--#--#-##------###-----
##--#-#----##----#-##---#--#------##----##----#---#--#---#-#----##-#---####--##--#-------------#-#-#
##----##---------##--#-##----#-----#---#--#---#---#-#-------#-#--#--#--------#-#-----#-#-------#-##-
-#-----#-#----##----#-#---#########----##---##-#-#-#---#-#--#-#-------#-#-#-#--##--##-#-----#-#-----
----#---#---------------##-#--#-#----#---#####---##-#---#----#---#---------#-----#-#--#-#--####-#--#
#-#--#---#---##--#-----------#--#------------#--##--#--#--#---#-###----##-##-------#-#---#-##--#--#-
--------##--##-#---------###-----##-##--#-##--------#---##----#---##-#--#-#--#---#----#-#-----#---#-
--#------#-#--#-----#--#-----#--##---##--#--#------#-#-#------#-#--#---#-----#------##-#-#---#-#-##-
-------#-##-----##-----#--#-##------#-----#--#---##-#-#--##------#-#-#-##-----#----#----####--#-#--#
-####-#--------##--###----#---#--#----#----------#---##---#-###--#-----##--#---##--###-----#-#--##--
---#-###--#------#-#####-#-#--#--##-------##--##-#--#-----#--#------###----###---##----#-#--#-#--#--
--#---##--#-------#-----#--#---#--#----------#---------#-#-#--------------###-#-#-#-------#---#-----
-#--##------#--#--###-------#---#-##--#---#-----#---#--#-##-----#---#--##-----------#--##--#--#--##-
--##-----#-#--#-----###-##--#--#-###---#--#------#---#---#-#--#-##---#-#--#--#--------#------#------
---##----##--------##----#---##-------#------##---#-#----#-#-##--#---###------##---#--#-#------#----
#-##---#-#-#---#-#--#------##--#--##-#----------#-#--#---#-----##--#-##-#-#-------##-##----#-------#
------#---###-#----#---#--------##---#-----#----#--#-#------###-#----#---##-#--#---#------#----##---
-#---#-#-#--#----#--##---------#--#--##---#--#------#------#-------#----#-----#--#---#----------###-
-#-#--##----#-#-#-#--#--#####---------------#----#--#-#--#-##---#--------#-#--------#-#---#####-----
--#--#-#####-#-----#---##--#----#----###---#-----#-----##-#--#-#-##----##-#-#--#----##-----#-#--#---
-#--#-----------####------#---#----#----#--#-#--#------#---#-##-------#-#------###--#-##-#------##--
--#---#-#-#-##-#-------#####---#---#-----------#-##--#-##-#-#-----#-##--#-----####--------#-###--##-
#-----#-#-###----###---###-##------##---#--##---#--#---------#-#--#---##--#----####---#--#-----#-##-
---#----####---#-#-##------#-##-#-#---S-#---###---#--------#----###-#------------#---##----#--------
-#---------#------##--#--#--#-----#-#-----#---#----------#--####------#---#--#-#--##-----------#--#-
#---#--##----#------#----##---------##-----#-----------#---#--#---#-#-----##--#--###----#-#--#-----#
#---##---#--------##-#-#-#-#-#-#--#-----#-#------#--#-#-----####---#--#-#--###----#----#---##-###---
---##--#----------------#---#------#-----#-------#---##-------#--##---#-#--#-#-#-#--#--#--#--#-#----
-#-------#-###-#------##---#----#--#-#--#-#--##--##-##-##-#--------#-#-##-#-----------#----------#--
----##--#-#---##-##---------#-#-#---#--#-##-#---##----##---#-##-------#---#-#-##---#-#--##--##------
