--#--#-#-###------#--------------#--#--#-----###-----#-----#-------------##--#------#--#--#-#----#--
#--------------#--#----#--#-#-#--#--##---#-##----##------------##---#-------##--##--------------##-#
------#----##---#--#--#--#---##--#----------##------##---###-----#-#---##-#-#####-------------#--#--
#-##-#----#---#----#-----#---##------#---#-----##---#--#---#-##-#------#-#------#--#----##-#-------#
-------#-------#-#-----#--#-----------##----#--##-#-#----##--#--##-#-##-#---#-#-#---#--#--#--##--##-
-#-#-##-##-#-####-##----#------#-#---##-#-##------#--##----##--##-#-#-----##-##-#-#-----#---#-----##
----#--#--#----#---##---#---------#--#--###--#-###-------#-#--#--------------#----#--##------#-----#
#---#-#--------#-#-###------#-#------------#--#--#-#--#-#--#---#-----#-#---------#--------##-#-##---
#-#####-----------#---#####--#-#--####-#---------#-##-##-#--#-#-#-----##--##--#----##--#--##-------#
#---#--##--##-----#-#-----#---#---#--#-#--#-##---#-#---#--##----------------#-#---#---#----##-####--
-#-----##---#-#-------###-##----#--#--##----###---##-##-#---#------#----#---###--#--##---####-#--##-
----##----#-#-#--#--#-##-#---#----------#-----#----#------------------###----#-#---######---#-------
------###-----##-##-#-#--##----#-#--#-#--##-##--#-##-----#----#--------#----#-----#---#--#####--#---
--##-----#----##----#--#-#---#----##----###-----#-#--#-#-#--#---###--#-#-----#--#-#--#-##--##-#--#--
##--##---#---------##--#-#----#---###-#--####-----#-#-#-----#----##-------#-#-#-#-#-------#--#-#----
--#-#--#-#---#--#--##----###-#---###-#-#-#--------------#-#--##---#-----#--#-#-##---#-#-#----#--#-#-
--##-----#--#-##----#-#----##--#--###-------###-#--#-#---#--#-#----#-##--#----#------#----#--#---#--
---#----#---##----#--#-#-----#-------#-------#--##-#-----##------###--#---#----##-##-------#----#---
##------#--####-------#-##-#-#--#---#-#-#----##----###-#---#--#--#-#-###-#--#-#-----##--#---##-#----
#--#-#--#----###-------##----#--##------#-#---##-#--##---#---#---#--------#--#---##--#-------#----#-
-#---#------#-#------#------###---##--#---#-#---##-#----#-#---##-#-##--#----#-------#-#----#-----#--
--##---##--#-#--------#-##-###-##-#----#---####---#-#-------###---#-#---#-#----##----#------------#-
-####------#--#-####-#------#-#----#--#-###------###-#---#---#-#---#-#---------#------------#-#-----
--------#----#-#-###---#-##---------##----#-#---#-----#------###-------##-#-#----#-------#--##------
#---#--#--#-----#---#-##---------###-----#----#-#-#--------#----#-----#-###-##----------#---#-#-----
-------#-#-#--##---##-#-----#--#-#--#--##--##-#--#---#-#-#-----###-#-#--#--------#-#-#-----#-#----#-
---##-#--##--#--#--#-#--#--##----#--####----#---#-##-------#---#--#----#-#--#--#--#-------#-#---##-#
----##-----#-----#--##---#---#----------##-#---------------------------#--------###-#---#-----##----
------#-#---#-----#--------#-----##--#--##----#--#-----#---#-#--#-#-#--#-----##---#--##-----#--#--#-
--##---#-##------#----#--------##----#-##-----#--##-#-#---#------####-#---------##-#-----------#----
--#-------------#----##------##------#--#-#------#----#--#----#-#-#---#----##---##-------##--#------
---##--##-#-#-#--#-#----##------##---#-#-##------#----#-----------##----##-#-----##---#--##----#-#--
---#-#---#-##-#-##-#---#----####---#---##--#----#--#-----#-##-------###---#----##-#-------#----#----
-#---##-#-#---#--#-#--#-##-----#--###-##-#----#--#-------##--##-##------#--#---####------#---###-#--
----------------#--##---#----#-#-#-#-#-##--------###--#----##-#-----#--##-#--##-#--------#---###----
----##-#--##---##-#-#-##----#------#---#---#-----#---#-##----#-##---#-#-#-#----#-#--#-##---#--------
-#----#--##------##---#-##---#--#----#-----###-###---###-------------##-#--#---------#----#--##-##-#
-#-#--#--#--#-----#----#-----###--##-#-------#--##--#-#-#-#---#-#--------##--#---#-##--#-----##-####
##----#----------#-----##-#--###-------#---##---------#-#-#-##-##-#-#---##----#--#--#------#--#-#---
##-#-#--------#-#-#-----#---#--#------------#----#--#--#---##-#-#--#-#----#--#-------#--#-##-##--#--
##-----##----#-----###--##--###-#-#-##----#####-#---#-----##--#------##----#---#--#--#----#------#-#
###-#-#---------#--#-#---------#----###------------#-#--##---------#----#--###--#-##--#--#----------
-###-###-##----------#-#--#--#---------##-#####---#---------##----#--#-##--#------#---------#-------
####---#-##---#---#-#---#-#----#----#-------#--#----#-##-----##----###---##-#-#-#--#-##-##-------###
-#--#-#-----#---------#-#-#-#-------##--#--##-#---#-------#--#---#-#---##---###-#----###--------####
--##---#--#---#-###-#-----#-#---##--##--#--#-##--------#--#--#---##-#----##---#--###---#-##--##----#
-----------#--#-------------#-#---#---#-----#--#-#--#------#-------##--------#-------#-#------##---#
----#----#-----#------##---#-##-##----------###---##---##-#-#----#--#---#-------###---#------#-#----
-----#-----#--#-#-----------#---------#---#-----#--#-#-------#-#---##--#-------#--##----#-#---#-----
-#--------####--#--###-#-#-#--#----#-----------#---##-###-#---##------#-##-##-#-##---#--#----------#
-#-------#-##-#----------##-#-----#-----##---------###-----##-#-#--#--#----#------##--#-----###----#
-##-#--------#-#--#####---------#-----#---#-#-###-----------##----#--##---#----#------#-#-#---##--#-
-------##---#-#--#--#--------#-#---#-###---#-#-##--------#--##---#-#----#-#---#-#-#----#------------
--#--###---#-#---#-#-----##----#-----#-###--##---##--#-----#----#-#------##-#-##-----#----#--------#
-##----##--#-#-#--#--#-##---E---------###-------###---#---#-##-----##-###-#-#----##-##-##-##-#---#--
----#-#--###-#---#--#----##--###-----###---##-#---------##-----##-----##------##---#----------------
##---------#-#-#----#--#-###--#-#-----##-#-##------#-#-#---#---#-#--#-#--#-##-------#-----##----#---
##---##-#-###-------#----#-###--#--##------#-##-##-#--#-##-#-----#---#---#-----##---#------##-#---#-
#-#-##--##-#-------#------#--#------#----------#---#----#------#------#-#---##----#-----#----#--#-#-
-----##----#-----------#-----##---------#-----#-##-------#-#--#----#-#-----#-#------#-----------##--
-##-##-#--------#----#--#-#--#--#-----#--------#-##----#-###--------------##--#--##-###----##---#---
---#-----##-#----#----#-##------------#---#-------#---#-#----#------#-##-#---#-###---------####-----
---#-##--#--#--#--##---#-#-----#-------##-##---#-##-----#-#--#-##---#-##-------##--#---##--------#-#
-----#----##----#-----#---#--##--#--------#--#-#--#------##--------#--#--#-#------#---------#-----##
-----##-#-#-#-#-----#-##-#----##------#-----#--#-------#----#--------#---#--#-##---#--#--#----------
##-------##----#-##-----------#-#------#--##-#-----#---#------###------###-##-------#--#-------#--#-
#-----###---#--##---##-#---##-#-#-#--##----#---#--#--#--#-#--#--##-###-#--#---#---##----##--##-##---
-####-##-##-##-#----#----#---#--------#---#-----##-------###--####--#-#-##---##-----#--#-##--#------
--##---#--#-------#-------##------#-#---###------------##-##----#--#---#----#-#--------##---#-#-##-#
---#-----------#---------#-------#-#-#------#---------------#-#-##--#--#---#-#-#-##-#---------------
--#-#-##-----------##-#-----###--#--##---#-#-#---#-----#------##---#----#--#-----#----##--##---#--##
---#---#--###---#-#-----###-----##--#-----------#-----#----##-##--#-#-##-#-##----#--#--#-###--#-----
-#-#--#-----#--#-#-#-----------------####-#-###----#--##--#-###-###-----#------#-----###-##-#-###---
--------#---#-----#-##----##-#-##-#--#--##---###--#---#---#----###-------##----#--#--#-----#-----##-
---###----#--------##------##-#-#---#--------#---#----------#---#-#--##---###----##-#---#-#-#---#--#
#-----#--#---#-###--#-----#---------------###---#--#-#----------##-----#--##---#-----#--#---##--#-#-
--#----#-#--#-#-##-#-------#--#---###--#----##--##----##-------------#---#----#-#--#-#-#####--#-#-#-
---#--##-##-#-#-#---#-----#-------##--#-----##--##-----###------#---------#--------#-#--#-#---#-----
--#--#-#---#####-#----##--------------##-#--#-##-#-#----##--##-----------#-#--#-#------##-----------
##---##----##--##--#--#-#--#--#-#------#--#---#--#-#-----#-----------------##-----#-##-#--#--###----
-###----#-#--------#---------#-##--##-#---#--#-----#--#------#-#---------------#---#---##--##--#-##-
---#-#-----#-------------#-#-#-#----#-#---#--#--##--#-----###-##-#--#---#-----##---#--#--#-----#--#-
----#------#-#---#-#-##-#-----#-#---##-##-###---#-#---#-####--#-#-#-----##---##-----#-------#--#----
#---#--##-#---#-##-------#--#--#####-#-#------#-#-----#-#--#--###---##--#---#-----------#----#-####-
---------###--#-#------------##---#----###----#-#--------#-------##-#---#--#----##-#--##---#-##-##-#
#--##----#-#-----##-----------###-----------#-----------###--#-------#--------#-##-#--#-#----##-----
-----##---#-#------#---------##--#-#----------#--#--#----#-----##--##---#-##--#-#----#----#--------#
---#----#-#-###--#---#--#-#----##------#-#-#--##------##------#-----#----#-###-------------#-#---#--
-#-#--#---#-##----#---------##-----#-###-##-#--#-##-------#--###-#---#-#--#--#----##---#--#----##---
-#----S---#-#-#--#-----#--#---#-#--------#--#--#-------#---######--#------##--#----#---#----#---#---
---#-#-###----------##---#-##--#--##-#####-#--#--#-#----#------#-#----#------#------##-#-#---#-----#
---#-#--##-#--#----##--###-----------#----###-----###---#----#-##----#--#--------------##--------#--
----#-#-----#---#---#--##-##---##--##--------#--##-###--#---#---#-#--#------#----#-#------#--##-#--#
---#------##-#---#--#---##-----#-#------###---###-##--#--#---###-#---#---#---------#---------##--#-#
#----#-#-----#--#--#-#-###--#--#---#-------------#####------#--#------#-----##--##-#-###------#-----
#-#-----##---#--#--#-----####--#--###---#-----##--#--------------#----#-#-----##-#--#-##----#-#----#
-#-#------#-------#---#-----###--#----#---##-----#----#-----##--##---##---#-#-----#-------#-#----#--
#----#--------#---#-#-#-#--#--------#-#--#-#---#---##---#---#---------#-----#--#-----#----##-#---##-
----##---####---------##----#-###-##-##-##------------#-#-#--##---##---#-##-------#--#----##---#----
-#---#-----#-#--#---#---##-------#--#-#----#---##--##---#---#-##--##--#-###--#---##-#---##------####
