#------##-----#---#-#--#-#--#---#-##---------#--#--#---------##---#-#---#--#-####---#---##--#--#----
-####-#--###--##-----#-#----#----#-#---#----#----###-------#--##-#---#-#---#----#-#--#--#---------##
--#--#-#--##---#----------#--#---#-#-#-------#---#-#--#-#--#----#--------###--#----##-##----#------#
#--#----#-------#-----##-----------#-##----####-----##-#-#--------##--##--#-----##------###---##---#
-##-----#-##-#---#------#--##-##--###---##-#--##---#-#--#------#-#------##------#---------##-----#--
-##-----#-#-#----#----##---#--#-#-#--#----#-###--#-#-#-#---##-#------#-#-#---#-#-----#-----------#--
-#-#---#---#------##---#------#-------##--##-----#-###---#--#--#-#-#--#-#---#-###-#----##-#------###
-#--#--------#-#----#-#------###----#---##-#---#----------#----#-------#--#-------####-------#-#-#--
-----#--#-#---#---#-#--#-#-#---------#----###--##--####---#-#-##------------#---#-#----#---------#--
#-----####-#---#-#---##-----#-##---#--------------#---#------####---###-####-----###--#-#-##--##---#
-#-##--------#-#-#---#---#-----#--#----#-#-#----#----#---#---#---------#-#----#----#--------###---#-
#---#------#--##-##------#-##---#----#-#----#---###-#----##--#-#--#--#--------#---##-#-#----#######-
#---##---##-----#-#----#---#-#--#----#-----#----###----#-##-###-------#-####-#--#--#--##---#-#-#----
#----#-------#-#--##--------#-#-----#---##-#-#---#-#----#---------##-----#----#---------#---#---#---
------##-#--#----#----#--#--#----##----#--###-#-----#------##-----#-#-#--#----#---###---#--##--###-#
-#-#----#---#-------#-#--#--#---#-------#-#--#-----###-#--#-----##----###------#-##---#-#--#--#----#
-##-#----##---------#-#-##-#------#-#---#---#-##-----#-###-#-------###--#---##--##--##-##--------#--
-#--#-----#--#-----#-#---#-##-#--#----#--#--###-----#--#-#----#-#-#----#--#-#--##----##--##--#-----#
---#--#-------#---##---#---#--#----#---#---#--##--##---#--#-#-#-##-#-#-#-----##---###-----#--#-#--##
#--#----#-----#-------#-#-----#-##--#--#---#-------#----#-----#-#------#-#-----------##--#----#--#-#
--##--------##-#----#-#-E--#---#------#----#-#-###---------#-------##---#----#-----#----#-#-###--#--
---#-#-#--##---#----#-#---#--#-#-#---------#-#--#-----#-#-----##-#------#----------#--------------#-
#--------###---#-####---#-#--------###---#--###--###----##--#----#-----##--##-#-#---#------------#-#
#---#----#-#-#-#-#----#-##---#--##--#-#-----------#--------#-#----#####--#-#-----#--------------#---
---#-#-##--#-##-----##-#--####--#-----##---#----#-##-----#--------#-----##----##---##---##-##--##-##
-------#-##------###----#-###-#----------------#####----###----#--#-------------#---#---##--###-#---
------##-#-#--#-#-##---#-##---#-#---#--##--#----#------##-#-##--##-#---#--#--#------#--###-#-##-#---
---##---#-#------------#-----------####---#-----#-----#--#--------#-------#---#-#-#--#S-#---#-----#-
##--#-------#------#---#---#-#--#---##----#-#---#--#-----#-------##-###--------#-----------#--#---#-
---#---#--#----------#--#--###--#-##---#----------#----#----#---#--#-#-#--#-#---##--#----#--#--#-#-#
--##------#-----##-#--#-----##--#--#--##--#----##--##--#--##-------##-#-----#-#--#-###-##-#---#-#-#-
----####--------#---#--##----##-#------#--#-#-----#--##-###---#-#--#--#-#--#------###--#--#-##------
--#------#-----#-####-#---#--#--------#----#--------#-#-##------------#-#----#--#-#-##----#--#--#---
-------##-------#---#-#--#--#--#-#------#--#---------#######----------#--##-#-#------#--#---#----##-
--#-----#------#-#----#----####---###--#----#-#-#--#-##------#--#---#--#-----------#-##-----###-----
-##--##--####--#---#--#-----#-#----#---###--#-###---#------#----------#-#---#--------#------#-------
-#-##--###-#----#--##--#----#---###-#----#--------##----#---##--------#-#---#--#-#------#-#--#------
--------#----#----#-#----###-#---#--#-----#----##---#---#--#-#-#--#---#--#--##--#-####-#-#-#---#--#-
##---#--#-#-----#-#------#---##--#-#-#--#-------##--#-##-----------#--#----##---##---##-#---------#-
#-#--##----------#-##------#--#--#----##-#---------##---##--##------#-----##-#---#-##--##----#------
---------#---#-#-#-#-----#----#-----#-----#--#-##----#--##-####--#--------####--#--##--#--#-----##--
-----##-----#-#---#-------#--###-----#-#---#------#----#-----##-------#---#------#--#-#-###-#--#####
-------#-----###-#----#-#-#--##--#---##--##--#---##---#---#--#-#---#--####-----#--#-#-#---#-#--#-#--
###-#-##------#--##--#--#--#------------#----#--#-#----#--#----#-##--#--###--#------##------#--#--#-
-#--##--------##-##-#-#---#-##---#-----###-###---------#----#-#-#---#-----#--#-#-----#--#----#---#--
---##-#-#-------#-------##-----------#-###---#--##---------##--#--------------##-----------##-###--#
--#--#----#---###-#------##--#--------------#--#---#-##--#-######------#--#--------##-----#-#------#
#-#-#--##-#-#-#-#--#----#---#---#-##-####----#-----#---#--#------##----#-##-##--------###--##-------
#-----------#-----#--###-#------------#-#---#--#--###---#---#---#-#-------##-####----#--#---#---#---
-#--#------#-#----#-#--#-#----------#--------##--#--#---------#---#--##--#--#---------#----------#--
-#-#----#-#----#-###-#------##-----#----#-#--#-#-------#-----#--##---##-##-------####--#------##----
---##-##--##-#--#-##----##-#-#---#---#-#-#-###--#---#--#------------#------#--#----#-#-#------#-----
--##--##-#-######--##----##--##--#--#-#-##-###--##-#--#--#--#-----###---#--#--------##-----##----##-
--#---#--------#----#--#--#-#-##-###----#------##---#---#-----#-----##-------#-##-##--#-#---###---#-
###-#--#------###--#----#----###---#-#-----##--#------##----#-#-----#--#----#-#----##-----#---#-----
#-###--#-#--#--#------#-----#-#-#---#----#---##------#-#------###-###-#-#-----------#-----##-#-----#
#--#-------#----#----###--#---#----####-##--#-----##---------#-#-#---##-#--#---##---#-----------#---
--#-#---##--#--#--------#----#-#---#--##----##------#-#---#----####---------#----#-##---#-#-------#-
-##----#---##-##--#-#--#-#-#----##----#---#-##--#--#-#--#-#--##-#-----------#------#--#---###---###-
-#---#-##----##---#--#------#-##---#-#-##--#----------#------#--##--------###---##---##----#------##
-##--#-----#-------#-------###--#---#-#--#-#--##---#------#--#---------#--------#-----#-#---#-#-----
-#--#--#-##-#-----##--#-##--##---###---------#--#---------##---#-#----#--##-##----#-#---#-#----#---#
#-----#---------#--#----#--#-#####--#--##--#-#----#----##--#---###-#-------##-#-#------##-#---#----#
-#-#--#------##---##-##----##--------#------#--#-----#--#---#---#--#---#---##-#-##---##---#----#--#-
##---##-#-------#---##---#-#-#------##-#-#--#-------#---------#------#-#------#-----#--#-#----#-##-#
#----##-----##----##-#----#----#--#----#-#-#-#---#---#-##--##-#--#-----#--#--------#-#-###-#--####--
-------#----#--#-##-----#--####-#-####-#-#-#---#-#--#-#---#----#-#-#------#-#-###---#--#------#--##-
---#--#----##--#----#-####--------###---##-#---#-#---#-##-----###-#----#-#--------###--#-####-#-----
#--###-##-##----#--#---------##---##--#---------###---#-##-##--#--##--##--#---#----#--#-----#------#
----#--#---##-##----#-#----------###-#--##---#--##-#-------#-#---#--#--#--#---##---#---------#-#-##-
#----##--#----##-####--#------##----#-###--------#--#-#---#-#----####-#--###-----##---------##----#-
-#------####-##--####--#-------#--------#----#-#--------#--------------##-#----------#--###--#--#-##
--#--------#----#-###----#---#--#-----#-------##---##-----##-#--#----#-#----##-------------#------#-
#---------#-##----#-#---#--#--#-##-#---#-#-#----------#--#-#--##----#-##-#---#-###------#-#------#--
#---#--##----------------#-----#-----##-###--#-----#-#----##--#----#--#--------##------#--#--#---#-#
-#---#-----####----#--#-#--------#-#--#-#--#------#--#-------###-#-##--##---#--#-------------##---#-
----####------#--#-#-##----#---#-#-##-----###---------#----#--#-#--#----#-#--#--#---###------#----##
#------#-#---#----#---#--#--#---#-##-#--#--#-#------##-#-#-#-#--###----#-#-#-#--#-#-----------#--#--
--####-#-#------------#------#-------##---#----#--#-#---#-----#--##-------------#-#--------------##-
------#--------###-----#-#-----#-----#---#----##-#-####----##--#--#----##--##---#---##--##---###----
---#--------#####---##--##----#--#-#-#----####-#-#-#----##---------##----###-###---###------#-#----#
-###--#---#--#---#-##----##---#--##-#-##-----#-#------#------------##-----#---#--------#------##----
#-#-#---------#--#-###---#---##-###---#-------##---##---##-#---#-##---##--#-#-#------#---#--#---#--#
----#-#----##----#--#------------#-#-#-###---#----##---#-#----#-----#-#-------------##-#--------##--
-#----##---####-----##-#-##---#--#-###------##-#----#------#-----------#---#--#---#-----##-------#--
-#------#------#-----#---#-####---#-#---####-#----#--#--##--#-#-------#--##---##---#---##------#---#
-#---#------------##--#-#-------#-##-#-#----#-#-------#--#-#---#---#--#-----------#----#-#####------
--#-#--#------#-----#--#--#---#--#---###-----#--##-#----#----#-----#---------##-#-#-------#---#---#-
-#-#---#---#------------#--#----#####-------##-##---#---#--#-------#----#---#-#-----#---##--------#-
-#------#-##---#--#-#-#----#-#-###-----------#-----------#---#---#--##-------#-#----###--##--##--#--
--------##---------#-###----#-#-#----------#-#-##-----#--###-----###----#-------#-##-##----####---##
---#--##----#--##-#-#--#-------#----#--#---#--##-###-------#-#--#-#--#--#---#----#--###--#-#--#-#--#
-------#-----------#-##---#---#----#--#-#--#-#--##----##--------#------#--#--#--#-#---#--#-##-#--#--
----#---#-#---##-----------##------##--#--------#--#-#--#-##--###--##-----#-------------#-##--#----#
-#-----#-----###--###----##-----###--##--#-------#--###-#-#-----##----#----###---###---#----#-------
##-#-#----------------------#----###---#--#----#--#------#----#-#----##--#-#-#----#---------#-#--#--
---------#-#-----#--#-##-#---#---#---#---##--#--#---##------#-##-------#---------------#-#-----###--
----##-#------#-------------#----#--#-----#------#--#---##--#-#--#-#--#-##---#-#--#---#-#------#----
---------#-#--####---#--------------------#-#---###-#---#-##----------#--##-#--#-#-#-#-###----#-----
--------##-###----##---##--#--#------#-------#-#--#--------#---------#-#-#--------#--#---------#-#--
