--#--#----#-#-#-#-#-----#----#-----#-#---#-------##-##--##-----#-##-#--#---#-##-#--#----------------
##-----------#--#---#----#--#----#-#----######-#--##-##-#---------#--#-------#---#---##-##----------
----#--------#-#-#----#------#-#-#-###-#-----##--#----#---#-##-#-----#-###-#-#-#--------#-#-------#-
---#-##-#--#--##--#-##-##-#-----#--#-#--#------#-##-####--##-------#---#--#---#-----#---#--#--#-----
-----##-#-------###---#--#--#---#---#--##-----------------##-#--#-###--#------------#-##----##-#---#
#----#-----#-##-----#--#-#------#---#--------#---#-----------###-##---#---#------------#--#--##-----
-----#-##-###----##-----------##---##-##---##---#-#---#-----------------#---------------#---#-#---##
-----##-----#---#-----###----#--#--------#-----#---#---#-------#-#--#--#-----##---##-#--------#---#-
-###-####--#-#-#---#-#------#----#--#-#----##--#-##--##-##-------#-#---####-#--#---#####-#-#--#-##-#
-####-#--##---#-#---#----#-#----###--#---#---#-#--#-----#---##------####-----#-#--------##----#----#
-#--#----#-----####-#-----------#-#-------------#--##-##-#-#-##--##-##-----#--#--#---#--#--#---#----
---#-#-#--#-----#-#--##--#-#------------#--------#------#-###-##-#---------#-#----#-#----------#----
#-###--------#-#------#-#--#----###--#-----#-#-#--###-------#--#--###-----------#-#----#---#-#-----#
-----#-#-#--##-#---###---#---------#--###--------#--##-----##-#-#-#--------##---###-----#----#-#---#
---------#--##---##-----##--##-#---#-##-----#--#--###----------#--#-----#---#--##--#----#-#---------
-#----#----#-------#-#--#-----#-#----#---#----##-#--------#---#------#---#-##-----#--#---#--##--#---
-#----##-#-##-#-#-----------#--###---------#--##-#----#--#----#---#--##--#--#-#-----#--------#--#---
-#--#-##--#-#----####----#--#-###--#----#--#------#-#----#-#----#--##-----##-#-##--#-#####-#----#---
-#------##-#-##--#---#-#--#-#---------#--------------##-##-##-##---#-#-#----#--#-----#---#--#--##--#
--#----##--##--#-#-----#----#-#-##-##-----#-#---#---##------##--##-------#------##-#--##--#--#---###
#--#--##-##----#----#--#-#-#---------------##---##-#-##---#--#----##-###-#-#---------#-------##-----
-#---#--#--#------#--##--#-#-##----#-#-----------#---##-#-#--------#--#------##----###----#--------#
-----#-----#----##--#-----#--#-#-------###---#-#--#-#-#-#---#---#-#--#-----#------#-#-#----##-----#-
--#--#--#-##--#--#---#------####--#---#--###-----#-#----#--#---#-----------#----#-#----------#------
#-##-##--#----#----##-----###--#---#-##-#-#----##---#--#----##--#####---###-#---#-##--##-#-------#--
--#-##-###--##---------##---#------#---#---------#-#-#------#--##-----##--#--##----#-#--------##-#--
#-#--###------#--#-----------##-#-#------#-#-----##-#--#-----#--------#-#--#------##---#------------
-###--#-##-----#-----#-#---#------##--#--------##--#-----#--##-----#-###--##-#----#-#-#-#--##--#----
-#---##-#--#----#---#-----#-----#--------#-##---###---#-##-##-##---##--#----##------##--#---#--##---
----#-##----#------###-#----##---#-#-------####--##----##-#-------#-###---#--#--#-----#---#--#--#--#
-#-##--#--#-------#-#--###-####-#--##-##-#--------#-#--##-####---#--#-###-#-----#--#----#-#--#-#-#-#
-##-#---#------#---------##-----#--#--#---#------###--#-----#--#-####--#-##-----#-###---#--------#-#
-#---#--#----#---#----##------##---##--------###----#----#-#-##-----------###-----#---#---#---------
#--##-#-#---#-#--##-----#---#---#---------##--##------#-##-##----#-#------#-#-#--#-----#---#--#---##
-#-#----###--##-#--#-----##-----##----#-------------#-----#---#-#-#---###--#----#--#--#-##-#--###--#
#--#--##----#--------#-#--------##------##-#--#--#-#####----#-------#--#--#--#---####----##-----#-##
----#--#-#---#--#--##----###-------#--####---#--#-#--------##--#-#--#---###--#------#------#-#--###-
---#---#--#--###-#--#--------#--#---###---#--####--#-#--#---#####-----#----------#---#----------##-#
##--#-#-----------#-----#------#-#-------#--#-##-#--##--------#------##-#----#---#---#-#-#--#-#-----
----#--#----#-#----#---#-#---#--#--------#---#-##-----#-----#-#---#-------#---#----#---#-#-###-----#
#----#---#-----###--#-#-##-#-#--#---##--#---#------------#--##-----##-----------#--#--###--#----###-
----------#----#-----------------#-------#----#---##-#--#--#--###----##-#----#----#-------##-#-#-#--
--##--#----##--------#------#--###-#--------##----##-#------##---##--#-------#----##------###--#----
---------#--###---#--#-------#-#---##----#--##--#---#--#-#-####-#---##-#--#----##--#-------##--#--#-
###------#--#-#-#-#------#---#-#-#---###--#--------##-#-#-#----#-#-----#---#-#-##-----##--#---##--##
#----#-----#---###------#--#-----#-##--###----##----#-#---#----------#----#-#-####-#--###--#-##-#---
#-----#----#-#----#------##---------#----------------#--#-##-#-----##----#--#-###-#--#-#-----##--#--
#---------##---#-###---#----#---#-#-------#-#--##--#-#-#--##-#---#----------------#--#--#---#-#--#-#
#-#-----####-#-#-#-#------##----###-##--##-#--##---#-----#-##-#--##----##-------#-##-------##---#---
--#------#-------#-#----#--#-----##------#--#----##---------##--#-##---#---#-#----#----#--##-#-#-#-#
----#--###----##-#-#----#-#--##-##---#-#----#-#--#-----#--##--#-#-#----##-----------#-#--#----------
#---###----#-##---#----#---#---#--##--##------------#--####-#-##--#-##-#---##--#-##---#----#------##
-#---#-##-##-#-#----------#-##---#---###---#--#-##-##---#--#---#-#----#--#-----#-#-----#--##--------
#-###-#-#------####-##-#----#-#-#---###---###---#-----#---###----#-#--#----######--#-----##----#-#--
--#--#--#-#-----#---##--#--#----#--###---##-#--#----#--###--#---#-----#---#---##----#-#--##-----####
#---#---#-----#----###-#---#-##-#-----##-##----------------##---##--#------------#-----##-##--#---##
-#------#--#-----#--#-----#----#------#--#---#--#-#--#-----#---##---####--#----#--#-#-----##--#--##-
---#---##-#-#-#--------#---##-#----#--------------##-#-------#---------####-#--#----###---#----#----
-----#--##--##-------##------#----#-#-------##--------###------##-----#--#-###----#-#-----#-#-----##
-----#-----#-#------------#---#-#-####--------#----------#---------##-#-#---#-------#-----#--#------
--##-#-#----#--------#-----#-###-##--##--#---##-#-#-####-#-----#-#------####-#--#-#------#--#-------
-#-#-###-------#---#-#--------#---#---#----#-----##-#--#----#-#----#-##-#---#-#-------#---#--#--#---
----------##----##----#---##-----###-#--#------------------##-#---#----#---#--#-------##--#-----#---
--#----#-#--#------#----#-#---#--#----##-----------#--#-#-#---###--##-#--#--#-#-#-##--#-#--##---###-
----##-----#---------##-##----#---#---###---#------##--#-----------------#------#--##------#-##--#--
##--##------#---##-#-#--#--#----------##---#--#----#-#-----##----###----##-##---#-#--#-----##---#--#
----##----#-------##---#--#--##---#--#-#-##-#-#--#----------#-----###--#--#------##---------------##
#-#---#---#----#---#-#-------------------#----------#-----#-----#--##------------#---#---#---------#
-#---#-#--#-#--#---#----#---#---#------#-#--------###-----------###-------##-##----------#--#-----#-
-##-##----------##-------######-##--#--#---#----#---##------#--#---#----#--------#--#--#---#--#---#-
#--##----#####-#-------#-----##-##----###--#----#-------------#---#------###-#-----#-##-#-##-#--#--#
#---------#------------#-#-###--------#----##-#---##-#----#-#---------##--##---#------##--#--#---#-#
#-----#-#---#--#--#-#--#----------##---#-----#-#---------#--#-#--#--------#-----#-----#----##-----#-
-##-##--#-----###----#----#-##-##-----------------#--#####----#--#---#-#-#-----##-##-#-#-##-#----###
##----------#-#-----#--##--##-#-##-------#---##--#--------#-----------##--#-----##--#-#--#---##-#-#-
#------#-#-#--#--#---#--#-##-#--#--#-#-#--------#-#----##-#-#--##----------###--#-#-#--###----#-----
-##---#--##--#-----#---#-##-#---#-----##-------#----###--#--##--#-#---#-###----#--#---------#--##---
-----#--##---#-#--##-#--------#####--------#-#--###---#-------------#---------##---#--#-#-----------
---#--#----#---#------##--#-#---#-##-##-----##--#-------#--#----#-#------#---#-##----#---###---###-#
--#-#-##---###-##-##---#----#--##--###-##---##--#-#--#---#---##-###--#--#-#---##--###----###-#----#-
-----#-##--#-#------#----#-#------#---##--##-#-#-----#-#-#-----#---#--#--------##-----#--##--------#
-#----##-##-##-#----#--#####---#-#-----#--------#--#--#-##---#-##-#-#----------#-#---#--#-----####--
---------------##---#----#---#-#--##---#-##--##---#----------#-#---###-##-------##----##-------#-#-#
--#-----#-##---#-#---#---------#--##-------##-------#--#------#----------#-##----#----#--------#--##
-#-#-#------#-#-#--#-##---##----##---##------#--#---##-----------#--#-#---#----##-#-##-#----#------#
##------###-#------#---#---##--#-#-##-----#--##-----#---#-----#--#-----##------##----------#-----#-#
-##-#-----##-##-------#--------#----###---##-----#-##--##---#--#-#---#-#-------#----------#-------#-
--------#-------###---#---#-------#-##---#---------##---#--#--####---------###---#-#-#--#-##-#-#----
##-#-------#--##----#-###--------#----#-------#####---##-------#-------------------#--####----#-##--
--#-#---#-#-------#--#--##-#-#------------##-##--#---#---##-###-###--#-##----##-#---#--#----#-##-#-#
--#-#-----#-#---#---#----------#-##--###-----------#--##--##--#-#----#-#--##--#----##------#----#---
#--#-##--#------#-##--#--#----#---#----#-#-#--##-##--------##-#-##--#--#-----#---S##-#------#-##----
#--####-#---#-#----#----#--##-------#----##----------#-###------#--##--#--#--#-----##-#-##-#----#-#-
-#---#--#-----#---#-#---#-------#-#-#-----##----#--#-##--#-#--#--#----#----#-##-##-----##-------##--
---#-##--#-----##----#-#--#-#-#---#------#--####----#-#-#--###-##--#--##---####---#-#-------#-##--#-
-#--------#-------------####-#-##---##-----#------#---------##---#-#---##-#-#---#---#---#---------##
-----------#-----------#-----##---#---------####----##----------#---#---------#-##-#-----#---#---#-#
--###-----#--#-##-------#--#-----##---#-#-#---##-----#-#--##-----##-#-------#---#------#-#-----#-#--
--#-------------#---#-#-#--#---#--#-------#--E---#---#-----#-----#---##---#---------#-#--###----#-#-
----#-##-###--------##--#--#-----#-##-------#---#-##-#-#--#------#--#--#-##--------------#-#---#####
