#---#-##------#---##----#---------###---####---#-##-#---####-#--#-#-#--#-----#--#-##-#--#---#---#---
#------#S--###---#-#---#-#-------##----#----#----#----#--#----###-#--#---#------##-----#-#------####
#---#-----#----#------#-###---##---#####----#-#-#--#--#-##------#--#--#-#-#-##---####-----#---#-----
---#--#-#-##------#-----##--#-##------#-#-##-#####----------#---------#---#--#-#--##--##-----##-#-#-
--####--##-------##-----#---#--------#-##--#---#-##-##--#---#--#-----------#---##---#--------##-----
---#--#---#-----------#---###-----#--##--#--#----#----#----#----------#-#------#--------##-#--##-#-#
#--#--##-----##-##--#-##-#---#-#-----#---#-----#-----#-#----------#-----#-#---##-#----#---##-#----#-
-------#---###--#--------#--#-------###-----#--#---##-####-#-#--------#-------#---#--#---##--#-##---
-#-#---------##-###-#--#--#--#--##---#---#--#--##---#-#-------#--#--#---##--#----#--#----------##--#
##---###--#--##----##----#--------#--####--#--#-----------#--#------##-#-#---#---###---#-#--##-##---
#-------#--------------#--#-----#----##---#----#--#---##-#-#--##--------##--#--###-#-#-#--##--#-----
-##-#--------#--#-----#-------------#--#-#--##-----##---#--###-##------###--#--#----#---#-##--#-----
---#-----------#-#----#---#--#-##----#---#-#-----##--------#--#-----#--##-##----------##-##--##-----
--##-#-#------------------#----#-#----#--#-#-##--#-#-#--#------#----#-#-----####--#--#-----------#--
---#---#-------##-#-#-###--#----#--#-----#-##-##--#--#-#----#-#---#-----#-#-#--#-------###-------#--
#--#--###-#--#-#----##--##-------###------#-#---##--------###--------#-#---#------#-###---#-##-----#
-----#----##------#-----#-#-----------#---#-#####---#-#-##-#---##-----##-##---#-#---#---#-#---#----#
--#------###--------#-#----##------###----#--###--#---#-------#-----#-----#----##---#---#--#--##-#--
#-###-----#--#--#-#---#---------###-------#-#------------#-----------#----#--#--#-###--#---#--#-##-#
---#---------##--------#---#--#----##-----#---------#--#------#---------#-#-#--#--##----####---##---
-----#--#----#-#-##--#-###-#---#--##-##--###---#--------------#----#--#---#---#-###-#-#-----####--##
--#-----#-#------#-----##-----#----#---##-##---#-#------#-#---------#---#---#-###--#-----#------#---
---#--#----#---##------##--#-#-##-----#---##--###-----#--#------#---#------------#----#---###----#-#
#-#--###-#-##--#--#---###------------#--#-##-----#---##---------#-------##-###------#---#---##--#---
#-#-##--###-#----#-----#-------#-#---##-----##-#---###-#-#---#----##-----#----#--------#-##-#--##-#-
----#-------#-##-----#-#-#-####----#---##-##--#----#----#----#-------#-#------#-------------#----#-#
------#-------#-#--#-##--##---#--#--##--#-#---#--#---#--##----###--#------#----#--#-#-----#-------#-
#-##-#---#----###-----#------------#-#------#---#----#------#---#----#--#----#--#-------##----#-----
----#---#----#-#----#----##-----#-------##-##--#---###-##----#---#---#--#---#------#----######-#----
---#-##-##---##--#-##------##-#--##-#---#####---#----#-----##-----------#-#-#------#------#-#--#####
#-#--#------##---#-##----#-##---#--##--#-#---------#-----------#--#--#---#-----#-###-----#--#--#----
-#####----##-##----#--------#-----#----#---##--#-#--##-#-###-##--#-##---#--#---#-#---####---##-#----
#-------#-#-#-#---##-#---#--###--#--#-##---#---#---##-#----------#--#----#-#-##--#---#---##--##---#-
#---#-#------##--#--#----#-#----###--#--------##--##-------#-------##--##--#------#------#-#--#-----
-#-##-------------#--##-------#--------#-#--#-----------#------#-----#----#---#---#----#-#-#----#-##
----#--#-----#-#----#--#-#--###------##--##--#------#--##----#--#--#--#---------------#--------#-#--
##---##--#--##---####----#-----#----##-----#-------#-##-----------##-#--##--##-####----#-#----#---#-
##----------#-####---#-#--##--------#--##-------#---#-----##---#--#-#----#-#--#----#-####--#--------
##-#-----##-------#---#---#--##-##---##-------#----##----#-----####--#--------##-#---#-##--##---#---
-----#--###----#----##---#-#-##-###---###-###----#-####-#-#-----#-#--##----#-#-----##-#--#-----#----
#-##----#---#-##-#---#-------#-------###-----#-#------#--------#-#--##----#--#--##-#---###-#-#-#---#
----------##---#-#-#-------#-----#-----#-###-#-#----##---------#--##------------##-#---#----#--#-#--
-#----####------#-#----------#----#---#--------#----#---##-----#---##---#-#--#---#---##-#------#---#
---------#--#-#---###---#-------#--##-##--#----###----#---##--------#----#-#-#-####---------#------#
####-##----#--#-#----#--##--------#-#-#--#-----#-#---#--#-----#----#-#-#-#-##--------#--------#-#-#-
---#---#-#----##--#--##-#-----##----#---#---------#-##----#----#-#--##-##----#---------#--#---#---#-
##-##-#-------#--#-#-#---#--#-------#---##--#-----#----#-#-##-----#-#--##---#-#----#-##-#--####-----
----------#--------##-#-----#--#--#------#-------#---------##---#--#-#-###-#---#-#-#--#-##-#------#-
------###---#----##-#--##---####-#-##---#-#-#-###---#----#-#-#----#--#--#---##-##------##-#-#--#####
#--##-##---##---------#---------#------------#-------#--#--#---------#-#-#---#-----###-###--#-#----#
---#------#-#---#------------#------#--##---##----#-#-##-#--#-##--#---#--##------##-#------#-#--###-
--#---------###-------#----------#-----##-##-#-#-#-----#--#--#---##-----###---####-#-##--#-#---#----
---#-##--#----###---##----##--#-#-###-#--##----#-------##----#--#--------#-##-----#-#-#---##--###---
##-----#--#--#-#-----------#-----##-#--####-##----#-----#--#-###-##-##-#--#-#--##--#-##-##--#-------
-#--##------#--#-#--##----#--#---#-----##---#-#-----###----#-#--#-------#--##-----#-##-#-----##-----
#--##-##---#-##---#-#--#-###-##-----##--#----#-#-----##--#-----####----##----#-#-#-#-------#-##--#-#
-----#--#-#-##--------#---------#---#--------#---###-----##--#---------#--#--#-#-#---#-------------#
-#-------##---------#-#-#----##---------------#----------#--##----#------------##-####---##--#---###
----#-###-#--#-#--#--#---#-##-#--#-###-#---#--#------##-###-#----#----##-###-#-----#---#--#--------#
-----#-----##-#-#-#--#--###-#-##------#-#--#--#--###-#-##--##-#-#--#---#---#------#-----#--##------#
----###---#----#-----#-#---#-#-###-#-#-##--#--###----#---#--------#--#-----#-###---#----###-#-----#-
#--#-#---#--#--------#---#--##-#-----#-----#-#-#-#-##-#--#-----------#-------##-##---#--###----#--#-
#-#---##-----#------#----------##-##-#--##----------#-###-#-#-#-----##------#--##-----#--#-##--###--
-##--#---##---#-##-#-#-----------#-#-----#----#-#---##----#-#--#-###-------#--##---#--#-##---#-###--
#--#-----#---##---#-##-#---##-###-#--#---#-#----------#--###-----#---#----#---#------------##-#--##-
---##---------#-#--#-#--#--##--#--####--#--#------#--#-#---------##-#-#--###---#--#---#---#-#-#--#--
-#----##-#--##--#####----###--#-#-##-#-#-#--#--##-##-#-###---##-##---#-##-##------#-----##---#----#-
--#-#-#--#--##--#-#-#--#--#--#-###--------#---#--###---------------#--#---#---#-##-#---#---#----##-#
------##-#--###-#---#-##--#----######--#---##--#--#--#--#----###--#------#--#-----#-#-#-#-##--##-#--
##---#-#-----#-#------#--#--#---------#--##--#----#-#-##-#--#-----#----#-#-#-#---#---##-######------
--#-###----#---#-#-#--#---###-##-#-------####-----------------##---#---#---#-##-------#--------#-#--
---#-----#-#-----#--#---###--#-----------###---#-##---#--#--#--#-----------#--#--#-#--##-----#----##
--#--------#-#-#-##-#-#-#----#----#---#-##E-----#--###---------###-#----------#-#--#----#---#--#----
#-##-##-#--#-------------###----------#----#-----##------#-#---####-#--#-----#--#---#-------#------#
-#--###----#----#-#--#-------#-#-----#---##--##--#-----------------#-#----##---#----#---------###---
----##-#-##---##--#------#--------#-##--#------#-#---##---##--#----##----#-----#--------------------
----------#--#-#---##-----#-#--#--#---#-##---------#---#-##-----#---------#----##--#------#-#----#--
--##-##-------#-----#-####-#---##-#-------------#-#----#--#-------#-#-##---#-----#-##--#---##----#--
-#--#------##-#----#--#-###----#----###-----#--#-#---##----#-#---#--##--##--##--#-------#--#-#-#----
-----#---#---#-----#--#-#----##-#-#--##---#---------#-#--#----###-#-----#-----##--#-#-------#---####
##-#--#----#-#-#----#-----#-----#####-#-------#----#---#--##--#-#-#-#---#-#--#----##---##--#--##----
---#------#-----#----#--#---------#----#---------#------#-##-#--#--#-#-----#--#-###--###-#---##--#--
#---##-##-#-#--##--#-#-#-#-----##------#-#-----#---#--#----------###----##-------###---------------#
-##---#--#-##---##---##---#----#-------#----------#--##-#------###----#-##---#-##---###-#-#-#-#----#
#-##--------#--##--#-#----------##---##--#-#-#---##----#--#--##-#-------#------------#----#--#-#----
-#-#--#---#---##----##-------#--#--##--#----##-----#--------#--#------#-##-----#-----##----###-#--#-
#-----#--##--#----#--#------#------##-##--#----##----#--#-----------#-#-----##-------#--#-----------
#---#-#-#-##-#-##------#----##---#--#--##-----##--##--#-#----#-#-#--#---###--#------##-#----#-------
--#-#-#--#-----#---------#-----#--#--#-----#----#-------#--#--#---#----##---#---#-#----#-----#-###-#
--------#--#-----------#-#-#--#-----------#--#--##------#------##-###-##---#--#--##-#---##-#--------
####--#------#-#---#---#--##-##-----###-#-#-------##-------#--#-----#--------##-#---------#---#-----
-#----------#--------##---#-#---##-#----#-#------#-#------#--------#---#-----####---#--#-#-#-#---#--
-----##--#-----#-#-##----#--#-#-##-----##----###-#----#-----------#----------#-----#-#-------##-----
--##-----#---#-#-----##--------####--#--#--#--#---------#-#-------#--#-#-#------#-##----##--#------#
-#--##-##--#-##---#---#------------##--#----##-#-----#---#-------######--#-#-----#--#-#-#------#----
---###-#----#-------##---#--#---#-------#-----##----#-#---------#-#-####---#-#---#-#----#-#-----###-
--##--#-#-#-#-#---#----##---------#--#--##---#-##-------###----------#-#--#----###--------#-#---#---
--------#---#--#------#--#-#---##---##-#-----#-----------#-#-----------#---------##-#--#------##---#
-#---#---#-#--#---#---###----#-#-#--------#--------#-----------##------###---#-----#--#--------#-#--
---#---##-----#-#-#--##-----------##------#-###----------###--------#-#--#---------------##--#--##--
