--------S##----------#-##-----##-#--#-##-----##----------#----#----#------------###-###-###----#-#--
--#--###--##----#--####--#-#----------#-----#--------#-#-------####---#------#-#------#--#---#-#-#--
-#----#---#----#----#-#--#-#---###----#--##-----#--#----###--#--#-----#-#--#-#---------#---##---#---
#--##--##-#-------#-#--#--#-#--#----#----#-#-###--##----##----##--------##---#----##-#----#-##--#---
--#-#-##-------#---#--##----#-#-#-----#-#-#--#-#---##--#---##--##---####-#----#-------#-----#---#---
--#--#------##-#---#----------##-----#----#-#------###--#--##-##--#----------#----#-#-#-#--##--#----
---#-----------#---#-##----##------------#---###-#--#-------##--#------------------#-----#------#-#-
----#-#-#------#---#---#-###----#--##----#---#-##--##--#------#---##---##--------#--#-#-###-#-#-----
-#-#--#-------#--#-#-------#-----#--#---#-#---#------#-----------#----#-#--#----#--#-####---#-#---#-
-##---------------#--###-#-#------#---------#---###-#-#----#----##-----##---------------#--#-##-----
-#----#---#----#--#--#-------#----##----#-#----##------#----------###---#-------##--#-----#-#-##-#--
#-----#------#----#-#------#----##-##-#--####------#--------#--##--##-##--#-#----#--#-----#-###-#---
--------#-##--###--###-#-------#-###---#-------#-----#-#---#-#---#------###-------------#--##-------
---#-------#-----#------##-##-#--------##--#-----#--#---###-----#-----##----#--------#--#-#-#-#--#--
----#-#-#----#-#-#---------------#----##--------#--#---##-#-#-#-----#-----#--#-------##---#-#--#-###
---#-###-#-#-##-#-#-#-------###--##-----#----------#--#####-#----#--####----##--##-----###---#-#-#--
---#---#-----#------###---###---#-##---#---#---#-#--------------#---#--------##---#--#--#---#-------
#--##----#--#-------#----#------#--#--#-##-------#---#---#-###----#-###----##-####---#-#-#---#-#-#--
###--##-----##---##----##-#----#--##-----#----#-##----#-#-##--#--#--#####--#----#--####-##------###-
#--#--#--------------#---#----#---#----###---#---#---#-##---#--##--------------#-#------#-----##----
-------#-----------##--##-----#-#----#--#-----#--#-#--#----#----#---##-#-----####----#----#-##----##
-----#-#-#---#----####---#---###---#-------#-----####---#---#-#--####--------------#--###---##------
#---#---------#-#----#-##--#--#-------#----#-----#----#--####-##---#------#---#--#-#-#------#-##--##
----#--#-------#-#--#---##-------##-----#-------#--#--#-----#-#--##--#-#-#--#-#--###-###--#-####-#--
--#-#-#----#-###-----------#---#-----#-#--#####------##-----#-##----##-#------#####-#-#-#------####-
-----#----###-----#--#-----#####----------#-##-#-#----#---#-#-####----##------------------#-###-----
------#-##------#---#---------##---#--#--#-#--#--##--#-#-----#---------#------#---#-#---##---------#
--------#-##---#--#-#--#--#-##-#--------#-----#-----##---#-#------#-------#--#---#-#--#-#--#---#----
--#----##-###-#-#-----##----#-----#---#---#---##-------------#-----------##--#----#-#--#--##--------
-----#---#-#------##---##-##-##-----##-#--#-----#-#-#----------#----#--------#-###---#-#--##---#-###
----#-#-###---#--####-#-#--#--#------#--###--#---------#----#------##-------------###--#-#--##-#----
--#------###--#----#------#--------#--#####--#--#------##-----#-#---##---#--###---#-#---#-#--##----#
-#--#--##--------#----##-#-#------#-------#---#--#---------#--#-----#-#---##----#----#--###-#--##-#-
##---#-#----##---#--#-##-----##----###---##-----##----#-###--##------#-#-#-------#------#-------#-#-
---#--#-----##----------#-#-#-----#-##----#----#----------#-----------#-##---#-#--------#-----------
-----#####-#-#---#--##--#---##---###----#------------##--##-#---------##---##-#---####-#--------#---
--#--------#---#----#---#-#-#-----##---#-----##-###----------#----####-#-##--#------------#-------#-
###-------###-----------#--#-#-------#--#-##-----#-##---###-#---#--##-#--#-#---##--###-#---##--#---#
--#-#---#--#-#-#---#-##-#-----##-#-#-#---###------#--------###--##--------#-#-##---------#-#--#-----
--#--#-----#--#-#--##---#-------##-##-------#-----#--#---#----#-##-#---#-#-----------#--#--#------##
------##-----------------#--#---##------------#---##--------#--#-----#-#--#-------#-#---#-#-##-#-##-
-#-###--#----#-#--###-#-#---##--#-#---#--#---##--------###---#--#--##---##-#--#-#-----#---#-##-----#
-#---#--###-##----#----#------#---#---#---#---##--##----#---#----#-----##---#-#---#----#---#-#-##---
-------##------#-------#---###-----##------------##-##--#####--#--##------#----##--###--#-#--###-#--
-#---#--#------###--------#---##---#-#---#--#-----##--------#--#-----#----#--#----##-#---#---#------
-##-##-#-#-#--#####-#---##-#---##---#-#--##-----#--#--#--------------#-----#-----------##---#-#----#
--###--#--#-#-#-----##---#----#----#---##-#---#----------#-----##----###---#-#------#--#-------#-##-
---#-#----#---##-##-----#--##----###------#------#---#---------##---##---##--###-#---####-###--#----
###-#-#-#-#--#####----#---#-#--##-#####-----##---#####--##------#----#--#-##-#---#------#-#-----#---
-----####-#------------#-##-#--#----###----#---#---------------#----##---######------#------#-------
-#---##--------##-#---#-----##---##------#--#---------#--#-##---#--####----#--#-#-#--#-#-#--##---#--
-----------#-#---#-----#-----------#---#---------#-#-#-----#-----#--#-----#-#---#--##------##---#-#-
--#-##------##----#-#---#------#--##-#-#-#-#--#-##--#---#--------#---###-#-----##--##-##--#-#-#--#--
--#-##----#-#-#-#--##-#--#---#----###--##--#-#---#-#-------#-#-------#-#-----##-#--------#-#-#---##-
--#--#-----#-#-#-#-##-#-##--#-#-#-#-##-#--###--##-####--#---##------#--#---#---#------#----##-----#-
-----#-------#-#---#---#-#---#-###-##---#-#--#------#-#-----#----###-#-#-#---------##----##-------##
-#---#----#--#--##---####-##----##-#-##--#---------#--#------#-#-#-#--#-#-#--##--#---------####-----
-##-#----#-----------------#--#-----##---#--------#------##---##--#-####--------#--#-----#-----#----
-----#--#--#-#------##-------#--#----#--##---#---#--#------#-----------#--#---#--#-#-#-###-----##---
-----#----#--#-------#--#---#-#-####---##-#-##----#---#-#-#-#---------#--##-##-----#---#-----#-##-#-
#-----#---#-##-----##-###----#--------#---#-#--------##-----#-#----#--------#---#----#-##--#--#-----
--##-#---------#--##--#-----#--#-###-#--#------###------###------#-##-----#----####-#-------##-#--##
-#--#-#-#-----#-####--#----------##--##---#-#-##------##-----#----------#---##----#--------#---##---
-##--##--#------##---####--#-##-----##------#-#---##-----#---#---#---------#-----#-#---##---##-#----
----#-----###-#--#-------#-----#--#---#----#-#------######--#--###-----#----##-------#----#-####-#--
--##----#-----------#--#--#---#-##------#--#-#-#-----####-#--------##-#------#---#-#---###------##--
-##-##-#----------#-------##--##--------#-#####-#-##---####--#-#----#-###--####-----#--##-----#-#-##
-#--------####---------#-#----#-#--#-------#-#----------------------#---------#--#-#---#-#---------#
----------------##------#---##-#----#----#-##-----#----#---#------#--#----#---#---#---###---#---#---
-#-#-#----###-#----#--#--#--#----#-##-###----#---------#-#-####--#-#----#-#-------#--##-#-#-------#-
##--#----#-#--#-----##---#-----------#------##--#-#--------#-#-#-#-#-##-##--##--##---##--------#----
#-####--#--#------####--#--#-#-#--#----#-#-#-----#--#-#----------#--------------##---#----------#-#-
-##----#---#-#-----------###-#-######---###---------##---#--#------#--####---###---#------#----#--#-
----##--##-----###--#--#-----##----#-#---#--#-#----#---#-----#---##---##--##-##----------#-#----#---
--#-----#-####------#------##-#----###---#---##-#--------#----#----#---#-#----####-##--#-----#-#-#-#
---#---------##----#-------##------#-#-##-----#-#--#----#------##-#-##------###---#--###--#--#---##-
-#--#-#-----#---##-#-#-#--#--#--#-#---#--##-#---#-#-#--#-###-#------##-#----#--####-####-#---#--#-#-
-#--#--#-#---#-##---#----#-------###-##--#-#---------##----#-###---#-##------#-----#-#-#------#-----
-#---#-####-----#-----------#-####-----#------------------#---#------#-#--##-#--#-#-#-#-#----#--#---
--#####----###-#--#----#---#-#-#--#----#---#---#--------##---#--#------------#---##-#---#-#--##-----
#--------#---#---#--##--#----##------#--###-##---------#-##----------------#-----#-#-#----#------##-
-#-----#-------#--#-#---#----##-#----#--#------#----------#-----#-#---#---###---#--#-#---------##-#-
-#-----#-------##-#-###----###------#---##-#---#-----###----#--------#-#--##--------##---###-#--##-#
---##-##--#-#-##-#-#-----#-#-#-#---#----#----------#------##-#-#--#-#--#-----#-#---#-----#-##------#
----#-----#-##-#--#----##--#----#------#----#---#---#-#------#---#-----#-----#----#-#-----#-#-------
--##----#----#---##----#----#-----#-#--##-#--------#-#-#--#--#---#---###---##--#-#-##-#-######-#-#--
#--##---#-#--#--#------##-#--#--#--##-----##---#---##-----#--##--##-----##-##-------------------#-#-
---------#-#---------#-#---#--#-#-----#---#----#--------##---###-#--#-###-#-###---#-----#----#--#--#
-----#-##----#-##---#-------#---#-----##-#-----------#---##-------##----------#--#-----#--#---##---#
#-#-####------------#-##-#---##---#----#--##-#---#-#--##---###--#---#----#-------#-#-----##--#-----#
#---####----#--#---#--####-----#--####------##-##-#-##---##--------#--#-#---#-##-##-----##---------#
#---#--####-##-----##-#---#--####-----###--###----#---#-----#-----#-#-###-#--#-#-###--####----##---#
---#------##-#####----######-#-----#--#--#---###-----#-----##-----##----####---##-#----##-#-#--#----
#--#-##-------#------#-#----#----#---#-----#--#---#------#--#----#-----##--#-#---#-##-#-#-#--#--#---
----#---#---#----#----#----#----###-##--##------##-##------#---#---##--------##-#--#---#--#--##-----
--#-#--#-#-#-#--#-#----#----#----#-#-#--#--##-----##----##-------##-----#--------#-#-----#------#---
---#---#-----#----#-#---#--#----#--#---#--#-##--#--##-----###-##--#------###--------#--------------#
#--#---##-------#-----#--#----#-------#-#------#####---#--#---#---E-#-#---#--#--#--#--##-#--#---#---
----------#-------#-#--###-----#-##-----#--------#--##-##-####-#--#----#-------###-------#-##------#
---#----##----##--##---#--#--#-#---#-#---#-----###---#-------#----##--#-#-##-#-----#----##--#-------
