---#--#----##----##-#-------#-----#-#-##--------##-#--#--###-#---#----#---#-----#-#---####------####
--##------#--#------#------#-##--#-#---#---#----#--------##----#-#-----##--##----##-------------#---
--#-##----#---###-#---##----#---#---------#----##---#---#--#------##-##---#------#---#-------##--#--
----#-----#--------##----##---------######----###-----#---#----##------##---####----#-##-------#----
--##-----##----#-##-#------#-##----#####-#-----###-#-#--------#--#---##--#-----#----------#-###--#-#
-#------##--------###-------#----#---####--#----#--#------##-----#-#---#-#-----#---##-#-#-----------
-#--#-----#-#--------###-#-----###---#--##----##---###---##------------#--#--#----------##----##--#-
---#---#---#--##---#-#--#-----#----#--#-#--##-#--#---##-----###-----------##--------##-#--#-----##--
-#--#-###---------------#---#--###-#--##-#------#---------#-------###-#-#-#-#-##----#-#-#--#---#----
-#-#-####-#---------#-#--#---#----#-##----#--##----#----#-----##--#-#-----##---#-#--#-#-##--#-#-#---
###-#-#--##------------#-----##--###-#---##--#--------###----#-#-------##---#----####---#-##-----#--
#--#-##-##-#--------------#--####----#---#-#---#-#-----#-##--#-#--------#-#-#------#--#----#--##---#
--#-#-#-#-----#--###-###-----##----#----##--#-#---##------##-#-#-#-##-#---#--#-#--##--#--#-#----#--#
-----###-----###---#-------------##-#---###-##----####-----#------#--#-#----#------###-##-#-##-#----
#---#------#----##--#--#---#--#-#-#####---#-------##-----------###--#----####----##--#-#--##---##-#-
---#-##--#----#--#------------###-#-###------#---#------#---#-##-----#----#---#--#--#-#---#--#--##--
-------#--###--#-----#-###----#-----###--------------##-#--#--##---#-#-#--#---------#--#--#---------
---#---#-#-##--#---------#-----#---#--#----------#-##-----#-#--##------#-----#-----#-#--------------
##-#---##--##-##----##-#-#--###-#-#-#---#-------#####-----##-#--#----##-#-#--##-##--#-#----#-----###
##-----#-----#----####-#-#-#----------##--##---#----#--#---####---------##-----#---#--##-#-#-#----#-
---#---##---#---#--#-#-##------##---#---#--##---##----#-#---##--#--#--------#--####-#-#--#----#-----
------#---#--##-#----#----#--##-#-----------------#-------##-#--#--------------#--#--#------#-----#-
---#-------------#--###---#-##--#-----#---#####---------##------------#-#-##--#-###------#-##-####-#
----#--##--#-####--##--#------#---#--#--#------##--##--#-#-----#-##-----------#-#-#-##----#--###---#
#--#--#----##--#--#-----##----#-###---#-#-----#------#-##------#---##-####--#-------##-##----##-----
-----#-----#------###----#--#--#--##-###-#-###--##----#-#--#-#--#--#-----#----###-#-##----#-#--###--
#------------##-#-#----###---#-#---#-#------##--#-------------#-####--------###-#--##------##-#-#-##
---#--#---#-----------#----###---------#-------#-#-----#------#------#-#--#---#-##-#-##-#-----#-----
--#---------###----#-#----#-#--#-##-#--###---#-#--#--#-#-#--##--------#----#----#-#-#---#--#-#-#-##-
----##------#-#--#--#--#-----#----#--#--#--#-#--#---#---#----#--------#-#---##-####----#-#--#-##----
##---##-#------#-#-#----#-----##----##-#----#-#-#----#-#----##------#-#-#--------#----#----##--#-#--
##--#---##-#----------##-#--##-------#----#--#--------#--##--##--------#------------#--###--#----###
----#-------##---#---#----####----#----#-#--#####-----#-----------#--#-#---###-#--#---##---###---#-#
#--#--##------------------#--#--#---#-##-##-##--#-#-#----#----#---------#-----#--#-##-#-#--------##-
-##---#-###-#---#--#-----#---------##----###--#-##----####------#--#------#----------------#-#------
-##---#--##----#-##---#-----#--##--##---#---#-#---#--------------#------#-----#-----#-#---#------##-
#---#-#--##-###--#--#-#---##--#--##--------#--#-#-#----##-#---#-#--#--#-#--#----------#--------#----
#-##-#-------###----------#-#-###-#------#-----#-####--#----##--#-----#--#-##----#-#--#-#-##-#---#--
--#----#------#----#-##-------##-----#--##--#-#--#-#-##-#---##---###-#----#------#---#---------#-##-
------#----#-#---#-#-#-##--#-#-#-#---------#---#------###---###---#------##--#----#---#-----#-#--#--
-#---#-##--##-##------#----#----##--#--##-#-#-#-#------------##--#--------#-#-#----#---###-#-----#-#
---#---------#--##-----#-###---#--------#--##-#---------###---#---#----#------#---#------#-##-----##
------#-##--#----#----###-#---#-###--#--#---#-----------##-##-#-#------##---#-------#---#-#-###--##-
-#---#-#--#------####--#---##------#-----#-----##---#-#---###-----##---#-------#-#----#-#--#-#---##-
---#------##-----#--#---##--#--#-#---E--#-#--#---------#-#----#---#----------#---#----#---#------#--
--#----##---#------#--##-##---###-----##----#-----#--#---#---#-##-------##---#--------------#------#
---##----#--#-------#-##-###---#-#-------#-----#-#---###----#--#--###--#-------##-###-#-#-------###-
---#---#-#--------#----#--#--#--#-----##--#-#-----##--#----##-#####-##-#-#-#-#----#----------#------
---#-----------------------#--#-----#---###----#-------#--#---------##-------#-#---#--#---#----#-#-#
##-#------##----#--#--##-#-##-###---#-#------#-----#--##-#--#-##-------#--##---##--#--##----------##
##-###-#------#----##------##-#-##-##-#---#--##----##------#--##-####-#-####---#----------#--##-#-#-
--##----##------------#-#--###-#----------#---##--##-#----------#---------#-----#-#---------#------#
#--------#-#----###--##--------##---#--#-##----##-#---#-#---#--#-#-#--#----#--------#----#--###--#-#
--#-#--####--##--#--##--##--##-#---#-#-----##-##---##-----------#---###--#-----#-----##-#-----------
-#-----#-----#----##---##--#--#--##----#--#------#-#-#-#----#---###------#--###---##-----####---#--#
--------#-##-----#---------#--##-#-###------###-#--#--#-#-----#---#------##-------#--------#----##-#
#-#-##-----#------##---#-#----------##--------#---#----#-----##-#---------##-------#---------##-----
----#----##-----##-#--#---##-#---##--###-#-------#-------------#-#-##----#-----#---##-#-----##-#-###
--#---#---#----#-------#--#-##-----#----#------#-#--------##-#--#---#----##------#----#####-##-##-#-
-#-#S-----#-#------#-----#-------#-##--#-##---#---#-#---##-----##-----#---------#-#-##-#------#-#--#
---#--#-#---#---##----#-----#---#-#-------------------#-#------------#---#--#---#-#-###----#---#--##
#---#----##----###------#--#--#-####-#-#-----#-#-----#-#-#-#---#--------#--###-#-------##-#--#------
---#-####-#--#-#----#--#--#-#-#-#--##---###-#-------#--------##--------##-------#--#-----#----#---##
#---#---##---##-#-#-#---------#----#-#--#--------#----#--#-#-----#---#----------##---#--#--#-##-##-#
#-#----#---###----#--##------#-#---#--#-#-#----#-##-##-----##------##--#-#----#----#--###---#-----##
--------#---##----#-------#-----#--##------#-#-#--------##---#--#---#---##-#-#----#----###-#-#--#---
--#-#--#--#--#------##---#-----#-#-##--#-------#-#-##-##--###--#----#-#-#-#----##-##----------##----
###--###----------------#-###--#--#---##----#------###------#--##-#-----#-#-###---#--------#-------#
##-##-#------#---------------#-----#-#-#-----#---#-----###--#--#--##-#-----#----#----------#------#-
#-----#---------##--##---#---#--#---###--#-----#--###-----#--#-#---#----##---#--##-##-------#---#--#
-#---#----##----####----##-#---#--#-#-##--#---##-----#--#----#-------#---###----#--#-###-----#---#--
----#---#---#-------#---##----------##-#--##--#----#----#-#---------#---#-----#-#-##---#--##--#-----
#-#---------#-#---#--#-------#-#------##----------##----##--##-------#------#-##-##-----#--#-##-##-#
-#-#----#----###-#----##--#-#---#--#-#--#-#-----##-##------###----#--#--#--------#-------##----#--#-
#--#-#-#-----#-###-#---#--##------#-#----#----#-##--#-#----#---##-##------------------##--####-#--#-
------#--##--#--##-#--#-#-#--#----------------------#----#-------#----------#----------#------#---#-
#-#-##-#-------##-#--#-----------#-------##-#--------#-###-##-#---------------##------#-----####--#-
-------#-##---#-#-###-#------#-##--#-#--------#-#-###-#-----#--##-#----#--#-----#-#--####----#-----#
--#--#-#-#--#-#--#---#--#-----#---#-----##---------#---#-#--#--###-----#-----##--##--###---#--#--#--
-----#---#-#---#--#--#--#---#-----#--#---------#-----#-#------#--#-#-#---#---#-----#-#----------##--
--#--#-----##--#--##-------#------#-##---######----#---#--#---#--#-----------#-#------#----------#--
##-##-###--#-----#-----#--#----#----#-##-#------#--##-#---##-----##-#-#----#-##-#-------#--#-#----#-
#----#------#---#--#---###-------##---#-#-----------#---#---------------#------#-#------------##-#--
#--##------###----##---------#-#-#--#-####----#---###------#---#-####-#-----------#--#-##-#-#-#-----
#-####-------#-####---#----#----#-#-#-#--#-----#-------##-###-------#---#---#-#--------#---##-#--#--
#----##----#-#--###-#----#-------#--#--#-------#-------#--#---#--#------##-#-#-#-##-#-##----#-----#-
--#---#---#----#-####-#---##--###-------#----------#-#------#--#-#-#----#-#-#--#-----------###-----#
--#--#-##--#-#--#---#-------#-##---###---##-##----#---------#-##-###--#--###-#--#----#-#-#-##-------
#-#-----#-#-------#----#-##-##--#-----------#---#-----#----#--#-#-#--##--##-#-##------#--##-----#-#-
--##----------#----#-#-#-##-#---#-#-###----#------#-#-##--#----#-#--#--#-##---##---#--###---#---#--#
---------###-#---#----#-------##-###-#------#---#--------###-----#--------#--------#---#---###-#-#--
--#-#-----------##-###---#----#--#--#-##----#-#---###---#--#--#------#--#-----#-#---#-#-##-----###--
-##-----##----#---##---##---#---#--------#--#--#-#-#-#-#----##------##----#-----##-#---#-#-#---##-#-
--#-------#-#---##--#-#---##-##-#--#--##--###-----------#--##-###--#-------#-#--------##---#-##-#---
--#-##------##--#----##-#-#---#-#--#---##-----##-#---#-##---#-----#---------#--##-#-##--#-#--#--#-#-
----###------##---------#-##--#--#------#--#------------------#----#----------------#--#---#--##----
-#--##-#-#---------#-#-#-#-------#-#--#----#----#----##---#-#-###----###-#-#-#--#-----###--######--#
------#-------------###-#--###--#-##-##----#--#----#-##-##-#-----##--##----##-#----#-##-##--#-##--#-
--#--##--#--#-##----#-#---#-#-#------#-------#####--------#------#------#--##----------#-#-----#----
-------#--###--##--#-----#-#---#-##----#--#---#--###-------#-----#---#---#---------#-----#---#-##---
