-###--#-##-#----#-#----####---#-----#-----###--#--#-#-#-##--#-#--#-----##--#-#-#-##---##--#--##---##
-##--##--#--#----####---#--#----##-------###-#-#----------#--#-#---##--##--#--#--##-------##--##---#
-##-###-----##-###--#-#-#-#-----#-#-----###-----------#--#-###-#-#-#-----##-#--#--#--#---#-#---#-#-#
----##----#-------------#---##----#-------#---#-----#-##----##--#------##-----#------------#--##---#
-#----#---##--#---------#-#----#--#--##-##-##-#-#--#--###----------#-----#---##--##---#-#-#-#--###--
-----#--#----#---#--##-----###-----#---##------#---#-#-##----##---#---##-#---#---------##--#-#--#--#
-##-#--------#-##-#---##----###-#----------#------#---##--#-#-#--##-#-##-----#------------#---#--#--
------------------------#-#--#---#-#---##-#-#-----#-##-------#---##-----##-#---#-##-#-#--#--#-#--#-#
-#-#--#--#-#----##-----#-----------#---#-----#-#-##---#----#-#-#--##--#---#-##---###-###--#-#-##----
---#-##---####---#---#-#------------#--#-#--------#--##----#-#---#####---------#-#-#--#-----#---#---
-#---#-------#-#-#----##--#-#--#--#--##--#---#--#----------------#--#--##--#------#-#------#-------#
#-###----#-#----------#-#-##-------#-#--#---#-#--#---#-----#-#-#-#--#---##--#----#--#---##--#--#----
----------------##--#---------##---#-#-----#-#------#-##---##---#----#--##-----#----####E--#--#-#---
#--#--#-----#-##------#---#-#####-#--#--#-##--#-----#-#-##---##--#--#--------#-#------#-###--##----#
-#----###----##-----#--##--#-----#-----###-#-#---##-##----#-#-----##-#--#---#--#---##-#-#--##------#
##--##--#-------------#-#-#--#----#-##--------------#-#--#-#-#-####----#-----##--#-----#-----#---#-#
##---#--#--#---#---##-##-#---###-###------#-#-#----#-#-#--####---------#------#-#-------##--------#-
--#-#-#--#-#--#---##--#---#---##--#----#-#--#-#-----#-----##-#-#--#-----###----##----##-----#-#-----
#------#-##-#--#-----#-----#--##---------#-#-----##-##---####--------#--#--#--#-#--##--#---####-##--
##--#--#-#--##----#----------##----------#-----------#--##--##--#----#-#---#---#-#----#-##-----#--#-
---#--#-#-#--#---#####---#---##---#--#----#------##----------###----##-------##---##--####--#--#-#--
---##---#-#--#--#--------##--------#--#------#--#----------#------#-#-#-----#-----#--#--#--#--------
#-----#--###---##----##--#--#---#-#-#-#-----#-#-#-----##--#--#---#--#--#------------#--#--#--#--##--
#----#--#------#-#------------#--#--#-###-----------------#-------#-#-#---#-##------#----#----------
-----##--###-#-#-----#-#----#-#--#-##----#----#-#--#--#-##-#--##-#--#----##-#-##------#--#-#------##
---#------##--##----#-#---###-#----##--#---#---###-----#---#-------#--#-#--#---#-#--------#---##---#
---------------###---#-#--#-##-##--#--#-#-----##---------#--#--##-##--#-----##-----#-#-#--###-####-#
#--#---###--#-#-###-----#--#-#-#----#---#-##-#-----#--#------#-----#-#---#--#------###----#-----#---
#-##----#-#----------#--#-#--#-#---##--#---##--#-#-----#--##----#-#-#--#------#-#--##-----####--##--
#--------####-#---#--#--#-##-#--#--#-#----#----##-##----###--#-----#-------#--#--#-------#--#--#--#-
--#-----#------###-----##---#---#----#--#---------#----###--------#--#-#----#-----#----#-----##--##-
-##----#--#------##------###-#---##---------#----#---#---#---##--##-#----##---------##-------##-----
------####-#-#-------#---####---#--#---#---#---#-#-----#--#-----#-#-----------###-------#-#--#-#-#--
#--##--#--#-------##---------###--#--#-#--##-----#------#--##----#---#-###---#--#----#----#----#----
---#------#---------#---#-------##---#-#---#---#-#-------###-------#-##--#-##-------------------##--
---##------#-#-##----#----#---#--##-#--#--#--##---#---#--#-#--#---#---#-#----#-#-##-------#-#--##-##
#--#-----------##---#--------#---------##----#-##---##-----#----#--##-----##-#-----#--#---#-#---##--
-##-#---#----#----#--#--#--#--------#--##-#-#####-#----#-#---#---#--#-###-#-##---#---------------#--
#---####-------#-----#---#-#---#-#------#--##-##-#--#-------------###-----#--##--#------#--#--#-#---
-#-----#--#------#--#-----#-#--#--##--#------------##---------#-------##----###----#-----####-##--#-
---#--#-----##-#---#-##--#-----#-#-#---#--####--#-#---#---##-#-#----#----#-#-------#-##-#--###---#-#
#--#--#-#--#--#----#-#-------------#--#--###--#-#-#-###-##--#-----#-----#-#---##-----#-#-#--#--###--
--------#------#----#-#-----#----#-#-#------##-#--##--###--#-#--##----#-#--##----#-----##-----------
###-#-#------##---#-##--#---#-#-#-##-----#--##--------#--#--#-#-##--#-#----#-#-#---#-----##-#--##-#-
#-----##-##--#---#-------##--##----###---#-#--###-#---###---##------#-#-#------#-#----#----#--------
##---------##----###-----#--##--#----------###----##--#####----#---#----#--------####-#--##----#-#--
---#--####-#----#-#####--##--##---###--#-#--#--###-#--#-###--------#--#-#----#---#--#----#--------#-
-##----##-----#------#-#----###-#---#---###-#-#-----#----##---#-#-----#---##-------#---#--------#---
#------------------#-----#--------#---#----#-#---#--#----##---#-#------#--------#-##--#----#----###-
----#----##-#-#-##---##-----###-#---#-#-#-------###----#---#--#--#-------##--#--------##-------#-##-
------#-##----#-#---#----#---#-#---------#-------#--#-#-##------#-###----#---------##----#-#------#-
-----###----##-------##--#----#---#--#-#--#-#-----#----###------##-------------#-#-#------##--#--##-
--#----#---------#-----#------#--#--#-----###-------------#----------#--#-------#-##--#---#---------
-#--#---#---###----##--#---#--#-#-----###----#-#-#-#--#-##-#--#---#--#-----###----####----##-##----#
-##--#-#--------#--#--#-#-#-#---#---###-#---#------#---#---##-###---#--#-#--#------##------##------#
--##-#-#---#-#---#-----#--#---#---##------###-------#####--#-#--#------#---#-##--###-----##----#--#-
------#--#-#------#--###----#--------#--##-#-----#---##-##---#-------#--##--#---##--##-#---#-#---#--
-----##-------#----------#-----#---#-#---##-#--------####--#--#---#-#-#-#------##----#----#----##---
#--#--------#----#---####-##---#---##----####-#-##---#-#--#-#--#-------------#-#------#--#------###-
-#-#-###---#---#---#---#----------#--###--#--###----#---##---#-------#--#-#-#------###---#-#----#--#
--##-----#---#---##-------##-----#---##---#--#-#------###----#--#--#-##-----##---##-###-#-#--#------
-#------##-------#----#---#---##---###-#-#-#-#--##------#----##--#-####-#-#-#-----#--#--------###---
##-#---#---##----#---#--#-#---#---#-----###-###-##---###-#----###----------##-----#--#-#-----#----##
--------#-----------#-#-----------#-#--------##---##--#---#--#---##--------##-----------#----#-----#
---#-------###-----------##---#-#-#---#------#---#-#--#---#---#--###-----#----#--#--###---#-#---#-#-
-##----##----#---#-#--#--#-##-#--#---#-#----#------#---#----#####-#---#--#--#--#--##-##----#-----#--
##-#-----#-#--#---###-----#-##-------##-----###--##------#----##-----#----#---------#---#----#-#----
----#-##-#--#-----#----#--#-###---##--#--------------#-##----#---###---#---#-#----#--#-#--#----#---#
#---#------##----#-#-###----#---#-----#-###---##----##-##---##-----#-#--#-#----#-------#-#----#--##-
-----#-------##-#--###-#---#------#-----##---#---##--#---#----###---#------#--#----#--#---##--#--#-#
---#-##-##-----#####----------#-----#--#--##---------#-------#----#---#---#-#-#-#-----#---#-#------#
--#----#-#---#-#------------#--------##--------#---#--------#------#---------#----#------#-#-##-##--
--#---#----##--------#----#-----##--------#-------#-##---#-------##-#-###-----#------------##-------
------##-#--#-----##--####-#--------###----#-#--###--#-#------##-###-#-#-##-#--#----#---##--#---###-
----------#----#-#----#---#--#---#------#-#----#-#-#----##--#----#--##-----------#-#-#-#---#--------
------##---#------##-#-##-#---###----------#-#--#---#-----#--##---#-#-###---#------------##-##--#--#
#--#-------##--###-#-####---#-----##---##-#----------#------------#--##-##---#----#--#---####---#---
----##----##---------#----S---#--#-#----#---#-------#-#-----#-----#-----#---#------#-#--#-##-###----
-----#----------#---#--------------#-####-#---#---#--##---------#-------#---------##-#-##---------#-
--#-----#-#--#----##----#---#----#-#-------#####--#---#-#--#---#--##-------#-------------###---###--
--##----#--#-------##---#-#-#----#-#-------#----#####-#--#-----#-##------#--------#-#-----##----#-##
--#-----#--------#---##------###-#-#-#----#--##-#-####----#--#-----#---#----##-#-----#---------#--#-
--#---#---#--#---#-#--#-#----###------#----#-----##--#-#-#-----##---#---###----#---#----#-##------#-
--#--------#--##---#-------#----#-#----#----#-#####-###--#-#-----#--#---#---#---#-#---#-#--#--###---
-#--------#------------#------#---##-#--#----#------###------#---#----#-#---------------------------
---#---#-----#--#---------##--#--#-##-----#-----#--####--####--------------#--#--#---##------#--##--
#----##-#----##-#-#---##-#--####------##-----##--#------####----##------##-#--#----#--#--#-#---##---
##---#--#---##--#---##-#-------####------#-##-##-####----#----#----##----##-#--#---#--#--#--#-----##
-#-#-#--##---#--#-#------#---#-##--####---#---#-----#----#----------------#-----#-#----#-----#####--
---#--##-#--#-----------##--------#-----#--#--#----#-#--#----#-----#-##--#-----#--##--------#----#--
#-----#-#-#------#-##-------#---##---##---------#---##-------#-------#--#-------#-----------##--###-
-##-----#-#-####--------###--#-----#--##-----#--#--#---#---#-----#----#-##-##--------#-##-###---#-#-
------##----#####----##-------#-#--###-----#---##---##-##--##-#-#-#--------#-#-#--##-#-----#------#-
##-##---#--##-#-------##-#---##--------------#-#-###---#--##--#------##-#-##----------##-##-#--#--#-
---#-#-#---#------#-------#--#--#-------#-#--#-#-##--#--##-#----##----###-##-##------#------#--##---
-#-##-------#--#----###--#--#-##----#-##---#-##-###---#--##-#--#---##-#--------------#-##--#----#---
-#-#----------#-#----##--#-#-#-----#-##--#--#--#---#----#--##--#-#-------##--#----#------#--##-#----
--#-##---#-------------#--##---#---##-#----#-##-----------##----#-#-----#----####-###----##--###----
##------#----#--#--#-##--#-#-----#-----#---####--#---##---#-#------#-###-#--#-------#-##-----##--#--
--#---#----#--------#-----#--#-#-----#-#--#---#-#--##------#--#--##--#---#-#---#--##----##--#--##---
