#-#-#--#----#--#--------#-#-#---#-#------#---#---#----#-----#---#-#-#-#----#-#---#-#####------#--#--
---#-#-----##--###-#--##--##----#---#-#-##-#----###--#--#-##-------##-###---##-----#------##-##--#--
---##---#-#--#---#-#--##---#---##-------#-----#-###--#--#-#----###-#---#------#-####-#-##---------##
-----------##-#----#--#####-#-#--##---#-----------#----####-------##--#-#-#---##--####-##---#--#----
----##-#-#-------#-------#--#-#-----#---#----#-------#-#---###--##--##-###-----------####-----#-----
#--###--#------#------#-----#---------#-##-#--#---##----##------##-------#-#--#--#----#--#--##-##--#
#-#-------#---#--#-----#------#--#-#--##-####--#--#---#-----#----##--##--------#--###------#--#---#-
--#----#-##-----#---#---##-#-#-##---------#----#------#---#--#--##-----------#-----#---#-#-#-------#
----##--#-#-###--##---#-----##---#--#--#---#-#---------------#--####----#--#------#--#--#-#---##-#--
#--##----##--#-----------##----#-----#------#--##--#--#-------------#-##-#--#--##----##-#-------#-#-
--#--#-----#---##-------#----####-##-##---#-------###-##---#--#-######-#--#-#--#----------###--##---
--#-----#-#-------###--##--------#-----#-#-------#-#-#---###--#---#---#----###--#----#-###--###-##-#
--##-------#----#-----##---#-#--###----#-#---#-------#--#-------#---#----#-##--#-#----#-##-----#-#--
-#------#---#-----#------#----#-##-#--#------#--------#-##-----##-#--#----#-##-#-#----#-------------
-#--###---##----##-----#-##------#--##----#-#-##-----------#---#---#-#-#--#-#--#--##--#-##-------#--
--#-#-----------------##----#---#---##---#----##------#--####-#----#-#--###-------#-###--#------#---
#-------------##---------#--#--#--#-#--------#-----#-#----#---#-----#-#--#-#-##--#------------------
-----##-#-------------###---##--##---#-----###------###---##-#---#---#---##-##------#-##-----#--##-#
#------#----#----###----###--#------------------------#-------#-----#-#--##--#-#-##--------#---#----
#-----#-#---##-#-----#--##----#--##---#-----#--###---##--##---####-###---#--##-##------#--###--####-
-----##--####-#---##------#--#--------##-###---#---#---#------#--#-#---##----------#--##------#---#-
--#----#---###---#--##-#-------#-##-##--##-----#---------###-#-#---#--###-------#-#-###----##---#-##
----#----##----------##---#-------#-##-------#-##--#--#---#---------#-#----------#--#--#----#-#--###
#-#------#--------##--###----------###--#-####-#------##--##-##--#-#---#-#--#------#----#-#-------#-
--##-#---##-----#-#-##---##-####-----#-----------#--#---------------------#-------###---#-#--#------
-##-##-#-------------#---#---#-##---------#----#----#--#--#-----#------#--#---###-#--#-#-----#---#--
------------##-------------##--------####-----#--##-----#--------#-#---------#-#-----##--#----#-#-##
#------#------#------#-##------#---#--###-----#---##-#-----#----#---##----##------#-##---##---#-----
#-#-#-------#--#--#----###--#--##----#----------##---#---#-##-#----#----#-#---#----#-------##----#-#
---#-#-#-#----#-#-------##-#--##---#--#-#------#-----##--####----#------#---#---------#-#-####-#----
---#--#---#--#-##-#--##-----##--------#---#------#-##-#----#-#####--##--###--#----#--##-----####-#--
#-#--------#-##---#-#----#-#-----#--#--------#--####-#-#--####-#--#----#----#--#------------##-##--#
------------###--##-#----#-#-###--#---#------#--#----##----#-----#-##--#----#-#-----#-#---##-##-----
-------#--#-###--#--#--##-##-##----#-----#-##---#-#---#-#-#------###-##-----#--------#-##-#--####---
-#####----#----#--#-#----###-#--##-#-##------------------##-#--#--------####-#-#--------#--------#--
---#------##-------#--##-#---#----#-#---#----##----#--##---#-#------#---#---#---#--#-----##---------
###---###-#--#---#-#--#-#-#---#-#--#------------##-----#---#-##---#-#---#----##-##-#--##--#-#-#-#---
-#--##-#--#----#-##-----------------#-#-#####--##---##-#---#-##-#---#---#--#-----#--###---#-##----##
--#----#---##--#-###----##--#-#----#---##-#-#-###-#-#-#------#-#----#----#-#-----------#-----#-#-#--
-----#-----##--#-#----#----#--#-----#-----#--#------#-------#---#######-##--------------------##-#-#
#------------##---#-##---##--#---##--##--#--#--------#---#------#-----#-#-#---#-#---#----##---#-#-#-
##-------------#--##---###-#---#-###------#-#-####---##--#--------#--#--------------------------#---
---##-##--#--#-------#--#-#--------##-##---#-#-----###--#----#----#-----------#-#-#--#------#------#
--##-###-------#---##----#-#---#---#---------#--#------##--#--#---#-#----#-##-#-##-----#-#---#-----#
---#----#---#--#--#--#--##--#-----##-----#-------#----#------#---#--------#-#--#----#-----###-----#-
#-##--###------####---##------#-----#-###------#-#-###------#####-##---##------#--#---#---#---------
--###-#-#--------#-###------##-----#-#--#--#------------###---#----#-----#--##-####------###---#-#-#
#--#---#-##-----###----#--------#-#------#--#------##-#-#--#-#--#-----#---###-#-----##--------#-----
------#------#----##-----###----#--#---##-#---#-------#--##-----------#---#--#---#-----#-#-#-----#--
#--#----E-----#--##-----#-##--##--#----#-#-----#-----#--#--#-###-#--###----------#--#-#---#---##-#--
-##--#-#----#----#-------#-##---#-#-#-#---#----#--#-#-#----#-###-#--#--#--#--------#--#---#-#--####-
--#----#--#---#---###--#-##------###--------------##-#------##----#--#-#-#-#-##----------##------#--
#---#--##----#---#-#-------#-----#-###-##-#-#---#-#-------##---#--#-#--------#-#----#--#-#---#---#--
#---#----##-##--#####---##-----#-#-#--##--#--#-------#------##-#-#--#-##----#---------------#-#----#
-#---#--#--#----#---#---#-------#-#--#---##---#--#-------#----#----#------#--#---#------##---##-#---
-------##----###-----#-#--####--##-##--------#---------#-------###----#-#-#--#----##---##--##---##--
----#-####-#--#----#-#-#--##-#-###-##-#---------#--##-#-#-##------#--#-#-##-#---#-#--#----#------#--
####------##---#----#--------##---#-#---#---#-#-------##-----#--##-----#-------#----#--#-#--##----##
--#--#--------------#------#####-#---------------##-#-#-#--##-#---#-#-####-#-----#-#-#-------##-----
--##---------#-----##---#-------#--#--#--#------#---##-#-------#----#-#--#--#-#---#--#---##----#----
##-#--##-------#---#-----#------##-#-#---#--------#-#-#--#---#-#--##---#---##--#-----###----##------
-----#--#-------------#------#-#-#--##--#---------#----##-----#-##--#-###-#------#-##---#--#-#-##-#-
-#-#-##-#---#---------###---#----#--#--#--##---##-#--#-#------#--#--#--------#-#---#----------###--#
-#-#----##---#--#----#---####-##-#---#-------##--#-#--#---#---#-----#-##--#--#---#--#--##-------#---
#-###-#-##-#--------##---##------#--#--##-#--#-----#-#--#------#------#---#--#------##-#--#-#-#-----
--#--#####-##---#----#-#---#-#----#--#-#####---#-##-#-#--##----#-#---#-----#--#--##-#--###-#-#--###-
#-#-#--#-----#----#--#---#-#-##-#---#--#---#-##--#--#-#-#----##--#--#-#-#----##--#---------##---#-#-
--#-#-----#----#-##--#------#-#-#-##-----##--#-----#---------##-##-----------##----------##-----####
#-#----#-#----#-------#--------#--------#---------#------#-#--#--#-#-#--##-#-#-------#------#--###--
#----#--------##-----#----#---##-#--#-#--#--#--##--------#-----#-#-#--#---##-----------------#------
-####---##---#-------###-----####--#--##--#-##----#-##--###-#----##------##-##---#-#-#---------#---#
-##----------##-#-###-#-###----#--#----#----------#--------#--#-----#--#---#-#-##---#---------#----#
--#-#------###--####-#----#------##---------#----#--#-#---#---#--#-------####------##-#----#-----#--
------------#---#-------#---#-#---#--#-#--#---##-##------##-####-#---###-#-#-#-##----###--#----#--##
-------#-----#-#---#---##-##----##---#---#--##--#-##-#-#--#--#------##-------#-----#-#-#---------#--
---#---#-#---#-#-#-##--###-#-----#-##-#-#--##------#-####--##-----------##----#--#----#---#---#-#--#
#---#-#-#-##----#-#-#--#--------##--#--#---##------#--#----#-#--#-----##-#-----#------#----#--#-#-#-
-##-##----------###----#---#-#----#--#---#---#---------#-#----------##---#-#-----#--##---#--###-###-
-##-#-##-----#---#-#--------#--##--##---#----##--#####-#---##---#--#----#------#------#----------###
----#-#-#---#--#------#---#---#----#--###--#---##-#---#-#------#--#-###--------#-------#-#-----#----
-#--#--#-#-##---##--#-#--##-#---###-##---###-##----####--#---#-#--##-#-##---#--#------#---####-#-#--
---#----##-----#--#---##--##---#---#----#--#---##-#-#--#----##---##----#--##-#---#----#--#----####-#
----###--##----#------#--##---#------#-#---#--##-#--##-----#-----#---##-----#---------------#----#-#
#-##--#---#--------------------#-#--##--#---#---#-----###---#---#-#--#-#---#S---##-#------#----#----
-#--#--------#----#-##-#-##--------#--------------#----#-###-##-####--#--#--#-----#--------#-###-#--
##--#-##--#-----#-#----#-##--#-##-#-#--##---#--#---#-------#-----#--#-#-#--------#-#--#------##--#-#
--#--###--#----#-----------#-#---#--#---##--#-----##----#-----------------#----##---------###-#-----
----#----------#--##-##-------#----###-##-----###---------------#---##-----#---#-----#--#----##--##-
-----#-#---#--#-#-##--###--##-#-#--#--#-#-#-#---##------#-#-###-#------##-#--#----------------#-#--#
#-----#----#----#-##-#---##------#-#-----#---#-#--#---####--------##---#-------#---#-#---##-----#-#-
----#---#-----#--------------##-####----#-#-#-#-----#--#--##-#-------##--##-----#--#---#-------##---
--###-#-----#-#------#-----#----#--#-----#-----#---##-#-#-#---#-#----##--#--##-#--#----------###----
#------#---#------#----------##-#-#----#-#-#---##-####-----------##--#----#-##-#---#--#-#----##-----
---#---#--#---#-#--#-#-#-#-----#-----#--##--#-#---##------#------#--#-#-#-#---#----#-----#-#--#----#
---------#-#-----#--#-------#-#-----#---#----#-##---##-#----#---------#-------------###----###--#---
###-##-#--#-#--#---##-###------###-----#----#-----#---#-------#----##-------#-----#----------#---#-#
--#----##---#---#--#-#----#-##-#-##---------#------#------#-------------#-#-#----#--##--#-##-##-#---
----#-----#---#--#--#-#---##--##-#-#--#-##----------#-#--##--##-#---#--#-##------#--##-#---###---###
--------#-####-----#--#----#-###-#-###---------------#-----##----#--#-#--------------#---#-#-#----#-
#-##-#------#-#----#---#----#--------#-#---------#---#----##------#--##----##---##---#--##----#-#---
