-##-#--#--#-----#-----------##-#-#--#-#--#-#---#-#-------#--#-----#--#-----#-##--#--#--#---#-#-#--#-
--#--###-#--#--#--#---#--#--#-#-#-###-#---#---##-------#--------#--#--##-#---#-------#--#-#-#---###-
--#--#----#-#--###---#-###-#-#----#---#---#-----#-----##--##-----------#-#-#--#--##--#--#-#--#------
-#--#-#---#-#--#----#------#-----#---##-----------#-#--####---#---------#-#-----#-------#---#-------
---#---#----#-#---###------#---------#-#--###------#--##--#-#---##--#----#--##---#---#-#-#-----####-
------#----##--##--#------##-----#--#-##-###-##--##-#--#--#--###-##--#-##-#---#-----##-----#-#---#--
--------###-#-#---###-#-#--#----#-##----###------####--#####--##-#-#----------------#------#--##----
--##-##--#--#----###--#---##--#-#---###-#-###--##---------#--##--------#------#------------------E--
----#----#----#--#-#--#-##-#-###---#----#------------#---#--#------#-#--#-#-----##---##------#-----#
#---#-####--#-#---#-##-#--------#-#--#-#-----##----------------#---##-#----#--#-###-##----#-#----#--
-#----#-----##-###-#------#------#--#--#---##--###--##-#-----##-#-----#--#---#--#-----#-##----#-----
--#--##--#--#--#----##--#--#-#----#-------###-##--#-#-#---#-#--#-##-----######---####-#-----#------#
-----#---#--------####---#--#---#-#-#--###-####--#----#------#-#--##--######--####-#-----##---###-##
-#--#--#------#-#--###-----#------#---#---#-------#--#--##--##-#-#-----#-#-------#-##----##----##---
--#--#---#-#----#---#--#--#--#---------#--#----#----#-#---##-##-#--#--##------##-----#-##--##--#-##-
-#--------#-#-#---------#-#-#-#---#------#--#--##--#-###--#-------####--------###-#----##-----##--##
------#-------------#--------#--#-#---------#-#-#------#-------###----#--##--------#-#-#-#-#--------
----#---##-#----#--##----#--#---#---#-----------#---#--#-###---#-#---#-#------------#-#-----#-----#-
---#--###-##--------#--##-###-#-###-#-----#---#-#####---------#----###----------#--##-----#-###-##--
-##-#-#--#--#-----#-#--#---#-##-#-#----##---------##-----#--#----------#---#--#--------#------##--#-
-#-##-##---#------#--#-#--------#----#-##-###-#-##--------###----#----##--#--##---##-#-#------#--##-
-----#-#---#-#--##-----###-------#-------##-###-#---#-#-##-----#-#--#--------#-##-#--##---#---#--#--
--#-##---#---###-#---##--#-----#--#-###-#---#---#-----##--##--#--#####-##--#---#-#-----#----------##
-##---#---------##-#-#-----#----#-##--------###--##--#----#-##--###--###------##-----#-#--#---##---#
----#-#-##---###--#-----------#--#----#--#---------#---#-##-----#----#----#-#-----#-#------##-------
------#----#----###--#--#-----#--##--##------#------#-###--#-----#----#-#-#---##-#-#-------#-#--####
-#---#----#-#--------#--#----#-------##-#-###-#--#--#-####--#--###---#-##-----#-##-###--------#--##-
-------------#-#---#-----#-------#-----------###----#-#---------#-------##-###------#--#-------###--
--#-------######------#-------##--#---##-#-#---#------#----##----###-#-#------#-##----#-----##------
##-----------#---#---#----###--###--#----#----#------##--##----#----#--#-----#--#-##-#---#---##-####
---#--#---##--###--#------#-##-------#-#---------#-------#--#----#-##----------#-------#-#-#--#-----
#-----------------###--#-#-#----##-#----#-----#------#-#-#---------###-#----#---------###----###-#--
#--####-##--#--#-#-#-----------#----#-#--####----------#-----#--##------#-------------#------#--##--
-#---#-----#--##-##-##--#-------#--#----###---#-#--#######--------#-#--###-#--##-----#--#----#---#-#
-#---###-#-------------#-------#--#-#----#------##-#-##----#----#-#---#-#--#-###---------#-------#--
----------#####---#-##-#---##------#-###--##-------#-----#---#-##--#--###---##---##-##--------------
-#---##-#---#-####------#---##--###-#-----##--##-------------#----####--#-----------#-----------#--#
-#--#-#---#-----#--#------#--#---##-----#-----###---#-##-##-#--###-#-----#--#--#-#--#-#---##---#-##-
-----#--#--#-#--#----#-------#-#----#-#-#--###-#-#-##--###---#------#-#------#--##-----#-#-##-#-##--
#--#-#---#----#-------#---------#---------#-#-##-###-##----##---##--#-----#-#--##-##-----#--#-----#-
#---#--###-----------#----###-#----#----##----#--##--#------#--#------#-#---------##------#-##--#-#-
-----------#---#-#--#-#-#-#---##--#-#--#-##-------#----##-#-------#-#--##---#--#----##-#------#-----
#-----#------##-#--##--#-#-#---####------##--##-----##-#--####-##--###--#-----#---#-###----#--#-####
-#-##-##------------#------#--------##-##------##----##-#---#------#-##-###-------#--#---------#----
------#-##-#--#--#------#----#----#--#--#--#--#---##-#-------#--#----#-#-#-----#--##----#--#--------
--#--##---##--##---##-#-##--------#-##----------------#-----#--#-#-----#--#-##---#-#--##-######--#-#
----#-#--#--##-------#-#--#-#--#-##-----##-----#--##----#-#--#---#-#--#---#-##-----##---##-##-####--
##-#-#----#-##-------#-#----###---#-----##-#--#--####------#--##----#---#--##----#---##----#--#-##--
--#---------------#--------------#-##-#-#---##-#------#-##--------#------#-#--###-##-------#--#-##--
-#---###------#-----###--#---#---##-##----#-------------#-#--#-##--#---------#-#--#-#-#-----#------#
---##-#---#----------#--##---------#----###------#-----#-#---#-----#-#-#----#-###-#-------#------#--
---##--##---#-##--#-----#----##--------#-------###-##----#------#---#---#--#---##-#--#####--#----#--
-------#-###-##-----#--#--##--#--#-#---#-------#--#--#-#----#---#---#-----#---##----------#--#-#----
--#-#-------####---#-----##--------#--#-##-###-##--#-#-----##----#--#---------#---#----###----------
------#---#--##--##----##-#---##--##---#-----#-##-##-----#---------#----#-------#-----#-----------#-
-#--#-#--#---#-----------#-#--#-#-##--#--------#-###--#---#---###-----#--#-#----##-----#---#---#-###
-#---##----#-#-----#-#-#--#----------#-#---#----##--#-###-#--#-#-#-#----##-#----#-##---#-#--###-----
-#--##-#---#-----#---#-#-----###---###-##-##------#-#----#---#---#-#--#-#---------------------#----#
#-##-#-------------#-#-----#-#--#--#------##------#------------#---------##--#--#--#-#----#---##----
--##----#-------#-#-----###---#-######-----#--##-##-#-----#---#-#-------#--##---#-----#---#---##---#
-#-###-----#----#-----###----###--#-##-----#-----#---------#--------------#----#---#---#---#--##---#
###----#----#---#----##-----#-#-------#-----#-#-#-###-#-##------#-----##--##--##---#----#----#-#----
----#---#--##------###-----#----#-##-------#--###-#--#---##---#-#----###---#------#----------------#
--#--##---#-##-#----------#--#-#---##------#-----###-####---------------#-#---#---#--#-----#--#-#--#
-------#------------#--#-----#------#---#---####---------#-------------#-#-##-------------------#---
----#-#####---------#-------#-------#---##-----#-------#----#---##-##----------#-#-------------#----
#-------##-#--#-#-##--#----##-----#--####--#--##---#-#---##--#--------------#-----#--#----------###-
------------------------#-----#--#---------#-#-##-#-##----##--##----#---#-#--#-#----#-###-#-----#---
----#--#----#-#-#------#----##--#-##---##---------#----#---#--##-##--#------#####-#-##-#-#--#-------
#-#----#-#-##----##--##-----#----#---------------##---#-#--------#--#-----------------#----------##-
#######-##--#-#--------#---##---##---####---------##-##----------##---#--##---####-#----#-#-###-----
--#-#-------##---#--##---#-#----#---##-#---##-#--#----#-#---##---#----##-#-###--#-#------##---#-----
#-#-----##------------#-#-----#--##---#-#----#----#---###-#---#-#-------##------##---#-###-##-----#-
-###---#-##-#-#---#----#-#---#-#-###------#-----##-#---#-###-#----#---#------#-----#--#------#######
---#--#------#----#---------###--#-#----#--#-##----------#--##-#-#----#-----###-#--##---#--###----#-
#-#------#-##--####--#-----##----#-#------#---##--#---#----#-----#----#-#---#---#----------###-#--#-
-#---###-------#-###-#--#-----#----##-#------#--#----##--###------#-##--#-#----#---#-#-#------###---
------#-#-#---#-#-#-#------#-------#----#--#--#-----#-----#--------#-####---##----#--#--#--##------#
#-#---#-##-#-##-#-----#-##---#------##-#-#----#-#---##-##--#---#----------#---#--#--#---##-#-#---#--
--------#--------#-#---#-----##---#--------##-----#-#---#-#-#--#---#------#-#--#---#-#---#------#-##
#-##----#------#-#---------#----#-##--#---#--#---#--#----#---##--##----#-##-#--##-------#-#-----#-#-
----#--##--#----------#--#-#-##-#-----#---------#------#-#--#----#--#----#---------#--#---#-#-##-#-#
---------###-##---#-#------#----#-#--#-##-----##--#------#---###-##--#--##-------#------##---###-#--
#--#---##-#----#-#-#--#------------##---#-----##---#-##------##-----#-#-##-#----#---#--##--#-##-#-##
--#------###-#--#-##-##-----#------#-#-#-#--##--#--#--##--#---#-------###----#-#-#----###---##---#-#
---##-#-##----#----#-#-##--------#----#-###-#----------------###--#--##-##-#---#---##--###--#--#----
-##----#--#----#----#--------#----#-#-#-#----#-##----###--#-#---#-###---##--------##-#--#-##-#--#--#
----------##-#------------##---#-----#-----#---------#-###-#-#-#-##---#-------#----#---#-#--#---#---
--#-----#--##-#--#--#-#-----#----------##--###-----#-##--#-#-#------#--##------#--#---##----#-------
---#-----------#-##--#-#-#-#---#-##---#--#----#--------####-#---------#-##--#------#-----#-#-----#--
#------#--#-------------##-----###---#-#--##--#---------------##--#--#-#-#--##-##-----------#---##-#
-------#-###--#--#-----##--#--#-------##-##-#----#--#--#-#--##-##--#---###-#-##-#---#-#-----##---###
-##---#-----#----##-----#-#----#-----------#-#--#-#-------##--####--#--##-#---#-#--#--##-#------#---
-####-----#-##---#--#-#--#--##-##---------##----#----##------#-------##-----------#---##-#-#--###--#
-#--####--------#-#----##---#-----#----#-------#--##--#----------#S#--#-##--#--##----#-#--#--#-###--
------------------#-----#-#--------##-#-#--#-----#---#-------##-------##--#-###--------###--#-------
##----#--#-#----#-#####---#-----#-----#-#------#---------------#-##-#---##---#--------#--#---------#
-##-#-----#----##-----#--#--#--------#-##----#--#-##-----#--##---##----------#-------##---#---------
#---###----#-#-----------#-#-##--#-----#---#-##---#-##----------##-#-#---#-##-#-#-#-#--##-----------
-------#--#---#---###-####-##-----##---------------#------#--#---#------#--#--#---#--------#------##
