#----#--------##--#--------------#-#--------#-----##--#---#--#---#----#-#-##--#-#----#--#--##-#-#---
##-#------#----#-#-#---#-----##-#-#--#----#-#--#---##-----------#--#-#-##------###----#----------#-#
#-------##--##--------#-#--#-#-#----#--#-------#-------#--#------#---#------#--#-###--#-#----###---#
-#-#-#-##--#------#----##-------#----#-#-----#---#-#--##--#--------#-----#--###-----##--##-#-----##-
###---------#-------##--#--####--#-##-----###-##----#--#-------#--#-#----##--#-#-####-----#-#-#-----
---#--#-#-##-------#####----####-------##--#--#----#-------#---#----#--#-#----##-#----###-##--#---#-
-----#--##--#---#------#--#--#--###-#---------#--#-###--##----#-------------#---#----##--##---------
----#------##-####-#---#----#--------##--#------#-----#----#-#--#---##---#-##----#------#-##-##-----
#---------#----#--#---##----##-#-----##-#---##-#--#-------#--#-#-#-----##-#------#-#-##---#---#--#--
------#----------#------#-##---#---#--#--#-#----##-------#-#---##-#-#----#--#-###----##---##----##--
#----#--#-##--------------###-###-----#---##-#--------------#---#---#--#----##-----------#------#---
#-##---#-#-#-----#-----#------##-#------#--###--------#-------------###------###----#----#------#-#-
-###--#----#--#-#--#--#--##-----###----#-#-------##---#-####--###---------------#-###-##-----#----##
#----#---#-###--##--#--##---#-#-#-#-##------#-#-#------##----##---#-#------#-#--##-#------#-#--##---
-#-##---#-#---#-#----###--#---#-----#-##-----#-#--#-#-#-#--#-#--#-#----##---#----###-#---#---##-#-#-
#--#--------#-#--------#--##-#--#-#-#--#-##--#--#--#-#-#-#---#-#-------##--------##--#--###-#----#--
##---#----------#--#------#-#-----#---##--#-#-#--#-####----#-#----#-----##-----##-----#--##-#-##--##
---------####-----###--#----#-##--##-#------#--#-#---#----#--------###-#--------#--#-#------#-#-----
#-##--#--------##----#--##--#-##---#-#--##--------##-#--##-#-#-#----#----#-#-#--##----#----#--------
#-----##-#--#-#---#---#-------##--#--#----#----#-----#------#----##--#--#---#----#-##--#-###---#----
--#----------###-##---##-##----##-#--#---------##--#--#-#---#-#---#-##--#-#--##----#----------------
#-#--#-#-------#--#--##---#--#--#----#----#-----##-#-#----##-----#---###------##----#----##--###----
#-----#--#--#-----##-#-###-#--------#--#---###------#-#--#-#--------#-#-----#-#--#----#---#--#--#--#
--#---#---#-------#---##--#-#----#---------###---#-----#---#-#---#---#--##--#--#---#--#----#--#--#-#
-----#-#--#######--#--###--##-----###-----#--##---######----##-#--##----##-#------#-----#-##-------#
#----#--------#-#-##-##-#-##---##-##----#----#-#------------##-------##-#-------#----#-##-#--###--##
--##----------##--#####-------##---#-#------------##--------#----#-#####-##------#--#---#-##-#--#-#-
-#--###---#--##-------#--##-#--#--#-##-#-#-#--####---------#------#-------##---###-#-##-#--##-#---#-
-------#-#-#-#-------#-####--#---#--#-#-##----##-#-##----#--#---#--------#--#---#---#--#-#---#-#---#
----#-----##--#----#-#-#-##--#--##-#---#----#-----#-#-#-----#------#-----#------#--#-----#--#------#
-#-------------###-------#---##-#----#--##-#--------#-----##------#----##---------#----###---#---#-#
---------#---#--#--#-##-###--------------##-#-#-----#--#---##----#-##----------#-#-#-##-#--#--#-----
----##-#--#------------##--#----#-##--#-#---#-#-#--#-------#-##---#-#---#-#-----------#--##---#---#-
##-#--#--------##---#-#-#------#----#-----#-#-##---#--#------#-------#---##----#---##-----#-#-#---#-
-##--------#-------#--#-#-#---#-----#------#-#--#----########----#-#-##-#-#-#----#--#-#--#-----#----
---#--#-#---##-----#-#------#-----#--##-------------#-------#---#---###---#-#--#------#-#----------#
-----##---##---####--##---#-#--------##---#----#-##-------####-#---##--##----##----------##-###-##-#
#------#-####-----##-###-#-#-#---#------#---#---##---#-#-####----------#---#-#----##-#-----#--##-#--
-#-----#--#----#----#--###---#---#----#-#--#---#--#--#-#-#---------#--#--#---#-#--#####-#--##-###---
--##---#--------##--#-##------#-#--#-#---#-#---------#--#-#-------#-#-#----#-#---#-------#-##-#---#-
-----#-#----###-#-####----##------#-----##--#-#----------#--#-#------#-###--##---##-#---#--#-#--#---
--#-#-------##-#-#--#-##-------#-#-#--#--------#-#-#--#--##----#-#--#-#-#-#---#-#-#------##------#--
------------#-#--------------------#----#------#-----#-----#---#-----#--------##---#---#----------##
--#--##---###-##--#----#----#-#-------#--#--##--#-###----#-#---#--#-#-##---#--#--#---#-----#----#--#
#---------##---------#----###-#-----##--#--#-##-------##----------#--##----#----#-#--#---#--#-------
#-#-#-#---#---#-E#-#---##-##---#-------##-------##--#----##--#---#---##---#----#-##---------#--###-#
-##---#---#--#----#--#----#-------#----#-#-----##----------#-----#------#--##-----#-#--#-----#-#-#-#
-#-#----#---##-----#-#---------#-##----#---#----######-#-#-#####---##----------------#--------------
#-#--#-----##-----#------##-#-#--#---#----------##-##--#-#-----#-----#--#-##---#-#--#--#---##-------
#---#--#--------#--#----------##----##------#--------#-#-----##---###---------#------#----##----#-##
-#---#----###----#-#-----#-#-###---##----#-#----##--##---------#----#--#----#-#-##--#-#-##---#-#----
####--------#----------#-###---##----###-##-----#-#-##---##--#-#----#--------#-#-----###--#---#---#-
-------#-##----#-#-#-#------##---#--#--#---------#--##--#------#-------#--#----#--#----#-#-----#----
#-----#--#-##-----#--#--#-#---#----#--#---#-#-#-#-#--#-###-##---##--#-#-----#-#----#----#-#----##---
-##-#----##-#--------#---#-#-#-###--#------#-----#--#--#-##-#----#-#------#-----##---#----#------###
----#---#-#-###-##--##----------#----#---#-#-##---------##-###-#-----------#--##-#--#--#-#------#---
---------------#-----------#--##----#---####----#-#-#----#---#-##-##---------#---##-#------#--#--#-#
-##-#-##----##-----#-----#-#--#--#--#--###--#---#----##---##------###---##-----#-#-##---###-###-###-
#--##------#----#---###-####-#-#-------#--#-##------------#-----#----##-------#---#--#----------#---
----###-#--##--#----#--#---#---###--------#---##------------#--##--##------##--###-##--#----##-#----
--#-#-#-#-----#-##------##----#----#----#---#-#----##--#---#-#--#--------#-#----#---#-#------#----#-
###--#--#-#####---#-#-##-#--#----#-----#-##---#--#----#-##-#--------------#----#--##-#---#--#-----#-
-#-###-##-#--#--#-----#---##-----##---------##--##-----#------------##S--#---#---#--##-##---------#-
-#-##-#--#---------------#-#--##----##-----#-##----#-##--#--#---##-----#----###---#-##-----#----#-#-
-##---###-----#---##--#---####---------##-#--#--------#--#---#--#-#-#------#---#-#------#--------##-
-#-------##---#-##---#---##--#---####----#-----#----##--------#----###---#-#-#---##-----##----#-#---
-#-#--##--#--------#-#-###--#------#----------#-#------#-#--------#-#---------#----#--##-#---#-##---
--##---#--#-------#---##----#---#--##----#####--#---------#---#-----------#-----#-------##-#-#------
----##---##-#--#-#-----#--------#--########-#-#--#-##---#------#--------#---#------#--#---#########-
---#-#-#-----#-------##--#---#--#--#-#---------##-#----#-#-###-----#------#--#-####-##------#----#--
---#--------#-----#--##----#--#---#--------#-#-#-#--#----#--#--#--#-#-----#---#-----#-#-----#--##-#-
--##-#----##---#----#----##---#---------###----------##----------###-#-#-------#-#-#-----#-#----#--#
##-###-#---##---#-#--#--##-#--#--#-####--#----#--------#---#--------#-----------##----#-##----#--#--
#---##----#-#---#--#----#-#------##---#-##---#-----#-##--------####------###--#--####---#-----#---#-
-#--#--##------##-----###---##--##-#----##--###---#---##--------####-------#-----#---#----#--#---##-
--#-#----#---#-#--#-----#-#---#-----#--------#--#####---#------------##----#--##-#-#-##-------------
--------------###----#-------##--#----####--------##-#-------##--------#---------###---###-#----#--#
--#-#---------#----#-#--##-#-#---#-----#-#---#---#---#--#--#---------#---#---#----#-#---#-#-#-#-#---
-#---#-#----###--#-#----##-#--#-######-#--#-#------#------###----#--#----------#----#-----------##--
--####-------##--#-#-#---#-----##-----#--#-------#-#------#-#-------#--##---##-------##-#------##--#
#---#-#-##------#--#--#----#--------####--#-----------#---###---#-#---#-#-----#-#--#--#-#------#--##
-#----#--------#---#--##---###-#--#----#-------#----#--#--#---#-----#--##----#--#-#----#--#---#--#--
--####--#--#-#---##----#-##------#-##---###-##-###--#-#-#--#----#--#----#---------#---#--------#----
--#---------###-##----#---#-#-------#--#---##--------#-#--##------###-#----####----#-#----##------#-
--##--#-#--##---#--##---#---#--##---------#-##----#---#---###-#--------#-------##--###-#-#------##--
-----#-##-##----#--#----------#---##---#--#---#-##-##------#--##---#-##-####--#-##-#--#--#---#-#---#
#-##-#----##-#-----#---------##-#-#--#-------##---##-#-----##-----------#------#----#-#------#--#---
#-#-##--#-#--##---------#----#-#-####-###---#--------##---#----#-#####-#---------#------#--#-#--##--
-##-#-#--#-####--##--##---##--#-##----#--#--#------#-#-#-##-##------###----#----###--####-----------
#---####----##---------#-#---##-----#-#-#-##----#-----#----#-----#--#------#-#-----#----------#-----
--#-#-#---#--#-#--#--------#-----##----###-##--#----###------###----#---------#-#-----##----####--#-
-#-------##--###---#--#-##-##-#--------------------###--#---#--------------#----#---##-#-#------##--
-#-#--------#-#--#-#---##-#-#-#-----###-#-----##------#-------#----#--#-##-------#--#------##-#-----
---#-----#-------##-#---#---###-------#-----------------#-----#------#-##------#---#-#--#-------#--#
-#-#-#----#-#-###---###--#----##-#----#----#-----##---#-#--#--#------#####-#------------##-#-----#--
-#-##-#------#-#-##-####----#-#---------#--#-###-#-#-#--#--#--------##--#----#-#--#------------#-#--
-------#-##-#-##----#-----#-###-#---#-------##---##-#-#-#------#---##----#-----##-#----#----##------
--#-#---#--#-##---#----##-#-----#----#---#---#----#-------#--#---#--#--#-##---#---#-------#------#--
###--#-####--#--#-#------#--##-##---#-----------#-#---##---#-------#-----#----#------#---##-----#-#-
--------#-#---###------#-------#--##--####---##-----#-####------#-------###-----##----#-#-#-##-----#
