---------#--------#----#-----##-##-#-----##-#------#------#----#-#-#--------##-----#----#-#-----##-#
#------####-#--#--#-----##-###--##-----#-----#------#-#-----#----#------#----#----------#---##------
-----#-#--#---##--#-------#----#------##---#-#---#---------###-----#-#---#---#-##-#---#-#-##--#---##
-#----#-----#-#--#--#-#---#----#-#-##-##-##-------#----##--#-#-##-#--------#-----#---##--#-##--#----
-##--##-----##---#--##-###--##-#------#--------###--#----#-----------###----##-#--#-#--#--#----###--
----#----------##-##-#-#-#--------#------#--------#---#-#-#--#-###----#---------#-##---#-#-#-#---#--
--------#----###--------##-#-------#------###-#------#--#----#-#----------#--#---##-##---###-##----#
----##--#--#-#-#-----##----##-#----------#----------##---#-#----#--##--##---#-#---##-##-#-----#--##-
###--#-#-------###--#---#-###-#------#--#-#-#-----#---####--------------##--##---#-##---##--#----#-#
---##----##--#--#----##--#-##--------#-#-#-#--##--#--------#-###----##-#--#-#-#-#---#--#---###-#----
#---#--##----#------#----##---##----#---------##-----##--##------#-----------#-----#-##----##--#--#-
##-#-#-----#-#-##------#---------#------#-#---#--#---##----#----------##-#-----#--##--#----##-#-----
-------------#-#-#-----#--#---#----#-##-#-------------##--#----#-###-------#----#-#------#--##---#--
-#-#-#--------#--##--#--#------#-#-----#---##----#------##-----#-#----------##-----##-------#------#
#----#--#-#---##--#-----#-##--#-----#----------#----#--##---#-#--#----#---#-#------#-#---#----#--#--
#-#--------------------##-##-###-#-------#-----#--###-----#-#--##---#---##--##----#---#---####------
-----##-----####----##-##-##-------#---##--#--##-----##-S----####--#---#---###-#-#-#----#--#----#-#-
-#------##---#-###--#---###-#--##--##--##-----#-#--#----#-----#-#--------------#-----#--##--#---##--
-#--#----#------#---##-#----#---#-#---#---#-----###---#---#--##-##-#--##--------#--##---#---#-#-##-#
#---#-#-------#--#---#---#----#-#---#-##---#------#----###----#-#-#-------#-##-#--------#---#-----##
-#------------##--#------#----#--#-#-##--#-#--##-#------#-#----###----------------#---##-#--#####--#
------#------##-#--##--#-#---#-##-#-----##-##----#------#--#-#---#------#-#-#-----#-------#----#-#-#
#--#------------------#---#---#-##----##----#-#----##------#--#---##-----#------#-------####-#---#--
---#-##-##--#--#---##----###--------#-#-#-#--##---#-----#--###-#-----#-#-#-##------#---#-###-------#
-#-###--##-##----#---------#------#---#-#--------##------#-#---#-#----#------#-#--#-------####-#--##
--#-##-##--#######---#--#---#-----#--##-#-----#--##-#--#-#---------#--#----#--#---#--##-#----------#
-#----#-##-#--#---------#-------##-----##-#------##-----------#-###----#--#-----##-###-#-#--#-#-----
---------##--##---#-##-#---#--#-#-#---#-###-----##--##---#---####-#-----#------#-----#-#---------#--
#-#-##-#-#----#--#----##-----##--#-##-##-----#---##---#-------#-##-#-#--#-------#-#----#------#-----
---#---##------#-#-----#--##------##--------#---##--#-#-----#----#--------##-----#---##-#---##-##---
----------------###-----#----##----####--#E-#--##------#--#---#-#-#--#-----#--#-#--##--#-#---#-##---
--#---##----------#--##-------##------####---##--#-#-----#--#-------#---#-#------#----#---#-----##--
----#--##-------#-###------#-##-#---#-##-----------##------#---###-#----#------###-##---#-#--#----#-
##-#---#--#-#-------##--------#----#------#---#-##-#--#--#-#--##--##------#-#--#-##-#-------#--##-#-
#-#-#--------#---##---#---#-----##----#---##-#--##-----##-----#---#-#---#-#--##-----#----#---###--##
#-#--###--#------#--#-------#---#----#---#-##-#---#-#-#----#-------#-----#--#-#---##--##---#----##--
#----##-###---##--#-----#-----------#--#-#---#---#-------------##-------#--#-#-#--##--#---###---#---
#--#------#-----#------#---#-###----#-#--#-#-###-#------------------##----#-#-----#-#-##------#-#---
#-#---#--#---####-------#--#--#------#-###-###--#-####-#-##--#----#-#-#--##---##--##---#-#--#-------
-----#-#-#-----#------------#------#-###-#------##--#-##-#-#---##--#--#-#---#---##--#--#--#--##-#---
-#-----#-#---#-#------##---#-###-#-##---#-----##--#-#--#--#-##--#-#-#----#----#------##-----###--#-#
#-#--##-----#-#----#--#-------#-------###-#---###------#-----#-#-------##-------###---##--#-------#-
#--#---#--------##--#---#----##----#-#---#--#--#-#--#--##-###-------#---#---#-----#-------#-#--##-#-
-##-#-###---#---##----##-#-#---#--------#----#--##----#-####-------#------#-#---#----#---------###-#
--------------------####-##-#---#-#--#---##-#-------#--------##--#-----------#--##-----#-##-#--##-#-
##-###-#---##--#--------#--##---##-##--##----#--#------#---####---------------#-##--#-#--##--###-#--
-#-#--#--#-##-#---#-###-#--##------##---#----##-#---#--------#-----#--#------#--#----#---#---------#
#---##--#-#------##-----#-#----#----#---#------#--#---###--##-##------##-#--#----#-##---#--#--------
---###--##------#------------#-------#-----------#----#-------##--#####---------##-----#-----#-##---
---#-#-------#-#------#----#-###--#--#--------#-#-------#-#--#-#-----#----#-#-----#-#----#--#-----#-
-#--#---####-#-#---###-###---#-#---###---#------#--#----#------###-#-#--#----#-#-------#-#-#------#-
--###-----#-##--##--#---#-##-##-#------------------#---#-------##-#---#-#-----#----#---------------#
#-#--#-------------------#-##---#---#---#----#-##-##-----#-#-#-##-#-###-------#--##-##---###-#--#---
---#----##-#---##-##-------##-----##-#---#-------------####---###-----#----#------#-#---#----##---#-
--##--##--##-#-#--#-#-#-#-#--##--#----#----#-#-##-#-#----#-#---##-##---#-#-#--#---#--#-----#-------#
--#-----#-#-#-###-----##----#---#-----#--##-#--##---#-#------#-##--#-#----#--#-###-#-#-------#-##---
---------#-##----##-#--##-##--#-#--##--#-##------#--##--#-#-##-#----#---#--#--#--------#--#----#-#--
-#-##--------#-#---##--##-----#----#----##--##-----#-----#---##----##-##--#---#--#---##--###--------
-----####-------#---#-------##-----#--##---------#------#-#---#--------#---#--#-----#-#---------#-##
#-#----##-###------#----------#----------#-----#-###-#--#----##--#---------#----#-##------#----##---
---##------------##---#----#-#----------#--###---#-#-##-------------#---#-#---#------#---#-----##---
--------##--#--#-#--#--#--#-##-#---#-#-##------#-#--#------#-#-----#-#--##---####--#--#----#---#-#--
##-#-#----------#---#-#-##--#-#-#---##-#----##-#---#-#----#-------#####-###-------------#-----------
#-----#------#-#-####--------#-###----------#---#-#-#-##----#-#-----##------#--##-#--##-#--#--##----
---#------------#------#####---##---#-#-#-#--##--##----#--#--##-----#--###--#--#-------#-##--#-#--#-
----#-###------#---####--#---#---#--##--#-----#--#-----#--##-##-##--#-##-#----##--#--##----#-------#
#--#--#-#--###-#--###-#------#---------#------#-##--#-##--#----###----####--#---#---#-------#----#--
#--#--#-#--##--#---#---##-#-#--#---###-##-#--##---#----##-----------##-----#---#-#-#----------#--##-
#-#-#--##--#-##-##--#--##-#---##--#-#-#--#--------#----###--#--------##-##---#--#--##---#--##-###-##
--##-----#--#--#-#-----------#--#--##--------------#------#---#---#--##---#----#-##--#----#------##-
---#---#-#-#-#--#-#--#---#-#-#--#--##---------##---#--------#-#--#---#-#--#-#-#####------#-----#---#
---#------#----#--------------###-#-##--##--#--#-------##-------##-###----#---#--##----#----#-#----#
#--------#-##------#-###-#---#--------#--#-------#--#-------#--------#------#-----##-#-#--#-----#--#
--#-#----#--##-----#---#------------------#----#-----#--#-#-#-----#--###-##-----###-#--#--#--###-#--
--#--#-#---#----#--##----------#-#---#---------#-#--#--##--###--#-----#---##--##--#------###--#--#--
--------#--#--#-#----##------#--#------#---------##--#-#--#--#--#-##----#---#---##-#-##-###--#-#--#-
-###--------#---#-#----#-#-----#----#-#----#----#--###-##-#-#-#----#-##--#--#--#---#-#--##-#--#---#-
------#----##----#------###---#-----#-##-------#--------#----###---#-#------#-----#-##---##-#-#-#--#
-#---#-----#--#----------#-#---##---#-#-#-###--#---##------##---------#-##-------#------#--#-##---#-
-------#----#--------##----#--#--##-----------#-#-----#-------#--------#--#------#--#---#--#--#-----
#--##------#---##-#---#---#--#-#--##-#-###-#---#-#----#-###---#--##--#-----##--#---##--##-------#---
-----#-##---#-##--#-----#-------#--##--##--#---##----#--#-#-#-#-##----#-------##------#---##--#-----
-------#-#--###----##--#-#--#----##-#-#####--#-#-#---#------------#----#-----------#--##-##----#--#-
-----#-#---#----#----#--#-#-----#----#--#---#--#---##--###----#---#-----#--#-###--#---#-----#-####--
-#-#-##---#-#----#--##-#--#--###--##-#------#--###----#---#--#---#--#----------#----#---##-##-----#-
-----##--#-----#---#-#--###--###-#-------#--###-#-----##-----#-#-#-#-----------#-----#---#-###--#---
##----##----#------##-----#-----#-----##---#--##---------------##-#----#-------##-#----#------###---
------#--##-#----##-#----#-#-#---------##--##-#--##-##----------#-#-#------##----#-#-#--##----#-----
###--#-##---#---#-##-------#------#-##----#---#-----##--#---#---#--#---#-----##-##--------####------
######--#------##-#--##-#-##--------#---#-#----------------##--##------#-----#------#-#---#-#---#-#-
##-###----###------#---#----#-######--------------------------#---###----#---#--#-#-------#-#--#---#
---##--#-##-----#------------##----#--#------##-#----#---##--#--###--##--#-----#--#-#-----#--------#
-##--#-------#-#--#-------#-##-#------#-----####-###------#-----#----#--#--#####--#-#-#----#--#---#-
----#-##-#---###----##--#-#-#-##-------#--#--------#--------##-#-#---##---------#-#-------#---------
##-#-#---###-##-###--#-##--------#-----##------#-##-#--------#-#--#---##----#-------#--------#--#--#
--#---#-###----#-##----##--#-#-#-----#--------#---#-----#--#--#-----#---##--#-#-#--###-##-###-#-----
--##----#--#------#--#--#--------------#--#-#--###-#-----#--------------#-----##----#-----#------#--
-##--#---------###--#---##--##-------#---------#------#--#--------#----#------##--#-##-#--###-#-#--#
--------------#-#-#####------#--#-#---##-------#--#------------#--------#---##--#----#--#-####-##--#
-###-##-#-#---##--------####--------------##-#-#-##-#-##---#----#-#----##-#-#---#-----##--##---#---#
