--#-#---##----##-#-----###--#---##----#-----###-##-#-----#------#----##----###-##-----###-#--#-#---#
-#---##--#--###----#---------#-#---#-#-#####--#--#-----#--#--##-#----#-----#------###------#--#--#--
--#-####----##---#--#--##--#-##-###-----#---#---##-##-#-------#---##----#----#-#-##-----------#-----
----#---#---#--#--##-----#----#--#-#---#-----#--#--#---##---##----#--##-#---##-#-----#-#---------#--
-#---------#---##-#-#-#-#--#----#----#------##-#-------#-------#--------#####-#-##-----#-------#----
----###----##-##--#-#-##-----#--#-------#-----------------##-------#--##-------##-#--#-----###---###
----#-#-----------#--##---#-#----#-#-###-#---#-#----#--#-##---------#-#---##--##-##-----#-------#-#-
#-#--#--------#--#------#---##---###-##-##---#-##------##--------#------------#--#---##-##-#--###-##
--#-#---#######--------#---##-------#-#---###----#-###---------##--#-#-#--#------#-----#--##-------#
---##------#-#--#--------#--#---##----#--------#--#--##---------##--##-----#---#---#-#---#----------
#-#-#----#-#--##-#------#--#---####----#-------#-#------#--##---------------#-------#-#-###---------
---#---#-----#----#--#E#--------#-#---###------#--#--#---#-----#-----#---#---#-####---#-----#-------
#-#------##-#-#-###--#-----#--#--#--##---#----#-#--#----#--#-#--#----#--#--##-----#---##------------
-----#----##-#-------#--------##------#-#---####----##-------#-#-----#----------#--------#--#-#-#--#
#-##------##----#--------#-#--#-#--#-----#--##---------------##-------------#-------#------##-#--##-
###-#--------#-----##-##---#-------###--#-##--##--#--#----------#--#-------#---#--#--------#------#-
--------##--###-#---####-----#--------#------#-#-----#-----##-#-----------##---#-#-##---##-###------
--#----#-#---#-#--###----##-#---#--###----####---------#-#----#--------#--#-##--#-----#--#--------#-
#----#---#---------#-#--#-###--#-##---#--------##----##-##---###--##-----#-#-###---#-##----#-------#
-#---#----##-----##-##---##-#----#---#-##--#-#--#---#-####---#--#--#-#---#-#--#------#---##-###-#---
-#-----##-##---#----#----#-###----#--#-##-#----##---#--##-----#-----#------------##------#--#-------
------#-#--------#-##-----##----#-----#------##--#-----#-------#-----#--#-----#-#---##-#-----#------
---#-#------#---##--------------####--#---#-#-###---#------###--###---#-#-#---#--------------#----#-
-------#-----#-#-----#-#-----#-###--------#---#-#----#--#------------###-#--#####------##--#--#--##-
---#--##--#----#------#--#---#-------#---#--#-#-####-----#---#--#------#----#----#---#-------#--#-#-
--####-------#---###-####---###---####--####---#--#-------###------##-------#-----##--##-#-#--#--#--
------#------#-----##-----#----#------#----------#-#--###----#---##--##---------#-#-#------#-#----#-
----------##----###-###--#-#-####----#---####-------#----------##-#------#-#-##---##----#-----#--#--
--###----#--#----#---------###-#-#-#-##------###--#---##--#------##----#-#--##---##---#----###---##-
----#---#--#--------#-#------#-#-#--#-------#-------#---#--###-#-#----#-##----------#-##---##---##--
------#--------#----#----#----##-#-#---#-##-#---#-#-----#-#--------#--#---#--#-#-------##-##-#------
-----###-#-##--#--#-#-----#-##------##--##---#---#-------#---#----#--#----#-#--#--------##-----#-#--
--#----#-#---##---##--#######--###-###-------#----##-#-------#-#-----#-#---#-#-#-#-#-#--##-##-#--###
--------#------#-##-#-#--##-#------#---#--#---#---#---#-#-#-------#-#-#-#--------#---#----------#-#-
#-#-#-------------##--#-#-###--#--##---#---#----#-#-----#--#-##------###--#------##---#-####--------
##--###----------#--#-#---#---#-#---##----###-#--##----#---#####-#----#------#-#-#---##-##-------##-
-#--#-#----#----#--#-#----###----#-##-------------------------#-####-----#------##----#-------#---#-
##-#---#-##--#-#--------#--##--#-#----#--#-##---------###-##----#-----#-#-#------#--##-----#--#----#
#----###-#--#-----##-##-##--------------##----#-----#--##----#-##---#---#--##--##--####---------##--
--#----#--#---#-##-----------#------##-#-#-----#---#-#--#---#-##-#---#----#-##--#----#--##-#--#--#--
-#---#-------##----#-#----#-#----#-#-##---#---#-------#-----#-#------##-#--#-------#--#--#----------
-----#------#---#-#-----#-##---#-----#-##--##-------##----###--#--------#-#-#-------###----#--#----#
-#---#---##-#------#--#---###--------#---#--#---#------#----#---#--##-#--#---#--#---#-#-#----#####-#
-------###-#--#-#----#-#--------#------##--#--###----##--#-##--------#----#--##--#------##---##-#-#-
#---#-#-##--##-#---#-#--#----#-#----##-#------##--#-##-#-###--#-#-#--#-------#-##-###--#-#-#--######
---#-#--##-#-----------------###----##--##-----#-#---#---#----#-#--#-----#---#------#-----##-##-----
-#---#--#--#-#-#--#-#------#-#--#-#----------------#----####----#---##-##---#----------------##--#--
-#------#---#---#-------#----#---#-#--#----#---------#-#-###-##-----##---##---#-##-----#----#-----##
#----##--#-----##--###------#-#-#----###----#---##--##------------##-----#--#------#-#---#----#-----
---##-------##------#-#---#-####----#---#------#------#------#----#-#---#----#----------#-------#--#
-#-##----#-#-------#---------#-----#-----------#----##-#--#-------#-------#--##-------------###-----
------#-------#---#--------###-#--#-#-##-------###-------#-##--#-###-#--#-#-#-#----#---#-##----#-##-
--#------##--#-#--##--#----#------#-#-#-##---#----####-----#--#-S-------#-----###---####------------
-----#-#--#----#--------##-#-#----#--#-#-----##-###--#--#-#--#-##---####--#--##--#-##-----#--#-#----
--#-#------##----------#-#-#-#---#-#-#-#-#-----##----##--#---#--#-#-#---#---#--#-----#---##--#------
#--##-####-#---#-------#---#---------#--##------------#--#--#---##--#--------##---##-###--#---------
---#-#--------##-----###------------#---##--#-----#------####-#--------#####---------#----#-#-###-#-
--#####---##-#----#--#----#----#-#--##-#---#--#-##-------#--#-##--#-#--#--####----------#---------##
-#---#-##-#-##---#----#---#--###-------#--#-##-#-----##--###-------#-----#--#-##------#-##-#--------
#-----#-#-#-----#---#--##-####--###-#------#-------#-###----#---#-##-#--#---#---#--#-----#--#-------
------#---#--#---#--------#--#---#-###-#--##----#-#----##-#-#--#-###-----#---#-##-#-#---------#--#--
#-----#------#----#--#--#---#----###--#---#-------##-#-#-#----#--#---#----#-#---##-####-#--#-###-#-#
--#---#-###---#-#-#---#-#------#-#----------##----#----#-###--#--###-#----#---##-----------###--###-
-----#-----#-#----#-#--##----##--#-#--#-----####--#----#--#--####-#--#-----#-###--##-#----------###-
#--#-##---#-##--#-##---#-##-----###-----#-------------#####--#-----#----#---#-#--#----#-###----#---#
--##-----##----#-#----#----------#--#-##-#-##-#--#-#---##---#----#-###-----#------#-##--#--#--#---#-
--##---------#---##-------#-----#--#--#-#---------##--#------#-#----##------#----##------#--#-------
#---#--#--#--#####--#--#-----##---#-#--####-#-##----###----##----#---#-#---#-#---##--##--#-----##--#
---------#--###-------#--##-###----#-----#----#----------------#---#--##-#--#-----#-----#--#----#-#-
#-----##--#---#--#----#--#--##-#---#--##---#-#--#-##-----###-#-#-----##--#-#-#--##---#--#-#-##------
#-#---#--#-#-#----#---#----##---#-----#-#-##-------##-#-#---####-##--#-----#--#------##--#-----###--
-------#---#---####------------#-#--##-----##--------#-#-#--##-###-#--#----###-------##-#----------#
-----------#-----#---#---##---###--#-#-#-#---##-------#------#---##----#-----#-------##------###----
--#--#--##---#---##----#-#------#--##-#------#------------##-#--##--#------#------#--##-#-------#--#
-#---##---##-#-----###-----------#------------#---##--#--#-###---##-#--####---#--#-----#-#-#-#-##--#
---###----##----------##----#----------#--#--------#-##------#-----#----#--##--#--##----##--#-----#-
--#--##-#-#-#--#----#----#----#---#-------#-##---####----#--#-#-----#---#-----##---#-------#------#-
-#------#--#---#-#--#--#--##--------#--##-#------##----#---#----##----#----#-#-#--#-#----#-###--#---
------####-#----#----#-#----#-#-----#---#-#------#---#--#--###--#----#---#-#-#----#-----#-----#-----
---#-#-####-#-----#-#-###--#------#----#--#-#--#-#-----------##---#--#---#-#-#-#----#--##-----##-##-
-----###--------------#-------#--#----#--##-----##-#-#--#-----#-----##-----#-#-------#--#----#------
#--#------#-#--##-#-##----#----------------#-#----#--#-#--#-------##-#-###--##----##--------#--##-#-
----#-#-----#--#---#-#-#-#-#--------#--###--#-#------------#-###-------#--#-#----###-#-##-#-----##--
#-#--#---#--##--#--------##-##--#---##-----------#-#--#---#--###-#-##-#----#--#---------##---#--#---
--#-#----##----#--#-#-#----#-##-------#-#-#-#-#-##---##-###-------#----#-----#--#--------#--#-------
--##------#-##-#-#----#--#---##----#----#------#-----------#----#--------#--###-#-#--##----#--#-###-
----#---#-##---#---##--##---------##--#------#----#-------#--#--#--#--------#----#----#----#------#-
#-------#-----##------#----#--#---#-##---#-#--#-----#--#--##-#-#-#-----#---#-#--#-#-----##-#-#--#---
#---#---#-#---###---------##-#-#-#####--#--------#-#-#-#----#---------#--####--#---##-----#-----##--
#---##-##-#--#--###--#-##-##---------#--#---#--##----##--###--#---------#-#---#--###-----##-##--#-#-
--##-#-----#---#------#--#--##---#-###---#--###--#-#-------####-##-#---#-#-#------#---#--#--###-#-#-
##-#---##----------#-#---------###---#-#-##--#--##-----#--------#------#--##-#--#------#-#-#--#-#-#-
-#--#-------#-------#-----#--#---#------##---#----#-#-#-----#-#---#-#-----#--#-##-----#------#####--
###-----##-#--#-----##-----##-##-----##---##---#--#--#---##-#-###--##--##----#--#--##------#-----#--
##-----##---------##-#--#------##---#------#----#-------#-----#-#-#--#-------###-#------##-#--------
-##--#---##--#--#-#-----#-----#---#-#---#-#-######--------------------#-##--#---##-#--###----#---#-#
-#-##-#---#-----#-#-#--#--###------#---#-#-#--##---#-#--###-##--#-####--#----------##--#-------##---
###--#------#------#-#----#---#-#-#--#-#---#----##-#-#-#---------##-##-#-#------###-----#---#--##--#
----#-#----#---#--###---#----#---##-###--#-#-#---#-#-##--#-#----------------------------###------##-
--#-------#-----#----#-#--#-##----#---#-##-##----##-----##--#-----#--------##----#---#---#-#---##-#-
