#-##-##-#------#--##--##--#--#--#--------#--------#----#---#--##-#--#----#-#---#-#-#--------##-#-##-
-#------#####-#-#--#----#-#--#-----##--------#---#--#-#-#------#---#---------#-#------#----#-----#--
-----#-#-#------#-----#--#-------#-#---#------#---#-##----------#-----#-#-----#--#--#--#-##-#--#-#--
-#------##---##-##-###-#------#----###--#-#--###-#--------#-#--###---------##---###--#----#-#--#---#
--#-----------#---#--------##------#----#-#----#---#---##--#-#-------#-#------#-####------#-#---#--#
#------#-#----#-##-#---####---##---------#-#------#------------------#--#---#-##-------#---------###
-----#----#----#------###--#-----##-#-#-----------#----###--#------#--#--#---#-----#-#-##---------#-
-#---#--#-#---#--#-#-##--###------#---------#-#-###--#-#------#--#-----##----#----#----#-#---##----#
#--##-#--##---#--##-#---#----#-######--#-#---#--###--###--#-#-----###------##--#------##--#-#-#-----
#-#---##---##----#-#--#--#------#--##--------#-###---#---#-#-#-------#-----#--------#-------#-#---#-
--##---##----------###------------##-----#-#####-###--#--#-#-----###-#-###---#-#--#--------#-##-----
-##----##---#----##-##--------#--#--#----#-#----#-#-----#---#-----#-#-##----####---#--###--#----#-##
---------#-##--#-#--##-------##------#------#----#--#---#-#-#-----###---#-----##----------#-----#---
-##-#--#---#-##--#---------#-##---#--#####----------#-#-##----##-------------#---##-#-#--------#----
---#-----#-##-####------------#----##---#---##------#-#-#-##--#####---#-#-#-----#----#-----#--#--#--
---#------#-----#--#--##-#-------#---#--#----#------#----##--#--###----##---------#-------##--#-----
------#---#----##-##---#-#-###---##-#-#--####-#-------#-#####-----#-#---#---#------#-##-#--#--##----
-----####--#---#---#---------#--#--##-##-------###--#----------#-#-#---#----##----#--#---##-#---#---
#--##----#-#-#-#----###------#-----##---##--##-#------#---------#-#------------#-##--##---###------#
--#-##---#--#----##--#-----##---#-#---#-####---#----#-#------#--#---#-#----------#---#-#-##-#---#--#
----#---#------#-#-#--##-###--##-#---#-#--#-#--#-#---#---#--#-####-----#------#-###------#--#--##---
---#---------#-#-#------#---#---------##--##---#---#---#-#-#---#---##--#---#-##--##---------------#-
#-#-##-##--##--##-##-------##-#------------##--#-----#--##--###-####-#---####-#----###--###-##----#-
-----#--#----#--#--#-#-----#------#-##-#-----##--#--------#-#-----##-------#-#--##-#---##-----#----#
#-#--#-------#-######--##----#-#-##-###-#--------###-#-#-#-#---#-##-------#------#----------###-#-#-
-##---#---##-#--#---------#----###--##-#------###-------#-#---#---###--------###--#-##----#-#----#-#
--#-----#---------#---#-#-#----#--###-##----------#--##--#----##----#----#-----#--##------#-##--#-#-
#---------#--------#-#-##-#-##---------#-#-----##--#-----#---#-#-#---------####-#--#---#--------#---
-#----#-###----#-----#---#--#-#---#--#---##--#------------#--#-------#--------###-----------###---#-
##------------####-#-#-#-###-#------##--#--##--#---##-##------##-#---#-##------#------#-#-##----#---
#-#-##---##---#-##-----###--#-----##-#--#---###---#----##-##----#-#-------##----###---###--#-#------
-#-----#-#-----#--##-##---###------#---##--------------#---#----#-----#--#--##------##--#----##-#---
---#-----####----#-#-##-#-#------------#--#--#-####----#-###--##-##--#---#--#---#--##------#-##-----
#-#-#---#-#---##--#-#--#-#---#-#----#--##-#--#----##---------##-------#-##-#-#-----#----##-##-#-#-##
-------#-#-----#---#--#####-----#--#--#--##-#-#--#----------#----#----------#-##-#------##------#-##
-###---#-#-##---#--##-#---------#--#--#-------#---------#--##-#-------##----##----##-#-------------#
--#-##--#-#--#-##------------##---#-#-#-###---------------------------#-#-----#-#---##-###-#-#--#---
-#-#----#-#----------#--#----#---------#--#---#-#---#--##----#--#--------#---##-###--#---#-#--#----#
-----#---##-------##--#--------#-###------#-#-------------------#---##---#----#-------##-#----##-#--
#-#--##------#------#--#---#--#-#---#---#--#---#--###-----#---##-##----#---#-#------#-#---##-##----#
#-----##----#------#---#--##--------#--#---#--#---------#---#----#-#--#-------#---------#-#-------#-
##------#-------#-#-##-------##--#-----#---##--#-#--#-#--#-#-#-------------#-#--#----#---##---#-##-#
--#---#-----##--#-#-----#---#-#--#----#--#-#------------##-#--#----#------#-##-##-------#---####-#--
---#----#------#----#-----####-------#---#-####-#----#-------###-#-#---#----#-----#---#--------#--##
----#--#-----##--#------##------#--###-##----#---#---------###--#--#-#--#-----#------#-----##------#
-----#----#--#----#-#-####--#-#-#-------#--#---#---###-#---##--#--##-------#----#E#----#----------#-
-###---------#----------#-#--------#-----#-#--#---#-#-----##-#--#-----#--------#-------------##---#-
##--#-------#-------#-#####------##---#---#--#----#--###----##---#---------#-##--##---#--#-----#----
###---#---##--#-------------##----#-#------##--##--------#-#---##-----#----#---#-#-#---###--#--#-#--
--------#-#---##---#------###--#---#--#-##-#--##-#-----#-----#---#-#------------####-##-#-----------
-##--###---#-------##-#-#----######---####--#--#-#--#--#--#--###--#----#-##---#---#--#-----#-#-#-##-
--##--------#----###---#---#-##-#-#-#--#-#------#-----#---#-##-#-####-#--#-----##--###-#--##------##
-#---#-#-#-##--------#--------#----#--#-----#------#-#----#-#---#---#-###--#-----#--##-#--#---------
-#-----------####-------#---#---##---#---#---#-----------#--###-#----#--#-#------#----####-----#--#-
--#------------#------#--#-#-##---#--#-----#-#-#-----------##-----#------#--##-------##-##--#-----#-
#-----###---#---#---#---#-----#----##--#---#-#--#-#---------#-#-##---------#--#--###-#--##-#---#----
---##-----#--####-##----#--#----##--#--------------#-------##--#---#---#-----##----#---#----#----#-#
-----#-#---#----------#---##---#-#-###--#-----##---#---------###-##--#-#---#-#--#-#--------#--###-#-
--#-----#-----###--#-#--------#--------------#-#----#----###----------#-###---#-#---#------#-----#-#
###-#-#-###-#-#-----#-##--------##-#--#--##----##---###-------#--#--#--#--#-#--##-----####--#--#----
-----#-----#---------#---#------#---#----##-#-#-----#-#-##-#--------#-----##-#---#-#-------###--#--#
#---#----##--------------#------##----##-#-----------##-----###---#--#-----#---------#-###---#--##--
--#---#--##----#-#------#-#--#----#-----#-#-------#----------#--##-#--#-#-#--#------#------##-------
-------#-----###-###-#--##----##-##-----#--##---#-#-#-#---------##-----##---###--###---#--##-###--#-
-------#-#--#--#--#--###-#--#--##------##--#---#-#-----#-----#-##-#-##----###-----------#-####------
-####--##-#-----##--#------#-##-#-----###-###---##---#--#--#--##--------##-----###--##---------#----
-------#----####--#--##-----#-#---------###-#---#---#------------##--##--###-----#-----#--#-------#-
#----#----#-##------#-----#--#--------##-#---------##-##---#----###--#----#-#------##----#-#-##-#-#-
-###----#------------##-#-----#-##---#-#-#-------#---------#------#--#-##-###--#------------#--#---#
-#----#---#---#-------#----#-#----#####------#---#--#--------#-#--#-##-#---#--###--##-#-#-#-#-------
-#-#---###-#-##-#--#-#---#---#----###----##-#----#------#----#---#-------#--##--###-------####-----#
---####--#-----------#--####-#-#-##---##-##-----#----#------#------#--#-#-------------------##---#--
---##-##---#-----#-#--#------#-#--#---#-------#-----###-#---#------#--##---------------##-----#-----
#-#--#----#---###-##-##--#-#------##--#--##-#----------#--#-#---#---#-##---##---##-###------#---##-#
-#---###-#---##-----#--#-#--##------#-#######-----------#--#-#----#------#--#--##--#-------#######--
----##----#-###------#-----#--#------------------#----#----#-----#----------###------#---------##---
-#--####------#-#--#-##-##----#-#----##-#-#-##-----##-#--#------##-###--#--##-#-#------#---#-##-----
#-----##-----#--#----##-##-#-#--#---#-#-#--#--##--#---#------------#--#-#-----##------###--#-----#-#
------#--------#-------#---##-------#-#--#---#-#----#----------#--#-#--------#-#-##----###-----#--##
#-#-----------#-##----####-##-#---#-#----#--#--#-#-##---##------#----#----#----#-#-#--##----#----#-#
#-----#---##-##--#-##-----###---#----#-------#-#--#--###-###---##----#-##-#-#---#---------------#--#
----#--##--#-##-#-#-----------#-#--#-##----#--#---#---#-#---#----#------------#--------#----###-----
-----#------##-----------#--------------#-##----##----#---#--------#---------##--------####--#--#---
#-#-#---#-#--------##-#-----#-#---------###----##-#---#------#---#-###-##------#----#-#---##--####-#
-##----#------#--#----##---###--#--#--#--------#------------##---##-----#-----##-#--#--#--##-#----#-
--#--#----#-#S#-#--##-#---##---#-------#----##-##-#-----#-#--#-------#----#--#---#-#-##--------#--#-
------#####-----#------###---#---#----#-#--------#--#--#----#--------#------##-##--#---#-------##-##
#-----##-#---#-##--#-#--#---##--#-#----##-#----##------#--#-------#---#-#-#-#---#----#-#---##------#
---------####---#----------#-#-----#---##-----####--##-##----#----##--#------#------##--####-----#--
----##-#--------------#####-#---#--##--#----------#---###-#-------#-##--###-----##-#-#---###------##
--#-----#----##--#--####--#-#-----#-##--#---#--#-##----#----------#-#-#-##-----#-------##-##--#----#
#---#---#--##-#-------------#---#-#----------------##-#---#--#-#-----------##---------##-#----------
#---#--##--#--#--#----#------#--------#-#------#--##-#-#--#---#-#--#-#--#-----#--#--------#-#----##-
-##-#--###-#-#---#--#-#--##----#######------###---##-#----##-#--#--#-##----------#--#-#-------#--#--
#-----#----##---##--#-#------#---------#----#-##-#-##--------##-#####------#----#-#--#---##-##-#-#--
#----#----####-#---##-#----#--#--#---#-#-#----###--#--##-#--#--##----####------#-#--#-##-##------###
#--##--#--------##-----------##-------##--#----#-----##-#------------#-#-##--------##-##---#-#-###--
---------###--------#-#-----#-------#-##-#-##-##--###--#-----#-#--------#---##---#-##-##-#---------#
---#--#--#--#--#---#-----###--#--####--#-#--##-#----------#--#---#-#-----#####----###-------#-#--#--
--#-####-###-#-#-#-#--#------#-------#------#--##----##-#--------###-#-----#-#-#-#-##-##-#-#---#-#-#
