#--#----#-----##----##-##---#-###-#-----#----#----#---------------#--##-#-#--####-----#--###-------#
#--######----##-----------#-#-#-#-#----#-##---##-#---------###---------#-#-##-----#-------###-#-----
#-#####---#--#------#-#--#-##-##------##----#--#---##----#-#-#--------#-----##----#--#----##---#--#-
-#--#-#--#---#----##------#----##-------#--#-#--------------#-####------##---#--#--#-##------###-#--
----###------#-##-#-----##---#-##-##---#-#----#-------#-#------#-##-#------#--#-###--#---#----------
#--#-#---#---------#---##-#####----#---#------#---#----##-#----#-----#----#----#-##-#---##-##-#-----
---#--#--##-##-#-##-------#-#-----#-#-#--#-##--##-#----#--#-----#--##-#-####----#---#-----##----##--
--#--###--#-----#-----##-----#-#-----#-#--##--#-----#---#---------##------##-------##---#-----------
-----#--#-----------#---#--#--#---#-#-#-#---------##---#---#--#---#-#--#--#---##---#-#-#-----#--####
-------------##----#---#----#----------#-#---#----------#------#-#----##--###--######--#-###-#-##-##
---#-#--#---#--#--#---#--#--#---##--#---#-----------#-------------------##----#-##--#----##-##--##-#
----#--#--##----#--#------#----##----#-#--------#----#-#---#--##-###-#---###--##-#-##-##--#---####--
#-----###--#------####----------#---#---#-###---##--#----#---##-----------#-#-#---##-##--#--#---##--
---##-----------##---#--#--##------#----------#-#---#---------#----#-#----##---##--##----#---#--##--
-##-------###--------#-#-------#---#-#-#------#-#-##--------#------##-#---#-##-----#----------------
-##---------##--#---#--##--#-##-#-#--#--#---#---#-#--#---#----##---#-##-----#---##----#--#---------#
---------#-----##-#--####-------#-----##---#----#---------##--#--#--#-----#--#-##--##---#-#--#--#---
#####--#--#-----#-------#----#--#----###------#---###---#---###-##-#-##----###-#----#-##-----##-----
#-#-----#-##----###---##--##--#---#--#-##-##-#-##-----#-------#----#---#---##--#-------#------------
#-------###-#------##--#-##---#---#-#-##--#-#--#-----##--#-#-----#-#--------------#---#-#-----#---#-
--#------#------#--####-#---#----#--------#-----------#--#--#-----------##--#-#-######--#-##--###---
----#---#-#-----###------#------##-#----#-###------#---##--##-#----#---#----###--------##----#--#-##
---#---#-------##---#-#------##-#--#-----#-------#--##--#-#-----------#-------#---###----------#-##-
-##------#-#---------------------#-#----#-#---------------#--#----#####---#----##------##---##------
##-#--###--##-#-#-#-##--#---#--##---#--------#----#--#------#S--####-#-------#------#----#---#-#-#--
--#-##--------##------#-###-###---#----#--#------#--#-#--##--#--#-#--##-----#---#--#--##---###--#---
-#------------#-#----##--#-###-#-#------##--#-##-###-----##---#----------#-----#-----#-##---#----###
-##-------#--------###-#-------#--------#-#-#-#---#-###---#---#-##-##-----#------#-#--#--#-##-------
--------#--#----##-----#----##------##---###--------##--##-##------#-------------##--#---#-#--#---##
--###-#-#----##--#-###---#--##-#-----#-#-#-##-#--#--#---#-#----#---------#---#--#--#--##------###---
----#------#-----##-#-##-#----#-#------------#-#-----##----#---#---#--------#---#--------##--#----#-
#----#---#---##--##--#-#----#---#-#----#--#####-#----##--###------#-#-#----##-#----#---###----#--#--
#---##---#-------#--#--##---##--------#-#--##--##--##-#-#-#----#-#----------###-##-#---#----##-###--
#--#----##-----#------#-#---#--#-##---#--------#-----#--##---#-##-#--#-##-##--#--#---#--#--#-#-#----
###-##----#------#-#--------------#---#----#--#-----#----------#---#------######-------##---#-------
#----#--#-#----#--------#------##---#---#-##--#--#-#----#-------------#---#--##------------#------#-
#-#---------#--#--#-#-#-----#-#------##---#-#---##-##--#-##--#-----###--#--#-#------------------#---
-----#-####----#-#####------###--##---#-#-------#-------#-#--#---##-#-------#---#####---#--#---##--#
--------#-#-----#----###-#-####-#-------#----##--#-#-------#--##-----------#--##--##------#-#--#--#-
-----#-#--#--#-#####----#--##-#---#-##----------------------#--###--#-----##-----#--###----#--#---##
--##-----#-------#--------##--#--#---------#-#--#----######--#-##----####--------##----#------#--#--
#---#-#-----##-----------#-#-##--#-#----##------#-------#-----##-##-##-----#-----#--#----#----------
-##---#--------##----#---#-#----#----#-#---##---##--##---#----#---#-##-----#-#-----#-##--##---#---#-
-----###-#-##--#---#-#----##--##-#-##---#--#--------#----#----#--###----##--------##-#----##---#----
-###--##-#--#####-#---#---#-##-#--------#---##--##----#--##---##-----##---#-----------##-----#-----#
---#-----#-----#-#--###-------#--#-#-#-##-----#--------#--#----#---#---##----#--#---#-##-#----------
#---#-#-###---#--#-#------#---##---##---------------##----------##----#-#-----#-#-##-##-#-#------#--
------#------#-#-------##-#-#----##-#--###-----------#-#---#------#-#---#-#-----#--#-#-----#-#-#----
-#-----#--------#---------#----#-----#---#-----#--------#--#--#---------##--#---#---#--------------#
---###--#--##-#--##-###-#---#---#---------#---#------#-#-----#-#-----#-####---#--#----##-----#------
---#-#-#---#------#-----#--#--#--#------###-##-#-#-##---##---#---##-----#--------#-----##-----#--#--
-###---#--------#---##-#-#---#--#---#----##---#-##--------##------##--##-#--#--#-----#--#---#---##--
#-###-#-------#-----#--#----#-----#---#--##--#-----#-##-###--#-#----#---#-#------#--##----#-#-------
-##--#--#-##-#--###------###--##-----##--#-##----#-------#----##-#-##-#----##---#-#--------------#--
#----#---#--##--#-#--#----#--#------------#--#----###----####-#---##-#-#-----#-#-##-#-#--#-#------##
#-#--#---#-#-#----#-#-------#-###--#-----#-#------#--#------##--#-#----#-###---#--##-##--#---#-#-##-
##-#-#-----##---#--##----#-#-##-----##--#--##-#--------#-##-#--#--###------##-#---###-#-#-----------
-###----#----#--###-#-----#----#-#------#--#####-#----------#-##---#-#-----#----###--###-#-###---#--
----------#-#-#---------#--#----#---------#---------###--#--##-#-##---#--------##-###----#---#------
-------##-#--##-#-#-----#-##---#--------#--##--##-##-##-------##-####-#-#-------#----##---#--#-----#
#-----###-#-#-----#---#--##----#-##-----##---#-##--#--#----#----#-###-##-#---##----#--#--#--##------
-##--------#----------#---#----#-#-#----#----#---#--#------#---###--#-----------#---###--#-#-------#
-----#-------#------#-----#-###--#-------#-######--------##---#--#-------#---E-#--##-##---#-----##--
##----#-------#-##------###----#-##----#---------#--#--#--###----------##--#-#--#--#--#--#----#---##
-----#-#--------##--#----#-------#-#------#----#--#-##------###-----#---#---##-#-##-#--#-#----#-----
-#--#--#---#--#----#--##-------#--#-###-------#-------#--#-##-#---##----#-#------#-----##-##-###----
#------#-----#-###---#---------#----#----------#-----#-----##-#-#-###----#-----##-------##-----#----
--#---#--#-##-##---###-#------#--#---#-#-#-----#-##--#--##---------#----#------#--#-#-#----#----#---
-#----#------#--#------####--#--#--###-#--#----#-#-----#--#----#-#---#------###--#-#-#-----------#--
-----#-----#-----#----#-#---#--#--#--#####---##-#--#-##--#----##-##-#----------###-----#-#--#---####
#----------#-##---#-##--#--#-##-----###--##-#-----##--#---#------#---#-##-#-----#-#-#---##-#-----#--
--##---------#---#-----------#-----#-----#-----#---##-----##--#----#-----#--##-#-----##---------#---
------#------#-#--##-#----#--#----------#-#--------#-#------##-#-#-----------#-#---###--##----------
#-#--#--#------#-##--##--##--#-------##----###-----#--#----#-#---##----#---#----#----#--#---#---#---
---#-----#--#----------#----##-----#--##--##-------#---###---#----#-#-#-#--#------#--------#-#-##-#-
-------#----#--#--#----#---###-------------#---##--#----#--#--#-##----#--##--##-#-----#---#--###----
#-#---#---#-----#-----#-#-##---#---#---#--#----#-###-------#-----##-#---------#----##----###------#-
##-#-#-#----------#--#-#-----##---#-----#-#---#--#--##--##--##------#--#-#-#--##----#-#---##--##--##
-#-##-#-#-----###-#------------#--#-#-#--#-##--#-#####--##---##-###---#-#----#------#-----------##--
#-------##-----###----#-#-#-#---#--#------#-------#-#------#--#--#--#--#-#-##----##-#---------##-#-#
##-##---#---##---#---#--#-------#-#-#-#-----#------#--#-#------#--#--#------------#-###---#-#-#-----
-#-----------##-##--##-##------#-----#---#-----------#------#---------#-#--###------#--##---##--##--
-#----#----#-##-#-##--###---#----###--------#-###----######----#-----#-------#--##--------#-------#-
--##--##--#-----#-#-##---#--#--#-#--###--#---#----##----#---##-#------#---##-#---#--#--###-#-###--#-
-#---##-#-###---#--#--#---##----#----##--##-##----#---#----#---#----###--#-#----#----#---------#----
#-----#-------#---##-------##--###-----------##-#-#-#-----#--###--------###-#----##-----##---#-##---
--#--------------#-#--#-#-##-#---------#----#-#---#-#--#--------##-----##---#---##-#--#------------#
#-----#-------###-#--#---#---#--#-------#-##-#--##----####----------------#--------#----------##-###
-#--------#-#######-#--##-##-#-##--#----###-#----#----#--##-#-##------##-----#-#-#--#---#-#####--#-#
----------#----###----#-#-#----##-------------------#-#---####-###----------#---#-####--#--#------#-
#-#-----#--------#------###--##-#---###----#------------#--#-#-#--##-##--#---------#--#-#----##--#--
--##--#------#----##---##-#--------#-#-###---#--##-##------##--#-#---#-#----------#-#-#-#--##---#---
##--#---#--#--#-#-------#-------#------#-###-#-----#-####-###-#-#-----#--#---##---#--#-----#----#---
--#----##-#-#--#--#--###-------#-#-#--#-------##-#----#-#-####-##--#----------#---#----#-#---#------
--#-#-------#--##-#-###-----#--#-#-##----#-------##-#--#---#--#-##-------#--#---#---#----#----#-----
###--#--#---##---###--##---------#--##---#---#-------#---#-----##-#---#--#---######--------#-#--#---
-#----#-#-##--#---#--##--#----------#-#--#-#-------##---##-#--#--------#---##--------#----#----#----
---#--###-#---#-------#-#---##-----##--#--#--#-####-#---##---------#-----##--##---#---##-----#----#-
--###--##----#-##-##--------#-##----#--##--##--##---#-##----#-###-#-#-----#---#-##-###--#----#-##---
-##---------#---#--#--#-#----##----#-#--#-#--------##----#-#-------##-#---##---##-----##--##--#---##
