###---------##-#---#----###-##-------#-#---#-#--##----#-#-#----##-#---#-#-###------#----#-##--###-#-
-#----#--#-#---##--#----#--#--#---#---##---#-#---#---#-#----#-------##----#----#-#-------####-----##
#----#---#-#------#-------#--#####--#------###--#----------#####--#--##---#-#-----#----#---#-#---#--
-#-#-------#---##----#--#####--#####--#----------------#-##--------------------##--#---##-##-###--#-
#----------#-----##----#--#-#-#-#---#------#-----##------#----#-------##--------#---------#--#----##
-#---#-##--#---##--##---##-#--#---##-##-##-#---#---###-#--##--------###--##---#----#--#----#-#------
#-###--#-#---#---#---##-#-#---------#-----#-----#--##----#-##------##---##----#--#-#-#---#-------###
-----###-----##-----#----#---###--##-#-#-#-------#--#-------------#--#---######-----#-------#--#-#--
-#--#----------#--------#--#-#---####---#---##-#--#----------##--##-----#------#-----#----#--------#
-#---##-----#-###--#-----##----#---##---#---###-----#-#-#--###-##----#-----#-#-##-----##-##-###-----
#---###-------#-#--##--#-------------#-#--------##-#-----###----#---###------#-##--#---#------------
-#----#-----#-#--#--#--##---###---#-------#---#--------##----#-#------------#--#--##--#-#------#-#--
####----##----#-###------#-##--##------------##-----#--#-#-#-----#----#--#--------#-----##-----#----
-----###--#-#--#--------#------#---#---###-##---#-----#--#--##-----##----#--------------#--##-##-##-
--#----##---###-#-#--#-----#------#-##--#---#---##-------###-#---------#-------#-#---------##----#--
--#---#-------##--#-##-#-#---#--#-------#------------##--#--#------###-##-#----#-#-##-####---#------
---###--###------#-----###-#-#----##--##-#--#-#-#---#---##--#-##--------------#-------------#--#----
##--#----##--#-#----#--#-------##---#------#-#--#-#-#-#---##----#-#-#--#-#-#-##--#-----##--#####---#
-##-#-#-###---#---------#--##------#--#-----#-###---##-###----#---#--#------##---#--#------------#-#
---##----#---##---#-#-#-#------#---#--------##-#---------------##-#----####----####----#--#-----#--#
-#---------------##-----#----#--#-#-#--###------#-----#-----#---#--#-----#--#-#-#-----#----##--#----
----#-----#-#-#-#---#---#--#------#--#---#---#---------#--------#-#-------#--##-------#------#------
------#--#-----##-##-#----###--#-----#----#----------###----##--##------#---##---##-------#-#---##--
------#-##----#--------#---#--#---#--------------#---#-#----#----#-####-###------#----##-#----------
#----#-----#-#---##-------#--#------#--#-###--##---##---#--#--##--#-#--###--#-###----#-#-#------#-#-
-#----##--##-##-#------#---##-#--#---#-###--##-#--#--#-##----##----##--##-----------#-###-----##----
-#--#---------#---#-##------#-----#---------#---------------#---##---#-#--#####----##----#----#-##-#
#-#---#---#----##-#-##--#-#---###-#---#--------###--##-#--###--#-------#-#---#--##-#--#-##--------#-
--##-----##--#----#-##---#-#-#--#-----#--#-------#----#---###--##-#----------######-#--#--#------#--
#---#-#---------#--#--#-#-#-#-----##------#--#-#----#--##---------##-------#--#--#-#----#-#-#----#-#
--------#--#------#-#----##-------##----#--#--###---#-#-###--#---------####---##-#-#-----#----#-----
-#-##-##-#---#-##--#-#--------#-#####---#----------#-------##--#---#--##--#-##----#--#--#------##---
#----####----#-##------#-#---##---#---#-#---#-#-##--###-##---##-------#-----#----#----#------#-##-#-
----#-##-#-#-#-#-#-#-----#-#-###-------#----##-##----##---------#-#---#--#-#--#-######----###----##-
--#----#-#-#------------------#----#--#-----#---#-------#-#--#----#-#----##-#-##--##--#--##----#---#
--##--#--#-#-###----#---#-#------##----#---#--#-##-#-#--##-----#-------##------#--------#--#---#-#-#
-#-#--#-#--------#----#--#-#-E-#------#-------##--##-#----#-##-##--#--##-------#-#-#-------###---#--
##-#--#-#------------#-#--#-#---------#-##---###-#-------#-###----#-------##---#-###----------###---
-##-------------#-###--#####-#-###----###--#--#--#-#--------##-------#-##----#-#-------#-------###-#
--#---------#---------#-##----#---#---#--#-##---#---#---#-##-------#--##---#---#-#----#----##--#--##
-----#------#------##---#-#----##-----##-##--#----###----#-#-#-#----#-----###----#---#-------#-#----
---#-#--#------#-----#-###---###----#--------#-#---##-------#--#---##---#-#----##----#-#-----##-#-#-
-----#--#--##--##--#-#-#-#-#--#-----#----#------#----##--###---------#---##---#-------------##-#-#--
-------#--------#-##--------#-#-#-#---#-----#-#---#-----###-#---#-#------#-----#-----##---------#---
#-#-------------#--#-----#---#-------#--#--##-#---##-#-#-----##-##------#-#-#----##-####-#-----##---
-##----##-#-#---###---##---------##-###---##-#--#-#-#-#----#----#----##-#----#--##-#-#---##-#-#---#-
#---#---#---####----#-#-###-#--#-#--------------------#-------##--##----##---#-#-#---##--#-#-##----#
-#----#--##---------#-----###---##--#-------#-#--#----#---##-##---#####-------#--#-----#---#-#------
#-#--------#---###---#-#--##----#--##-#-#-#---#-#-##-##---#-###-#----##-#--#----##---#-----#-##-#-##
##-----####----###-#---------------#------#-##--#--#----#---##---#---####-----#-#-----#------#--#-#-
--#--------#-#-#----#--##-----------##--#---#--#-####------#---####----#-#-#-----##-##----#-#---#---
-----------####-#---#----------#-#--##------------#-#---####--#---#--S--------#--------#-----#--#---
----##---#------#------##---#----------------------#--------###-----#--##---#-#--#---#-----#--------
----#--------#-#---#-#--#---#-#---------##--#---###----#-#-----#--#--#--------#-----##--#-#------#--
-------#---##-#--#--------###---#----------#---##----#----##---#----------------------##---#--#-#---
--#----##-#--#------##----##-#-----##---#--##-------##--------#--------#--#---------##-----###----#-
-#---##----#---#-#--------####-------#-#---###--##--#--#---###------##-----##---#----#-#---#--------
---#-##---------##----#--#----#------#-------#--#-####-##--#-------------###-#---------##--#-####--#
-#--------##------#-----#--###-#-####-#--#-#------##---#-#----------#--##-##-------##--------#--#---
---###---#-##-#-----###----#--#---#---##-###--#-##----#---------------###---#---#----#----#---###--#
--#-----------#-----#------#--#------#---#---#-##-#-##------#--#--#------------#-----#-#---#--#-----
-#---#-#----##------##--------###-----###-----##-#---#----#----------##------#----#-#-#-----#--##---
--#-#-#-----##--#-##-#----#----#----#-#---#-#-##----##-#-#-------------##-----#--------------##-----
-#-#------##----#------##--#------------#--##-#-#----#-#-----------------#-#-#-----#-##------#-##--#
--#-#---#--#--#-#-#--#----#-------###-#------#-##-#--#---------#--#--#--##--##----#-----#-####--#---
-#-##---###-###---#---#---##----#--#---#-#-----##----#---####----#---------------#--###-###-##-----#
#---------##-------##---#-#-#---#-##--###-#-----#--#-#-#--####--#-#--#-------#--#--###--##---##---#-
-##--#-##--#-#-----#--#--#-#----#---##-----#-#-##---##--#-#-#---#-##---------##---------#----#--#--#
-------##-----#-#---#-------#-----#--##---#----#-#-#-#---#------#-##---#--#--------#---#---#-#-##---
-#--#-#----#----#-#-----------###------#-#---#------#----#-##------#-##--##-#-#-------#--#--#-------
---#--#-#----#-#---##-##-#----#-#----------##-----###-#--------##-#--#-##--#--#---#-#-##----##-##---
---#-#-#---#--####---#---#------#------##--#-#----------#-#-----#---#-#-###-##---##-#-###----------#
-##----###----##--####-##-#---#-#-----#-#-#--##--------------#-------##-#--#---##-----#-------##-#-#
#--#-----##--#-#---#---#-##---#-###-#-##--##---#---#--##-#-#-#--###--##-#-----#--#------------------
------#-#-#-##-##--#-###-#-##-##-#-#-#-#-#----#-----#----##------##-##-------#--#-#-#-#-------#-#--#
--#-#---###--#---#---#-#-#-##---##---###--#--#--#-#------#-#-#---#-####-#----#-----#----#--#--------
------#-#--#-#--------#----------#-----#--###------#-#---#--#--#--#--------#--#---#--------#-#--#-#-
-#--#-#-----#---#--##----##-#----#-----##---##------###----#--##-------#-#---#-#-##--------#--------
#--#-----##----##-----#-----##-----#--------------###-#--####---#--#--##-#----#--####----##-#--##-#-
--#-#--#--------#--------#----##---------#-##----#-------##----#-#--####-------#-----#--#-----------
--##--##------#--#--#--####-#-#-####--#---#--###---#---------#---#-#-###---####--#-------####---###-
-#---#-#-#--##--#---#--#---#----#---#-##------#-#-#---##-----##-##-#--#----#--###---##--#-#--##----#
-##-#--#----#-----#--#----#-----###---##-#---#--##----#---###-##-#--##-#---#---##-------#-#----#-#-#
-##--##-##----#--#-----#--##------#-####-----#-#----------#-----#---##---#--#--##---#---------#-###-
--#---#--#--------#-#----##--#--###----#--#--#-----#-#-##-------##-#-#--##-#--#--------#----#---###-
----#---#--------------------#----#--##----------------------#-#--##--#----#--#--#---#-#--#-----#--#
---#-#---#-#-#-#----#-#--#--##----#--------##-##-#--------#--------#-#-#---#--#----------------#----
--##----#-#-----------------------#--------##---------##---#--#-------##--#---#-----#-#---#---###---
-#-#--#-#---###----##--#-##--#-#-#-##-##-####---------##-#---##--#---##--##-#-#-#------##--#--#-##-#
#---#------#-#-#----#--##-#-------#------#---##-#-----####-#--##---#-#--#---------##--------##-#----
#-#####-##--#----##--##-------##----#--#-##-#--#-#-----#-----#--#---#--------#-##-#---##----##-----#
#--------##--#-#--####---#-#----##-----------#--#---#-#---##--#--##-#-------#----##--#-##--#-#-#----
----------#------#----#--####--#--##-#-#-#--##---###---#--#-#-----#--#-#---##-#--#---#-##-----------
---#----##---#-----#---#--#---#---##-##----#-###---#--##------#-#---#-#--#-----#--##------------#--#
----#----##------#---#--#----------#-##--#-----##-----##-----#----###---#---#-#----#--#------#------
--#-##--#---#-#---#---#----#-#--#--#-#-----------#--#-#-----------####---#-#######--#-#-###---#-##--
----##---##--#-#--##---####---#----#--#-#---#-#--#-#---------#--#-##-##--------##------#----#-#-----
-----#-##----#---#-#--#---------##--------#-#-#--##------#--###-#-#---#----#----###---#-----#-------
----#-#-#-------#-###----###--#-#--##---#----#----#-##---#-##---###----###------#-#-#--------##-----
-##---##---####-----#----#--##--##-----#--##---##--#------#-###--------##-#---#--##----#------#-#-#-
