#---------##-----#--#--#######----#-###-#-#----#-###--###----#-#-#--#------##-#--#--##-------#--#---
----#-#--#---###-#-##-------##---#---#-#--------##-#------#------#-----#---------#-##--##--------##-
---##------##--##--#--#--##-#-#----#----##---###---##----------#-#-##--##--#-----#---#-#-----##-#-#-
#-#-#--#-----------#-##-###-##--#-#-#-----#---#--#---#---#-##-#--#---#-#-----###-------###---#------
---#-###-#-#----------#-----------#--------------#-#---#----------#-##-#-##--##---#------##---------
-###---##--#--###-#--#----#-##--#----#--#-#--#-#-------------#------#--#---#-##-------#----###---##-
---#-#----#--###-----#--#-##-#---#-#--####-----##-----#-##---#-#-#-#-#--#####-#--#--###-#-##-----#-#
#-#---##-#---##-----#-#------#-#-#-#------##---###--------#-------#---#---#------------#-------#--##
---#----#----#---#-##-----#---##-----#--#----#---#---#--#---#-----#---##--#---##--#--###-##-----#-#-
----#----#--##-#---#--#-#-----#-#--##---#-#-#---###--------#---##-#-----##-##-#-##--##----#---#---#-
###---------------#---#-##--#-##---#---#--------------##---#-#---#-#--#----##-------##-----#--#-----
##----##--#----##--##---##-#-#-#-------#-----###-#-------##-#---#--#--###----#-#--------------##--#-
----------#-##------####---#----------#----#-----#-##--##----#-#-#--#-#-###----###---#----##----#--#
-#--#------##---#--##-#---#-##----#---###-#---#-#---#-#-#-###--#---##----#-------#-#-#-##-#-------#-
----#-#-------#--##----##------##-----------##-###-#--#----------###----#--##-------------###---#---
----#-#-#-#-##-#-##---#---##----#-------------####----##------#--##-------###----------#--#-------##
#-------------#-###---#--##-#--------####-----##---#--#----------#------##---#-##----#-#---------#-#
#-----#-#------#--##--------#----#--------#-#----#-##-----#--###--------#--#---####-###-#-----------
-#----#----##----#---##--#--#--#--#---##-#-------#----##--##-#--##-##-#-##-----#----#-##--#-##-#----
---#-#--#-#-##---###-----#-#-----#--##---#--------#-##----#------------#-----#-#-#---##-#--####---#-
##--#-#-##--------#--##--##---#----#---##-------##-##-####-#-##---#---#-#------#---------#---#-###--
#----------#------######-#---##--#-#----#----#----##--#-#-----#------###----#---#-#--##-###-----#---
--##---#--#-#--#--###-##--#-------#-#-----------##-#-###---#--------------##-#-#--#----#-----#--##--
#--#---###---#--#------##-#-#--##-#--#--#----------#---##-#-#-#-##-#---###----##-##--#--#------###-#
###--------#----##---##----#--#--#------#---#--###-##-----------#-#-#-#---#-####---#---#------#--###
-#-----#####--#-##------#------####---###--#-----#-#-#-#--##-----#-------------##--#--#-###---------
--------##-##----##----------------#--#----------#--#-----#---#----##-#-#-##-#--#------#--#-#----#--
###-#------#--##-####---#---#-###--#--#--#-------------#-#------#-#--#---#-##-#-#---#-#####---------
--###---------#--#--#-##-###----#--#-----##--------#-----------------##------#-#----#-----#-----#---
##-#---------#-#---#-#------#-#-#-###-#-##---#----------#--#----#--#--#----###--------#----#-#-#---#
--##------#----#---#-#-#-------------#-----------###--##----#-##--#-#--#---------#---------#----##--
##-#-####--#-#-----#---------#--###-##-##-----##-#--------##---#-#---#---#-#--#---------#------#----
------#-----##--#--#----#-----#-##--#----------#-------#-----------#-------##------#--###-#--#--#-#-
----#--#----#-#---###------#----------------#--##---#-##----##---#--#------##-----#-E#------#---###-
#-#-##--#-----#-##---#---#---#--##-#-----#------###--------#----##-----###--##-#--#---#-#---##---#-#
-------##----##-#--#--#-#####--#----##-##----#-###--#------###--------#-----#-------#------#--------
-------#------#-----#####---#-------#----#--#--###-#---------#-----##-#-#--#---#-#####-#----------##
#--#--#-----#--#--#--#-##----#---####-##--##-#---#-#--#-#----#--#------#-##-----#----#-#---#-#--#--#
#----##---#----#--#---#---#-#--#-#-#--#--------##-----#--##-------#--##---#----##-##-#-##-##------#-
----#---##----###----#---#---#-------#--#-------#-----------#--#-##-----#-#--------#---#####--------
-#--#---#--####-###-#--#---#--##--###---#----#--#-#-------#------#----#-#-#-----#--##-#-#-------##--
#-----###---#--###--##---#---#-------#-#----#--##-####-#--#-####--#----##--#----#-----###--#--------
---------##----##--#--#-----#---#---#----#----##-#--###--#-###-#--##-#--#---#--#-#--------#-----#---
-#-----##-----------#------##-----#---##-----------------#-#-----#------#--##---#-#---#-----------#-
#-----------#-#-##-##-----#-#--#-#-----------#--#---#--##---#----#-----#-#--##---------###--#---#--#
##------##-##---#--###----#----#--#-#--##--#-##---#-----###-#-----#----#-####-##--##--#-----##-----#
##--------------#-----#-----##-------#------------#-------#--------##--#-#-###-#-------#---#--#-##--
#-#-----#----------#-#-#----##--#--------##-------#-#-----#-#-#---#-#----###-#--#--#-#--#--##-#-####
#----#----#-#-----##-#----#-#-#-#-#---#-#---#---#--#----#---#----#-------#---S--#-----#-----###-----
-##------##-##--#------#--#-----#--#----##-##-------##--#--#--#-------##---#-----#--##-#-#------#---
#---###--------#---#--#-----#--#-##---##-###-###--#--####--#-#-#--##------#--##-----#-#####--#---#-#
-#--#--#--#------#----#--#--##-#-#-------#--#-##--##------##-#--#--##---#---##-----#-#--#--##-#--#--
--##------###--#--#-----#-#-----###-------##-#-#---#-##--------#--#--##-----#-#--##-#-#--###--#--#--
--#----#----------------#----------####--#-------#-##-#--#-#-#----#----#---#----#---##----#-----##--
-----#-#--###--#-#----#---###--------##--##------##--#-##---##--#-#-----##--####--#-#-#--------#-#--
------#-#----#-###-----#-#---#------------#--#-------------#---#-#---#---##-#--#--###--#-#-----#-#--
#--#--#----##--------#----###-----##--#--#---#--------#-#-#---#-##----#------#--##----#---#-#-------
##-###----------------##------#-#----------##---#------#------------#-----#-##---#--#-###------###--
----------#---#---####----#-#-----##-##--#-----#-####----##---#-#----#------##----##-#--#--##--####-
-##---##--####---##-#----#--#-##--#--#----#-#--###------#--##---#-------##---#--#-##--#-------##-#--
--#--###---#-#-##-----#---#---------#---#---#-#--#---#---##-------#-------#---#---#--#-#-#-##-#-#---
#--#-#--#-#-#-#-#----##------###-----#---#-------#-##-------#-###-#-#---##---#--#----#----##--###---
---##-#---#-#---#---------#-#----#---------##--#------#-#-##-#---##---------#-----#---#----#-##-----
-#--#--#-####--#----##-#-#-#--#----##---#-#-##-------#--#--###----#------#-#---#---##----#------#-#-
#-----#--#--#-#---##---#-##-#--#----###-###---#------#-------------#-####-##--#-----#-#--#-#-###----
----#--###--#--##---#----##--##-----#---#--#-###--#-###-----#--###-----#--#-##---#------#-#-#----#--
##-##--###--##-------#------#-#-#--#---####--------##-----------##--#----##--##---#------##---#-----
-#-#-#-----------#------#-----#----#-------------#-----##-#----------##--------#--#--#-#-----##-#-#-
-#--------#--#-#-----##--#-###---##------#-#######---#----#-#------#----####--#---------------------
---#-----------#---#--------------###--#-##-#------##-###-----#------#---##-###--#-----------#----#-
--#--#-##---#--#-###--#---##---#--#-----#--##--#--#----#-#----#--#-----#----#-------#---#--#--#-----
#-##-#----##-#--###--------#----###-----------------##-#----#-#-#-------#-#-------###----------###--
-----#--#-##--##----#-#---#--#---#-####---------#-##-#-###--###--#--#----#----#---#-------###------#
---------#---#-####-----#--#----#-#-#----#----#-----#-#-#--##-------#-#-#-----#---##-#------#-#-#---
##---##--#--##-##--##-----#-###-#-##---#-----#--#--------#------------------------------#-#------#--
-----------#--------###-####----#---#-#--#-#---#-##--##----------------#----#----##-#-#----###--#---
-##-----##---#----##---##-##-----#---#---##-#-#-#-#-#-##---#--------#-####---#------------#--#-#---#
-####-----#-#-#-----------------#--#--#-----#--#-----------#---##-------#---#----#---#-#------###---
#-----#-##---#-----------#-------#---#-#-#--#-#------#-#-----------##-------#-----##-#-#------#----#
-----------####--###--####-#--#---##-#---##-----#-#----------##--#-#----##-#--#-----#---------------
--#-#--------#-----------------#-#-#--#-----##---#-----#---#--####-------------#---#--##-#--#----###
-----##----#-###----#--#-###-#---######--##---------#-###-#------##-#---#-#-#--##-#--#-----##-------
---###-#----#----##---#---##-##-----#--#-#-#--#---#--###---##---#-#---#--##-##-#----#--#--##-#------
#-----#--##-##-##--------#-#-----#-#---#-----##--##---#-##-#---##-#----###-##--###------#-###--#-#--
-------#-#-##---#--###-#---#---#-####-------#-#--------#-##--###--#----#-####-------------#---------
-#---#----##--#-##---#------#-#--#----#------#-##---------#----------##---#-#---------#-#---##------
--##---#-##------------#-----##---##----#-------------#-----#---------#------##-#--#---#-------###-#
-#------#---#-----#---#---##-#--#----#----#--#----#-----##-#-#-----#---#-#----------#--##-##--#-----
----#--#-------#-##-#--------##----------###-#-#-----#--#--#---#--###-#------#----#---#---#---#-----
--#-#-###--------##-#####------##--#-#-#----#--------#-#-#-#--#-#-#---#------------#-#----------###-
--#####--###-#-#--------##-###-##-#--------#---#-----##-----#--#------#---#------------##--#----#-##
---#---------##----#------#-#-----#---##----#---------##----##-###-#------##--##-##-##---##----#--##
--#---#-#----#--#-#-#---#------------#-------#-#--#-##----##-------#-##----#--##---####-#----------#
#-#---#---#-#----#--#--##----#--##---#-#----#---#--##-----##-#-##--------#----#----#------#---#-#--#
#---#-----#-#---##--#-------##----#-#-##------#-##-#-----##----#--------#-##---------#---#--#-#-#---
------#-#-#-#--#-------###---##------##-----#---#---##---##--##-#-#-----#-#-----##---##--#---#----#-
#--##-#--#-#-#--##-#-#---##---###--#-##--#--###-##--------##--#-----##------#---#-#---##----------#-
-#-#----#---#----#--####-#-------#---#-#-##----###-#------#--#--------------#--#-##--#--#--#-------#
-----#-##-#---##--#-----#--#-#--#---#-#-------#-#-----#--##---##-##----#---#-#-##--#----#-#----##-#-
#----#-#----#----#-#-#----#--#--#----------#--------------#-#-###----------##-----------------###-##
