#--#-#--#-#-#-##------#-----#-#--#--#-#-#-----##-#--#-------#---##--#-#--###--##----#-##---#--#---#-
---##-#--#--#-###-#---------##------#-#-#-------#----#----##---#-------###-----#-------#----##-----#
----#----#--##-#--#-#---#---#-##--##-----#-#--#---#-#-#---##------#----###-----#-#-#---##--##-##-###
#--------#----#-----##--####--------#--#-##-----###--------#----#----#-#--##---#---#--#----#-------#
----#-#-------###---#-----##---#---#--------##-#-----#-----------#---#-#-#--#--#-##----#-#-###-#-#--
--#----#---#-----#-##-##--------#---##-#--####---------#-----##-#----####---------#---####--#--#---#
-----#--##----#-###-##--###-#---#--#----#-#-##-----##-----#---#--#--##----#-#-------##-------#--##-#
-#---#--#------#-------##-##-----##------#------#---------#--#--#-#-#--#-------#----##---###---###-#
---##-#--##--#-------#--#--#-#----#-##------#---------#-##-##-------#---##--##-#------##-#---#----#-
#-#--#---#--#---------#--#-------------##----#----#-######--#-#-------------------#-#-#-#---#-##----
----#------#---#--#----##-#-#---##--------------#---#--#-----#-#---##---------##---#--##--#---------
##--#---#-----#--#----#----------#-------#-#-#-#--##-------#----#-#-#--#-#-##--#-----##-#-#-#-#----#
-##---#-#------##---#---#--#--##-####----#---------#--#-----##-##-----##----#------###--#-#--#--##-#
-------#--#-----#-------#--#--#-#--#--------#----##-#--###-##---##---#----###---##--##----#--#---#--
-#-#-#---#----#-----#---###---##-#-#---#----#-##-------#--#--------##-#---------#--###-#---------#-#
#-----#-------#--#---##-#--##--#-#--#----#-#--#------######-#-#-#---#-#--##----------#--#---#--#---#
-#-#--#---#-#----#----#--##-##--#----##-#-------#--#--#-----------#-#-#--#--#-###-----#-#----#--#---
---#--#---#--##-###------##-#-##----#-----###-------#--##------#---#--#----#--##--------#-#-###--##-
---####--#---#------#----###----#-----------#-------#---#-#---####-##--#--#-#------##---#-#--------#
-#--------##---#----#-#-------#-----#---#--#-----#------##-#----##------#---------#--#--####----##--
-----#-#--###-----#--#-#--#-------##--#-----#--#---#-------###-##-##---#------#---##--###----#----#-
#-----#---##--##--------##----##-#-------##----#-----#--#--#------##--###--------###---#-----##-#---
-###------------##--#--#--#-#--#-#---#-#####-##-#-##---#--#-#-###-------##-#-#-###---#--#-####-#--##
--#------###-------#-----#---#-###------------#---#--#--####----#-------#-----#--#-#-------#--------
---##-----#--#-#-####-#---#---#-----#--#-##-----#-#-------#-------#-----#--##--#----#---##------#--#
----#----##---##-#--#-##-###---#--#---#--#--#---#----###-#-##-#--###----#-#-------#---#----#---#--#-
-#---###--##---#---###-#----#---#---##-#--#--###-------#-#---------#--------#--##-#-##----#-###-#---
---------#-#----------#--#----###--#---#-#-------#-##--#-#-#-#------#-#---#--------#-##---#----#--##
#-#----##--###-------#####--###--##-#-##-#--#----#--#-----#------#-----#-##----#-----#---##----#--#-
-#-#-####---#-#---#---#--##--#---#--#-##-----##-------------#-##--#----#####-----------###---#--#---
#---#------#-###-----##-----#--#------#-##-##-##----#-#--------#-#--###-#-##---##-----####-------#--
---------#-#-#------##-------#---#---#-S---#-------------#-###----#---#--#-#--#---#-####----##------
##--#---#-----#---#------#--#--#-#---#--------###-#--#--#--#---##---#---#-##----#---#-#-###-##-##--#
#-#----------#-#---##-#---##-#-------------#-#-##--##------##-----#----------##------#-#---##--#-#--
#-##---##-----#---------##----###-------###-#-----#---#-#-#-##---#--##-------#--------#-#-#-###-----
-----##-#-------#------#--#---#-##-##---------#-#------##-##-###--#--#----#-#-#---#-#-#-----#-#-#---
------#-#--#-#-#----#------------##--#-----##--##----------#--#---#----------------#---#-#-#-----##-
#--##---#-------#-#---#-#-###---#####-#------#-#--------##-####-----#---------##----#----#--#---#---
#----#----------#-----#----#---#-#-#-#-#-#------#-#-----##--#-----#--#--#-#-##--#---#--#---#-----#--
--##---#--###-----#---#-#-#-----#-------#---#-#--#-#-##-------#-----#--------#-#---###---#-###-#----
-#----#--#-##-#--#-##-#-----#----------#---#--###---#-#-----#---#----#------#-#--#--###-#--#-####--#
---###-#----#--#-##-----###---##---#---##-#--#------##-----#---#--#--#---##--###---#--------#-##----
##-----###--------#-#--##----##-#--------#-----###---------------#---#------#-------#-#--#-#--------
---#-#----#--##---------###---#----------#----##--#---#------#-#----#--#--#--#-----#----#-#---#-#-#-
-#----#-##-------#-#--------#--#-----#-------#---#----#--#-##----#----#-#-#-----#-------##-----#----
---##------#-----##-#-----#--#----------#--#---#-####---------##---#-#----##----#----#-------#####-#
#-----#---------#-------------------#----#--#------#-#----##------------#--##-----#--##-#-----------
--##----##--#--#----#---#---##----##-#--##-##---------###---###-#---#----#-----#----##----#-##-#----
#-#---####-#####--------#-#-#-#-#--#-###----##------##-----#-----#--#---#-#----##----#----#----###--
-#-----#-----#-#----#-#---#####----#-------#-#----##-##---#-------##-------------#-------##-#------#
---#------------------#--#-#---#-#----#----#---#---###-#-#--#---#-##-#------#-----##---#-##-----#--#
----#-----#-#-----#---####-#----###-####-#--#--#--##--------####----#-##--##---#-#-#--#---##--------
------#-#-##--#--###---#---#---##--#--#---#-##---##--#--#---#-#---#---#------#---#-------#---##-####
#-#------#-#----#-#--------#--#----##---###--##-----#-#-#--##------#--#-#---#-#---#----##--#-#---#--
#-----#--###--##-------#-#-#-####-#-------#-------#---#--------------##--#--#-------#----#-------#--
----#---###-----#-----##--#----#----##-#-#-----------#--#--#--#---#--#-##---##-#----##--#--#-#------
-##-----#---#--#------#--#-#--#-----###--#--#---#--------##-----##------##--##---##-#---#-----#----#
---------#-#-#--------#--##--#-------##--##-##-#-------##---##-----##----#----#-#--#-####---#---#--#
##-#-----##-------##-##-##-----#----#---#------#-#-#--#-#-###----------------###--#----------###----
--#-##-----#-----#-##--#-##-------#-#------####-#---###-----#--####---------------#---#---#-#---#--#
#---#---#-------#---#-----#----#----#-#----##-#--------#------------------####-------#------##--#---
-#------#--#---------#-#---------#---#--#----#---#--##----##---#--#----##-#--#-#-----##---##-------#
#-------#----##----##--###--#-#--#---###-##-#---#--##-#---#--##-----##--#---#------##-----###--#---#
-#---#-##------#---##--#--#--####--####-#------------------#---##---#-##-##-#-##-#---#-#-----#-#----
---#-------##----#---##---#-#-#-###--#----#--#-#-#-#----##-----------##-#-#--#-##----#--#---#---#---
-#---#--#------##---#--------#-#---#------------####--#-------#------#-#----------------------#-----
###---------#------#--#----###--#----###-----#-#--##-#----##----#####--#--#-#---##-----##---##------
----#------#-#------------#-#-#----####--#---#--#--#----#-----------###----#-----------------#--#---
--#-#-------#----#---##--##---#---#-----#------#---###--------#---------##-----####---##------------
-----#--#-##--#---#-----#-#-#----#--#----#--------#-#######--#----##---#-------#-----#-#---#------#-
#---##-#--###-###-#-##-#-#----###-#-----#----###------#----#-#------##---#####-#--#-----#--#--#-----
-----##-------#-------###----#--#--#--#-#-#----#---####-#-###-#---#-----##------#-#--#-#------------
-#-#--#----#---##--#-------##-#-------#--#-----#--##------#-###-------#---###----##--#----##----#---
-#------#-##-#-##----##-#-#--------#-#-#--#---#-#--###-#----##-#-----#---#--#-#-#--##---#-------#---
-#----#-------#-###---##--#--------##------------#-##-#-#-#-#------###----##-###----#-#####-------#-
---###---------#--#--##---#--#---#---#-##--#----#---##-#--#-#--#----##-#-----#-##--##--#--#---------
-###----#-##----------#-#--##-#--#-----##--#-##------#-----------##--####-#----#-------#------#-----
-----#--#---##-#----##--#-#-#---#---#-##-----------#---#-##-----#-#---#-#---#--###-#-#-----#----#--#
-##-----#-----#####----#------#------------#--#-#---#--------##--------#-#-----###--#--#---#----##--
----###-#-----#--##-####---#--------##-###---###-#--#-#---##--#--#--##-###-#----------------#--##---
-----##--#-----#-#-###--#-#---#-#--#-###-#-------##---------#----#----##--##-#-##-#-#-#-#---##-#----
#--####----#--#-#----------------#----##----#----#-#--#--#--#----##-##---#--------##---------#---##-
-----#---------#-######-#-#---------###---###------#-----##--#-#-----##-----#--#----#-#--#--#-#-----
#---##-#--###---##---#-#--##--###-#-----#---#--#------#---#-#--###-##-##---#---#---###-#-#---#--#-#-
-#-------------#-----#------#------#--###-#-##-##---#---##-----#--##-#---#-------------------#-----#
#-##-##----###--#--------#-------#--###---#-#--#-----#-#------##------#--###--##--##-----#---#--##-#
---##-------#-#---##-##----##-##-#-#--#---#--#---#---##--#------##------#-------#---###---#----###-#
----#-----------#----#--------###---#-##--------#--#----#--#--#-#---#-##-###----------#-##--#---#--#
------#---------##-----#--##-#--##-###--#---###------#-#--#---##-#-----------###------------#--#----
--##--#--#--#--#------#-##-##-#---#---##-#-----#-------#---##--#--#-##--#------#----#--#--###-##-#--
--#--##--#-#--------#----##-#####-#-----###--#-#---#-###------#-#-##-#------##--#--#----##------##--
-##-#-----###----#-##---#--#------#--#-------#--------#-###-----####-#-#-#--#---#--##-##------------
#--#------#-#--##-----------#-##-##-#-#--#----#-------#---------##---#--####-#-#-##----#-#------#---
-##-###-###-------#-##--#----#####-------#---#--##--#------##-#-##---#--#-##---------#---##-#--#----
##--#--#----##-#----#-------#--#-#---#-#-------------------#--#------#----#----#-#------##------##--
------------##----#--#-----------#------##-##--#---#----##--##--#-#------#-#-#--#---#-#-##-#-#-##--#
----###---#-#--#--##--#--##---------#---#---##----##--#-----####---##--#----#---##-----##-#--#------
###-----###----##----#-----#-##--##-###---#------#-----#-#------#------#----------#-----#---#---#---
-#----#---##--#-#----#--###-#----#--###---##--#-#--#-#--#-----#-----#----#--#--##------#----##------
---------####----#-##---#---#------#--#----##-----#---###E-##-#---##----#-#--------#--#---#---#----#
