--------------#-#--#---#---------------###-#--#----#---###-#--#----#----#-#-----#-#----#--#--#------
#-#-------#-----#--------#-#----##-----#-##-#---##--##--#-#--##---#------#--#--##---#-##-----#--#--#
#---#-#-##--###--#----##-#--#----#----##---#------#-#-#--#-#-#--#-#--#---##-----#-------------#-#--#
--##-#---------###---#--#-#--#-#----#--#-#---#-###--#-----#-##-#--###--#-##---------#---#-#-#-#-#-#-
-#--##---##------#-------##--##-------#-#-#--#-##--#####--#--##-##-#---#-#-----#--#-#---------#-#---
-#----------------------#-#-----#-#----#-#-#--------##------##-------#--#-----###---#-----##--#---#-
#-----------------#--#---#-----#---#-----#------###---#-#-#------------#-----------------#---#---###
-#--##----##---#-#-#--#---#-##--##-#--###-#----#-#-#------#-------#-#---#-##-------------#--##---##-
#--#-####---#---###-##-#--#--##-----#-----#--##--#-----#--##----#-----#------#----------#--#--#--##-
#---------#---#-##-#----#-#-##-#-----#-#--#---##---#---#-------###-#-#--#--##-#----#----##--#---#---
##---------#-----#-###-#-#--#-#------#------#-#------#-#----#--##-#---#--#------#--#----------#---#-
---#-----####-------#--------#-#-#-###-----#-#----###----##-###-#----------##---#----#------------#-
---#--#-#--#-#-------------#--#--##---##--#--#---####---#---###---##--#-##------#--#--#-####-------#
-----------##--------#-#--##------##---###-#--#-#----#----------#-------#---#--#-##-##----##---#----
#-----#-----#-#-#-####------------##----#----------#---#---##--#--#-#--------#-#---###--##-#--#----#
----#-#--##----#---#-#-------#---#---#-------------#-#-----#-------#----#---#-------##-##---#--#-#--
-#---#--##-----##-#----#--#-##-###--##-##-##---#--#-#--------#-#-#------#-##-----##----#-----##-----
##---#-------##-###-###-###---#--------------#-###-##-##-#----#-#---#--#-#---#--#---#---#-----------
##--#--###-#-#------#----#-#------#-#-#-----------#----#-----#-------#--------#---###-------##------
#-##-#--#-#--#---#-----####-###-#---#---#-----#---##------###-#-#-------#----#----##---#------##----
----####------------#--##-#####----##--###-####---------#--#-------#----#-####--#---##------#---#-#-
#----#--------#--------#--#-#-##-#-----##--#--#-#--#--#---#--------#-----------#--#---###--#--------
----#------#-##--##---##--#-#--#--------#-#---#-#--####--#--#-#---#-###----#---#--------####-###--##
--#---------------#------------#--#-----#-###-##------------#-----#---------#-----##--#-----#------#
-#----#####--###-----##-##--##---------#-#------#--#--##-##--##---#-------#--####--#---###--#-------
--#---###-##--#----#----------#----#-----#----#----###-##-#---#------#-#------------#--#---#-#-##---
#-#---###---#--------#-----#-----###---##--##-##----#-----##-#-###--#-##----#------#------#-----#---
-#--##--##--------#-#---##---##--##----#-----#------##-----#-----#-#---#-#-#----#----#--##-###-#----
#--#----#-----#------##-##-----#-#----#---##---#-#--##---#-----#--#-#--#--#-----#####-#-------------
#---#--#--#--#---------##--#---##---#-----####---##-##--#--##-#----#-#-#-###-#--####--------#-#-#---
-#-----#-##----#--------##--##-#---#--###---#----####------#-#--####-#-----#----##---#------#-#-##--
--#------#---#----##------##-------##----#-------#-##--#-#---##------#---##----##-#--------#---#----
---#-#-------##--#--#--#---##-##-##--#-#----#--#--#--#------#--#---#-----#-##---#--#--####-#----#---
#-#-##-#-#------------#---##---##---##--#----#-----##-#--#-#----#--##-#####-#--#-----------------#--
--#----#----#--####------------#--#---###-##--#-#-##------------#------#----#-##-----------##-------
--#-#-#-#-###--#------##------#--#--#----#--#--#-#----##-#----------#-#-##-##---------#-#--#-#-#---#
#---#-#--###-----###-#----------------##-#---##----#----##----#-##----------#-##-------#--#--#---##-
-------#--###----------#--#----#---##----#--##----#--#-##-#-----#---###-##--###----#--#--#-----#-###
#------##-----#--------#-#---#--#-#--#-###-#----#----#---##-----#----#-#---#---#----##------#-#-##--
--#---###---#-------##--#---#---#------------##---###-##-#--#--#-----#----##-##-##-#--##-#-#--#-----
#--#---------------#---#-----#-#--#--##-#---#-#----##--#-#-#-#-###--------#---#-#--#---------------#
#####----#-######-#--#--#---##---#---##-------#---------#----------#---#-##--#----#--#-##-----#---#-
#--#---#---#-#-#-----##-#-#----#-#---#---#---#-#-#----#---------#-#--#-##-----#---#------##-#-#--##-
#-###-#-##------#---#----#---#-----------------#----##--#--#--#--#--#----#-####---#--###--#-#---#---
--#--#---#####-----#----#--#-------#-#---#--#-##--#--##----#-#---####-##-##-#-##--##-##-##-#-----#--
-----------------##----------#-#----#---#-##----##-#--#--------#--##----#-#---##-###---##-------#---
------#--#--#--#---#----#-#---------#----###------##----#------#---#-#--#-#----------#----#--#--##--
#-#---#------#---#-#---#-##-#---##---#-----#--------#-#----###---##--#---#-##-##----#---###-##-#---#
#-#----#-----##--##-#-#--##-------------##-#--#-------##---#-#-------#---##-#-####---------##-----##
--#-------#--#--#-----#--###-#----#---##--#-#---------------#------------#--#------#--##----#--#-#--
---##------##---#------##-###-###--#--#-#---##-#-----------#--##------##----#-###-#-----#----#---#--
--#--------#---#-#-#-#--------#------##----#-----#------#--#--######-#-#--#--#-#------------#####-#-
##-#-#-#---#--#--------------------####-----##--#--#--###---#--#-#--#--#--#--#-----#--##---------##-
##-#-#--##----##-----#---#-#---#----#---##-#---#-#--#--------#-#-###--###-##----#--#-----#---###--##
---#--#-#---#---##-####--#-##-----#----------##-###--#--#--#--#----#--#-###-##--#----#-------------#
-#---#-----#----#---##---------------#---#--###-#--#--#------#--#-----#--#-----#-#----#---##--##----
-#-#------------#-#--####----##---##--#-#-#---------#####----##--##--#-###-#----#---#--###----------
--#-----##-#-#----#--##--###-####-------#---#-###---###-------#-#---#-######-------#---##-#---#---#-
-------#-#-----##----#--#-----####-#---#-##---#----#-#------#-#--##-------#--#---###--#---#-------#-
---#---##-----------#--#--###----#-##-#-#------#-#-#----##-#--#--#---#-##--#---#---------#---##-#-#-
--#---#-##-#--#-----##--#----------------##-#-##---#-#----#--#----###---###------#------#--##--#---#
#----#-----#-#---#####-###--#------####-------#----##-#-##-#---#-----#-----------###---#----#-#----#
--#-###-#-#---#--#--#---##-##----#---###-#--#-#------#-##-----##--------#------###--#--##--#----#---
-#-#--------#-##--#--#--#-#----#----##-------##--#--#-#------#--#---###----##--#--#####----------#--
-#---#--##--#-##---#----##------##---#----#---#-#---#-#------#----#-------##-##-------#-----#--#----
-###---------#-----####--#-####-#-------###-#-#-#----##-----#-----###---#------##---#-####---------#
---------####---#--#--#------#--#--#--###--###--#-###------#----#---#---###--#-----##-#---#-#---#---
-#-------#--------###---#-#----#---#--##-#--------##--#---#---------#-#--#-#-##----#-#--##-#---##---
--#-----#--##-----#-##-#--#----#--------##-#------------#----#--#----#-#--###--#---#----#-##-#---#-#
##-##----------#####----#-------##---####-#----##-------#-#--#----------#----##-###-#-#-#-##-#-#---#
--------#----------#-#--#---#--##-#---#---------#------##----##-#-##--#----#-#---#---#-----#-#--#---
----#--#-##----#---##---#-------#------#-#-----------##-##------#----##---#-#--#-#----##-#--##------
----#-#-#---##-##-----#-#-#-#--####-#-##------#-#--#--#-----###----#----#----##-#-##--#------#-#----
###----------#---#------##---------##----#--##--#-------###---#--####---#-------###----#----#-----#-
---###-####----#----##--#--#---##-#-#--#--#--#---#-#----------#------------#--#---##--#--#-#--#####-
---##---------##------#----#----#--------#---##--##-------#-#---#------##--##---#-#--###-##----#---#
#--#-----#---#-##-------##--#---##---#--##--------#----------#-----#----#-#-#--#-#----###-#--#------
------#--#--------##---#--------##------###---#-#---##-#--##-#---#--#------#-#----------#---##-##---
---##----###--#--#--##-##-#-#-#---#-##------#-------#-#--##---##-#-----#-##-#-#-#-#------#-#--###-##
----#-----#---##--#---##-#-#---#-#--#-#---#--##-#-###-#--------#-#-----#-----#-#------#-#--#----#---
#-##-#----#-#--##----#-------#-----#--#--##-------#-#-#-------------#-##------#---------##---###----
------#----------#-#--#---#---#-----#-----##-#-#---#------####-###--#-------#----#--#-#---##--#-###-
--##---##----#--#-#--#--------##-------##--#---#----#--------#-------------#---#---##----#--#-#-###-
---#--#--#---#---#--##-#--#------#-#--#---#------#----#-#-----------#-#--#-----#--#----###--#--#-#--
-#----------#-#---#-##-#--#-#---##---------#---------##-#-#-#---##--##--##--------#----#-#----------
-----#-###---#-#--#-##--#--#--##---##-##------#-###--#---#--#---##---#------#-#--------------###-#--
-#--###-###-------#--#-#-#-----#-----------#-#----#-#------#-----##-#---#-#--#------#-#-#----##--#--
###----------#--##-----#-#---#-#--------#--##---#---#---------#-#---##-##---#--#-----------###------
--##-#-----#---------#------#--#--####----#---##------##--##-------#---#--S---#-##--#------#--#-----
-----###--#--#-----------##--#--#--#----------#-#----#-----#-----#-------#---###-###-#---##--##---#-
---#------##---#--#--#--###-#-----#---##---##--------#---------#-#--#--------#--##-#-###-----#----##
----#---#--##--#--#--##-#------##--#----#---#-------##---#--#------##-##---#-##-#----#--#--#####---#
-#----#----#---#-----#--#--------##--##-#--#--------#--####----#--#-#---#-##-------------#-#-#-#-#--
#------#-#-#--#---##----#----#-#--#-#----#-----#------------#--#-#--#--#--###---#---####----#--#-#-#
--##-#-#---------#-----###---##--------------------#---##----#----#-#--#------#--#------##-------#-#
-#----##------#------#-###-----#-#--##------#-----##-#-###---#--#---##--------#---#-#--#-#------#---
---#-#--###--#--#----#----####-----#-##----#----#-#-##-#--##--#---###-#-----#--#---#--#-----#----#--
---#-#-----##-#-#-#-----#------#-#--#--#---------#-##-#-##--------#-###-#----##-##----#----#-#-#-#-#
--#---#--#----##-----------#----###----------#-----#----#-#-#---##-#---#----###---#--#----##-----##-
------------#---##--#--###-#---#--#--#-#-#-#----------#----E--#-------#--#-#-#--##--#----------###-#
