#-----#--#--#-#--#-##-##-----###-----###-#--##-#--#------#-##----##--#--#----#-----------##-----#-##
----#-#------#-#------#-----------#---#--#--#----##---#-#--##-----##--------#--#--#---#--#---#-#-###
-#----##----###--#---#----#--#-----##---#---#--------###-##----------#-------#--##-#---#--#---------
--###-#----##---##-------#---#-----#-#---#-#---#-####----#--#--###----#-##----##------------###---#-
------#--##-#-----------#-----#-----#--#-#--##--##--##------#-#-----#---#---#---#-##-#-#-#-----###--
--#-#-----#-#--##-#-------##---##---------#----------##-------####-----#-#----------------------###-
###----##-#--#-#-----#-----####--#-----#-##-###-#-#------##-#----#-----#--#----##----##-#--#---##---
#---##---##-#-#--##--#--####--##--##--#---------#--#--##---#-----#-#----#---#--#--##-#----------##--
#---#----#--###-#-----##-##---###--#----####--#---##--###---####----------------#----#-----#----#-#-
-----#-#---#---#--##----#----#--#-#-----###-#--#-#-##--##----#---#--#-------##-----#-------------#-#
----##--#--#--#---##--------##---#-----#----#--------##-#-#--#---#-###-#---####------###---#-#-#--##
-#-----#--#----##---#--#-#----#--#---------###---##------#--##--#-----#-#-----#-#--#--#--#-#---#-#-#
--##--#-----------#--####-----#---#--#---##-#---###--#-#-###----##-----#----#---##-#-###-----------#
-#-##-#---------#-#----------##-#------#--##-#----##---#-#---#-#-#---#---##-------#-##-#-#--#-#----#
----#---#-#--#--####-#--##----#--##-----#----#####----#--------#-##-#-#--#----#--#---#---#-------#-#
-----#---##-#--#---#-#--#--#----#-###-#-#--------#-##--#-##----#----##-----#------##--#-#-##-#-#-#--
#-----#-#----#--#--##-#--#-#-#-#---#------##--#-#------###-------#--#-#-----####---#-#----#---#---#-
##---#------####--#----#-------#-#--#---##--#---#---#-------##--#---#-#----#--#--#-#-#-####--#-#--##
#---#--####----###-----#-#--------------#----#----###----#--##-##-----##----#---####------------###-
##---#---####----##-#----###----#----#---#---##---#---------#-##----#---##-----------------#---##-##
-#-----------------###--#--#-----#------#-----#---##--#----##--##-------#---#-##---###----------#---
-###---##--##------#----------##----#--------##--#-----##------#-#---#---##--------#-#----#-#-#-----
--#--------#-###-#--#-------#--#--##--#--##---#--#-###--##-----#--#-------#----#--#---#----#-#---#-#
#--#-#---#--#--------##---###---#-#---#--#---#--##-#------#---#--##-#-#----##-------###---####--#--#
-##---#--####-####----#-----------#-#####-#-#--#-#------##-#--#--#-##---#----#-------#---#---#-##---
--##----------#----#--#----##-----#-------------#----#--#--#--#--##-----#---##---#------#--------##-
---#-#--#-#-----#-##-#-----------#----###------##-#----#-----------####--#-----##-----#---#-#---#---
-#-----#-----#--###--#-#-#--------##--#--#-#----##------#####-------#-#--##--##--------#---------##-
------------#--##--##-#-#-------##-##--#---#-#----#---#---##-##-#--#----#--------#---##-----#------#
--###--#----##-###-#-------------------#-##--#-#---#----#-####--#-----##---##-----##------##-#---#-#
--##-#--##---#----#-##-#--#----#------#----#-#--#------------------#-#--#-#-#--#-----#-----##--#-#--
-#-#--#-####--#---------###--#--#----#-----#--#------#---------##-##-#####-##--------#-#--##-#--##-#
-###-##-#---#----#-#------##--##-###-##---#------#####-----##------#-###---##------##---#---#-#---#-
-#-#----##-#-------------#---#--##---#--------#-#--#--##-----#-#-#-#####-#-#-#-------#--#--#-------#
-----##-#-#--------#-#--##--------##-###----####---#-#-#-#-----#--##-#---#-#---#-#----#-------##----
-#---##------#-##---#-#-#--#------#--#---#-#---#----#-##-###---##----#-##--#--#-###-#-#-#----#######
----#---##----##--#####-###-#-#-#-#-#-#------#------#-#-----#-------##----#------##--#-------##-----
-##----##---##-#-##--###-#----#--#---##---------#----#-------###-#----##----##-#---#----#-####-#-#--
#-##------##------#----#--#-----#-#------#--#--#----#----------##---##-#----##------------------##--
#----#--#-#-##----#---#--------##--#-#-##----------#----##--#-#-##----###-#---#--#-##---#-----#---##
-#-#--#----#------#-##---#-#--#--#---#-###--##--#---------##---#-----#---#-----#----##---#-#---##---
-#-#--#-----###-#----##---#---#---##----###---#--#----#-#-#-#------#--#-------##---#---#-#---#-##--#
-#--#-#-----#--#-##-#-##--##----#-----#---#-#---#----#-----------#----#-#---#--##-#--#---###----##-#
--#------####--##--#------------#---##----###---#-----##-------#--##-#-#-----####-#----#-##--#---#-#
---#--#-##-#-#--##-#-#-##-----------##-##-#----------#--------------###--##-----#----#-----#--##-#--
--------##--##---#-#----###--#--#-#---#---#-#-#------#--#-#--------------#--##-----------###-#--#-#-
---#---------#------#----###-#--------##--#--##--##-##--###-#-#--#-#-##----#-#-#####---##-#---#--#--
#-####------------#--#--------##-#--###--###--#-#----##----##----###-##---#-----#---#------##--#-##-
#----##---#------#-#-#-#-----#--#--------#-#--#-#-----------------------###---#--#-#----#---#--#-#-#
#----#--##---------##---#-##--#--#---###------#------##---#--####---###--------#----#-#----##-##--#-
---#--#--#---#-#--------#-#-----#-----##-#---##--#-##-----#----###--##---------##-##------#-#-----#-
---#----#-------#--#--##-----#--#-#------#----#----#--------#-#-------------#-----#--#---##--#------
-#----#------##---#---#-#-----#-#---#--------#--###--#-----------##----#-#-##---#------#----------##
--#--####---#-#--##--------##---#--#--##-##-#-#-#-------------###-##-------##------#####-##--##--#-#
#-#--####----#----#---##--#--#-##-#-##-###---------#---#----##-----#-#----##--#--#--S-----#-----#---
-#-----##----##---#-------#--#-#---##------##--#-------#-----##-#-#--#---##---------#-----##--------
--#---#---#-#----####------#-------#------##--#------##--##--#---#----#-###---#--#---#-#-###---#----
#--##---#-#---###----###--##---#--#-##---####--#------#------#-----#--#-#----#--#-----#--##--##--#--
-##-#------#---#--#---#--##-----##---###-------------------#------#---#---------#--#--#-#--#--###---
#-----#--#---#-##----#------#-------#--###---#--###-#-----------#--#----##--------#--#-#-----##---#-
---#---#---#--##-----#------#---#----------#---#-#-----##--#-###-#---#-#-#---##--##--#-#-#----------
-------##---##--###------###-------##--#---#-----#-#--##-#-----#-----#---#----#-----#------#------#-
--##-#-------#-#--#------#--#-#----#-#-----#---#-----#-#---##-#----#-#----####--##--#-##------##--#-
-##-----#--##-#-------#----#-------###-------------#---------###--##---##-#----#----#---------#-#---
-----------#--##---#-----#--#--#-#-##-#---#-----##-#----#----#--##-#-----#-#-#-###---#--#--#-----#--
#------#-#------###-##------##------#-##-#--##-######--#---##--------#---###-####--##---####--------
#---#--#-#--------#---#--#---------#--#--#-----##-------#-----#-#-----#-##------#-------#-----#--#-#
#------#--####----#--#--#--#-##--###--#-#---------#-#-###------#-##-#-#--#----##-#-#----#------#----
-#-#-#-#-#------#---#---##-----------##--#-----#------#-------#-#----#-#-------#----------#-##------
--#-#-#-##---##-#-####-----##--#---#-#-------#----##------#--#---#--#-##--#-#-#-###--##------#-#----
-#---#----###-#-------###--#-------##----#-#--#----##--#-#--#----#---#----#----#----#--##--#-#---#--
-#-#-----##--#--#----##-###--------###-####------##-#-#--##----#-###-#-#---#-#-#--#-##-#-#----------
#--##---#--#-----#--###----------##------------#-----#--####-----###----#-##--##--##--------###-#---
#---------#---#--#----#-##----------------#-##--------##-#-------#--------#-#----#--#--#-#-------#-#
-------##--#---#----------####-----#-------#-##-#-##--#----###--#--##--#--#---#--------#----------#-
--#--#--#------------#--#-------#-#-#-#-----#-#-----##----##------------#--##-#------#------##--#---
-#-#--#----#-##----#---###------#-#--#-------##------##---#----###------#---#---####--#----#--#-----
#-#-#---#-##----#----##-###---#------#-#-#--##-#--#------#-------#------###----#-#--#-#---####-#-#-#
#-----##------#--###-#---#------------#---#----#---------#---#--#------##--###--#---#-#-#------#----
--#-#---#-#--#-----#--#---------#--#-----##-----#-##-#-E---#----#--##----#---#-#---#-#-#-##---#--#--
-##-#---#------------#--#-##---##-#----#----#-----#---#---------#-##-#-----------#--------#------###
####-------#--#---#-#-##-#-----#-#--#---#--------------#--------#----#---#-----------#-----#-#---#--
#----#-#---##-##-#---##-##---###--#-#------##-#---------#-------#--##-#-----#---#-##----##--#--#----
-------#----------#--####-#---##---#----------#--#-#-#--#---#-----####--#--###--#---#-#-------------
----##-#-##--#--#--#####-#-##-#---#--#--#------##--#--#--#------#--##----#-##--##-----------#--#---#
##-----#--#-----##-----#-#-##-##-----#-####----##--##---##----###--#-----##-#--#--#-##----#--#####--
-#-#--#-#-#----#--#---#----#-#---#--#-------#--##------#--###---------------#-----#-------###--#----
--------#----##------#---#--##-----#------###-#-----#-#--#-##-###-##--#---------#------------#------
-#-#------#-###---###--##-##-###--#---##------#-----#--##--------#-#-----#----#----#-#---#---#-#----
---#----#------#---#---###--##-----#--#-#-###--##-#-------#-##---####-####-##-#---------#-#---------
--------#--##-#--------#-----#-##----##------#------------------------##---------------------#------
##-#----------#---#-------#--##--------#--------#----##--#-##----#-------#--##----#--#--#-------#-#-
---#-------#-#--#--#---#-----#-----#---#-#---------#-#-#--------##-----#---#------##------#--#-----#
#--#-------##---#-#--##--------#-----#####------#-----#----#--#-#---#---#-----#-#-#--#---#-#-#-#---#
--##---#-#------#--#-----#-##---####----------##--##----#--###--#---##------#---#--#-----#--#-#-----
--#-#-#------#--###------##-##----------##-##-----#----#-#---#------##-#---#---###----##----#-#####-
------#--#-----###----#--#--#--#----#-##---#-#-#--------------##-#--------#-#-####-#-----#-#-#--##-#
######--#-#--##--#----##-#-#------#-------#---#----#------#----##----##-##-------##---#---------####
--##---##----#--#-#--#--###--------#-----#---##-----------------#-#-#-#---#-------#-----###--#--#---
--#---#---##------------#--#---#-------#--#-#--##--------##--##-#-----#----#-#-##--#----------#----#
