-#------#--------#-#-#--##--#-#--#-##-#---##----#---#-#---##-#-#-#--##-----#-##-#------##-#----##---
---#-----#-#-----#-#--#-----##---#---#-----#-#-#-#-#---#--------#--##----##-#-#--##---#---#------#-#
##--#---#--------#-----#---------##-#-#-###-----#----#--#---#---####-------#--#--E-#---------##-#---
#-----##-------#--#----##-#--#-###---#---#-#--#-#--##-------#--##-----##-----##---#---#-------------
--##-------------#----#------###-----##---#----------#--#-#----#--#--##---#--#-#----#---##---###----
-###--#-#------#------##-##--#--#-#-#-###---#-#----#-#-------###-#-#---#-----##-#--#-----#----------
------#-##-#---#--------#--#--#-------------------------##----##-----#----------##-#-##--#----------
##-#----#-#----#-##---#-------------####--##-###-#-#----#--#-#----#--------#---####--------####--#--
-##--#---------#---##-#-#-----#-----#--#------#-----#----------#----###--------#--#-##-----##------#
-#-##---------#--##------#--##-----#--#--#-------#--####------#-##-#-#--##---##----#-#--#---##-#----
-##--#---#-#--------##-----#---#--#---###--#--#---##--##--##-#-#--##-#--------#-##-#-##--###---###--
#-#-#-#-------#--##--#--#-#-##-#-##--------#-#-#----#-#--------#-#---##------##---##---#-#--#-------
---#---------#-###-##--#----#-------#----#----###--#----##----#-#--##--#-#---#---##-------#----#--#-
#---#--#--#-#-#---#--#--#----#--#--#-##-------#-#----##-----#-----#------##-------#-#----#--#----#-#
#-#--#------------##--#-#----#---###----#####-----#--##-###-------#--#--##--------###----#--#---##--
-##--------##-##-----#--#-#-----#--------#----##--#--#-------#--##--#--##--#----#-###---#-------#---
##--##----#-##-#--#--#---------#----#--------#---#-------#--#-##-#-------#-#---#----#--#-#----#-#-#-
-##---#-#-#-#--####-#---------#-#--#----#---#-##-#-#--#---#--------------#-----#-#----#------------#
-#-#--#-##-#--##--#--##--#--#--#--#---#--#--#---##----------##------#-###----#--#----#------#------#
-##--#-----#---#-#-##------##-#-#-#-------#-#----###---#--#-----##-------#-#-#----###---##--#--###-#
--#---#-##----------##-#----------------##-#--#--#---------#-##--#----##---#------#---##---#-------#
-#----#---##-##---#--------#--#-#-----#-----####---####-----#-#-###---------#-#-#---#---#-----#---#-
#----###---------###---##-###-#--#---##--#--#---#----#-###---##--#-#---##-#---#--##------------#-#--
-#-##-#-#-#--#-#--#-#------##------#-#-----#--#-#----##----#-###-----------##--#-##--##-##----#--#--
-------#---#-##--##-----##-#--#----##-----------#-----#--------#-#--#---#-###-##------####---#-#--#-
#-------#--#-#-#--##------#-----#---#-###--####--##---------------#-#-#------##-#---#-##--#--#-----#
------#--------##----#--#-----#------#-#--##-#-#----#------#--###------#---##-##----#-##---#-##-#---
----#---#--#---#-#----###-----##-----#--#-#----#-#-#----------#-#-----#---------------##-#--#-------
--#--#--#-#--#----###-------##--#----##--#--#----#--------#---##------#--#----#-------#---#-------#-
-##-----#-####----#--#-#----------#-#-----###---#--#---##----#-----##-###---#--##--###--##-------#--
---#-####--#-----#-#----#-#-#-#-##--#---##--#--------####---#--#-----------------#--#-#-#-##--------
##--#------#--##-----#-#-----#-#---#-#--##-#--###-##---#-#-#----#---#-#-#--#-#-----#------##------#-
-#----##---##-------#--#------#---#-#----------#---##-###-#------#---#--#--------#--#####-#--###----
---------#--#---##--S#-###---#-#--##-------##-##--#----##---------##--------#--#-#---#-#------##---#
#---####-#-#---##---------#-#-#----##-#----#---#--##-#---#---------#--#-------#--##-##--#---##------
------#----#-#--#-#--####------##-----------#-#--#---##--#-#--#--##--#------#----#---#---#----#---##
--###---------#------------#-#-###--#--#-##---#--#--#-------------#------#-####----#--#----#--##----
#--#-----#-#------#----#----------#-#---#-##-##---#-----#-#----#--#-#----##-#-----------##--#-------
#---#--#----###-###--##-###-##-#-#-#------#--#-----#--#--#-##----------#--#-#--------#----##--#--##-
-----#--#--------#---###--##-#--------#--------------#-#-----##--#-#-#--#-##---------##--#-###------
--#---#--#--#---------#--#---#-#---#--#--#--##-#------#--#----#-----------#--#--#-#--##-#-----#--#--
--##-#---##--#---#-----#-----#######------###---##----------------###--------#-#--#---####--#--#----
----#---#-#---####-#--#---------#--#-#-#----#---#-----#-#----#---#----#-##--#-##-##----#-------##---
------#------#--#------#----###----##--###-#---##----------#--##---##-#-#-----#--#--#-----------#--#
---------#-#-#----#----#--#--##-----#--##-##---#-#####----------###-#---#-#-----#---##--#-#----#-#--
-#---#-----------------------#--##--#-#---#--#-------#-#-##-#--#--##-----#-----#-----##----##-------
----##--##-------#--##--#-##------#--#--#-#-#---#-##--#--##-------##-------##-##-#--#--------#----#-
---#--#-##--##--##---------##-#--###--#--#-#-#-#----------##-#-----#----------#------#---#---#--#---
#----#--##--####--#--------#---##-#-----#----------#-#---#-#-#--###----##---####-------#--#-##------
--##---------#-----#-------#--#--#-#-#-#-----###----#--##-#-#-####-#--#-#---##---#----#-##-##--#----
---#--#--------#--##-##-#-###-#-----------##---#-#--#-##-------#-###-----#-#--#--------#--#---##----
--#-##-#--#------#-------#-#-#----#-----#--##-------#-#--#---#----#-------##--##-----##--#-----#-##-
----#-#-----#--#--#----------#--#--#--------##---##--#-#------##-###-#-#-#--##-----#----#-----#-----
-#---#----#--##--#---#---------#--#---##-----#-#--#-------#-#-###----#-#-#-#--##-##-#-#--#----##----
-##-#-#-##----#-#---#--------#-----#---#----##-##-#----#------#-#-#------#----###--#----#--##-----#-
-----#--------##-#-----#---------#--###--###--#-#--#----#---#------#-#--#--#--#--#-#-------#####-#--
---#--#---#----------#-##--####----#-###------#--#-#--#--------##-#---------------####----###-----#-
#-#-#----#-#-#-##----#-##-#-#------#---##--#---#-----#-#---#----#-###-##-###------#----#--##-#----##
-----#-----#--##----##----#-#-####------#-----#--#-###--#--#-#####-#----#----##--------#--#------#-#
-#-##-##-#-------#--##--#-----##-#-#----#---#-----#-#---#----#-#-#--------#-----#-#----#-#------##--
#---#-----#---#--#--#---#-###-#---###--####--#--##-------#-------------#-#-####------#---##--#--#---
----#-#--#---#-#-#-#-------#-----#-----#---#---#-#####----#----#-----##-#-----#----#-#-#----##-#-#-#
#----#---#-##-----#-####--##-##--#---#--#---##--------#--##--#-##-##----##-##--------##--#-##----#--
----####----------#--##-------------#-------#-#-----------##--#------#----###-#---##-##----##-#-----
--------##-##------##------##---#--##---##-#-#----##-#-#-#---#----#-#---------#---#-#-##-----#-#--##
---#--------#--#--#-#-------------##----##---#----#----###-#-#-#--------####-##---#-------------#---
------#-####--#-----#---#-#-------##------###-####------#-----#-#----------#--#--#--#-----#-##-#---#
---###--####-###--#----#--#-####--------#----#--###---###--#-#-#--##-#---##--#-#-#--##-#-##------##-
#--#----#--#---##-------#---#------##-----#---------#--------#-----#-----------#--------#-##-#-#--#-
###-----#-#---#-##---##-#--#-#--##----###-------###-#----#--#----#--------#-#-#--#--#-----##------##
---#---#------#---------##--##----#---##----#-----###------#---------------#---#-------#-------#-##-
#-#-#--#---##---#---#-##-#-##-----##--#-##-##-----##-----#----#---##--###---#--#---###--#--###-#---#
#-------#------#--##----##-----##---##-##--#-#--#-#--##----#---##-#-##-##-----#----##-##----#-#-----
--#-#-------##--##----#----####---------##-#--#-#---###----#----#-#-#-#-#------#--#-#--#----#--#----
---#---#----------#-##---#--#--#-###---#-----#----#----#---#---##-#-----#---------#----#--##--------
--------#-#---##------#-----#----#--#------#---#-#----#--#-###-----#-#-#-----------#------##-#---#--
#-#-#--#--#-#----###-#--#-##--#-------#------#---------##-#-#--------#--#--##-------##--##---#------
#----#--#----#--#-#-#-#--#---#--#-#-----##--#-#-#--##-##----##-------#----------##-----#--#----#--##
-----#--#-#--##-###-#-#---#----##--##-#---#-#---#---#----##----#----##-##-#---#-#-##--#-#-##--#---##
-##-------#---##---#----#--#---#-#--#--------------------#---#----##------#----###-#----#-----------
----------#-#--#---------#-#-####-#-##-#--##---------#--#---#--#--#---#-----#-#----##-#---#-#--##---
-##--##----##-#----------#-----------##---###---#-----#--#----#---#--#----------#--------------#--##
--#-----#---#------------##----#--#---#-#------#-----#--#------####-#-----#----#---##------#-#------
-#------#-----#-##--#-------#--#-####----#--##-###-----##--#-#------#-####---##-##----#-----##-##--#
-#--#-#-----#-#---------#-##------------------#--#------------------#--#--#-----#--------##--###--#-
-##-##-###-----##-##---#-##-#-#--#--##--------#------#----------#--###---#---##-----##-##--------#--
---#-##--##---#-##--#-##--#--#--#---#---#-#--#-#--------#---#----##-----##-----#-###-###-##-##-#---#
#-#--###--#-#-##----##-#--#----#----------###----#-----#-##-#--###-##------##---#-##--###---##-#-##-
-#--#--#####---#------------#---#--##-#---#----###---##-----#--#-#----##-##-##----#---#--------##---
---------#--#-----##----#-#-##---#-----#------#-#---#----#---##-##----#--#-#--#----##---#-#--#----#-
#-#-#--#-##-#-###----------------#-##----------#---#-#--###-----#-#---##-##--###----#-#-------##----
----#-----##-#---####-----#-#---#--##---#----##-#-----#-#-###-------######--#--#----##----#----##---
--#-#------##---####-#------------##-------#--#-##--#-##-------#-#-#------#----#--#-#----#--#-#--##-
--#---#----#-##------##----##--#---####-#---##--#-#-----#-##--##----#---###-##-----#--#--#---#----#-
-#---#-##--#--------------#-------#----#-#----#-#-----##-----#-#--------##------#-####--#--------#--
-------#--##-#-##-#-##-----#---#-------#--#--#-#-#-----##-#-----#-#----#----##-------##-#-#-#-------
##-###-------#---#-----#-###------#--##----#----#-##-###--#####-####---###----#------#--##--#-------
--#--#----##-#####-#-#---#------#------##-#------#-----#-------#-----##--#-###-##---#-#---#----###--
----#----#--#---#-----#-#-----#--#####-------#-#-#-----#-------####------#----#--#--##-#-#----##---#
---##-#-----#-----#---#--##-##-------#---#-------------##-#-------------------#---#----#---#--#--#--
