---#--#----###------#--##-###----##--#-----#----#-#----#---#--#-----------#-#----#-#------#-##----#-
------#####--#------#-#-#--##-#------#----##---#--#---#-----####----##-----###--##---###--#---#--#--
----#---#----#-----##---#-----#-#--##----#--#----------##-#----##---##--##--#-##----#--#--##----#-##
#----#--#-#-------#--###-#-#####-#---##--------------#-#------#------------#-##-----#--#--#-###---#-
--#-##---#-#--#-#-#---##----###-#-##------#--#-------------#----#-##-##--#---#----##-----##--#------
--------------#--#-#--#------#-##-----#--#----##--##---#---#--------#----#-#-#-##-###-##--###--#----
--------#####----##-#--#----##-------#--##---#-##--#---#----#-#---#-#--#-####---#----##-#-#-----##--
-##---#-#---##--#-#-------#--#-###-#--###-#-#-#-----#-----#-#---#------#-#-####----#---#----#----#-#
-#--#--#----#-----#---#----#---------#-----------#-#-----------------------#------#----#-----#------
-#-------#--#-------##--#---#----#---#----##--#-#--#--#---#-##--#---##-----#-----#-#-###-###--#--##-
##-#--#--------#----#-##---#---#----#--##----##----#-#-----#-----#---#-#-##-#-####-#------#-##--#---
##--#-#-##-#---#----#-#----------##---------#---#-----#------------#---#-----#-------##---##---#----
-#---#-#-##-#-#----#-###---#--#----###----##----#-##-###---#------##-----#------####--------#-#---#-
---#-##--#-###--##-------------#------#--#-----#-----#----#-------#-------------##--#--------#---#--
--##-#-#-#-##-#----#--##---####-#-#----#--------##--##-#------#-----#----------###---#-#--##-----#--
---#-#-#---##--#--#--#--------#--#----###-----#------------#--#-#---------------#---#------##----#--
##---#----#-#--------##--#------------###-#-#----#---###-#---#--###-##-#-##--#-#-----#------##----##
##------###---##---------------##--------#----##--------#-----######--#-#--------------###----------
----#-#-#-----#-------##-#----#--#--##-##-#----#----##-----#---#--####-#----#-#-#-------##----#-#---
------#-#---#-#-#---#--##---#--#-------#---#--#---------##-#----------#---#-##----------#-###-#-----
------------#-###---#-#----##-----###--#-----#-#-###--####-----##-----#-##----#-#-#-#--#--#-------#-
--###-#--#---##-#--#--##---#----#--##-----#----#--###---#--#---#---#---##-#-##---##----##--#-#-#----
--#----#-----#-#---#----#-#------------#---##--#---#---#-#----##---------------#-#----#--#---##-----
--##------#--##--------#-----#-#--#####-----##-----#####------#--##----------###--#--#-#--#----#-#-#
-#-##--#--#--###--##-----------#---##--#--#---##--#-----#-----###--#------##---------#-#-#--#-#--###
---##--#----##--#-#----#---#---####-----#-#-------###---------#----##---------#-#-#-------#----#----
####----#---#-#----#-----##------#--------------####-##--#-----#-#-#--#-#---#-#-#----#--------##---#
---#-------#---##--##--#-#--#--#---#-#--#--------#--#----###---#----##--#--##-----####--#------#----
#-#------##-----#--#-#-------#---#-#-#----##--#--------##--#--#-#---#-#---#----#-##--#---##---------
--#-----#-#----#-#----------#----#--####-##---###-------#------##--#-----#-----##-#--##----#-##---#-
-----###---------##---#---#-#-##-#--##--##--#---#----##-#---------#--#-#------#--#-----#---#-###----
-#-#-##--#---###-------#--###-#--##-----------#----#------##--#----#-#--------#-----#-#----#---#-##-
-------##-#-------#----###----------##------------#-#-----#----##------###---##--#-#--#-----#-#-#---
----#-##---------#---#--#--#---#--#---####--##-##---#-----#---###-----#----#---#-##--##----##-------
##--##-----#---#------##-#------##-#-#---#-#-#--##-#-#---#-------#-##----###--##-#-#----#-#-#--##-#-
--#-#-#-#-#-#-#---#---##-####-#---#----#----##----##-#---#-----#--#-#-#---#-##--#-#--#---#-##-#-----
--##--#-##--#---------#---##-----#---##-#------##----------##-#--#----#--#-#--#-----#-##---#---#----
-##-------#----------##-------#-#-##-##----#-------#---#--#--#---##--#----------#----#----#--#------
-#-#---#----##-#-###--------#-#---##---###---#-----------##-#------##-----#---------#-##-#-##-#-#---
--##--------####------#--#---------#----##--#--#---####--#--#-----##--##--------##---#-#-----------#
----#----#-#-#-#-#-#----#----#--------#-#-------##--##-#-#-----##--###-##---#-----####-----###------
---------------##---##-----#-#-#---#------#--------###----#----##--###-###---##--###--##-#----------
-#-##-----#--#-#-----#--#-#-##-##---##------------#---#--#----#---##---#---------#--#---------------
--#-#--#-#--#-----#-#-------#---#-#-#-##-----------#------##--#-------#--#---##-##--#----#--#-----#-
-#---------------#-#-#-#------#-##---#---#---#-E-##----------##-#--##-#-##----#-#--#--#----#-#-#--#-
-##-----#--###--####----#-#--#####-----#------##----#---------##--#--#-#-----#----#-#---#---#--#-##-
--###-#--#--##---#-#---##---#-#----##--#--#-#--#---------##---#-#---#-####-##--------#-------#------
-#-###--#-#--#------#--###---###---#-#-###-##-------#-#-##-#--#-#-#-#-#----#-#----------#---------#-
----#-#----------#-----#--##-#---###--------#-#-----#----#--#--##---#----##-------#-----###-#---#---
--###---#-#--#-#---##---#-#------#-#--#####--##-------##-#-###-----#-#-#----#-#-#-###----#------#---
-----###---##------##----#---------------##-------##-#-#-#-#--##-#--####----------#-------##---##---
----#-----#---##---#--#-##-#--##-#-#--#--------##------#-----#---#----#-#-#----##----#--#--##-##--##
------#--#-----#-##--#-#--##---####------##-#-#-##---#--#-#-#-##-----##-#-#--#---###-#----#-#--#----
--##---#--#--#--------#---------#-#--------#-#--#-------#----#-----#-----#----#--#-#----------------
---#--------#-------##---##-#--#-#----#--#-----#-------#------#---#-----#-#-#---#--#---------#-#-###
##---##---##------#-##-###--#----#--#----#----#---###-##--#--###--##-####-----#--------#-#--#-#-----
#-##--#--#-#---##-##-----#---##---#--####--#--#---#####-#-------#--------#--#-#--#------##-----##-#-
---#----#------##----------#--#-##----------#-----#----##--------#-#-###-#-#---###----#-###---------
--#--#---#-#----##--#---#--#--------#--#---##----#-#--#--------#-###---#-##-------##-----##---#-#-#-
#--#---#---#--##----###---#-------#--##----#---##-#----#------#-#----###---##-#------#--#-#-##-#--#-
--##---------##-#-----#-#----###-----##-##----------#-----#-----##--#----#--#--#----#-----##--#-##--
--#-#-------------#--#----#-#-#---#-#--#-##------------#--#---#--##-#----#--#-#-#----------#--##-##-
-#--#####-#--#---##-##-###----#--------#--#####------#-----------##--#----###-#-##--------#-#--##-##
#----#--##-------------#-#---#--#-##-#-#--##--#-###----##------#-----#---#------#-##-##----##-###-#-
##-#-#-#------#-------#-##----###-------#-----#----#---------#--------#-#-----#----#---##-----------
####---#------#-###-#---------#--#------##---------#---------------##--#--#-#-----------#--------###
-##-###-----#--#--#---###---#----###-###--#----------##-#---#----#-----#--#----##---####--#-----#---
-###---#---##-##-----#-#------#-#----#-##---#-#------#----#------##--##-#---##---#--------#--#--#-#-
-------#------##----#---------#--#----#-#-----#-----#----#-#-#----#-##---##-----------#-#--#-###---#
---#-----#------------------#-##--####--#---###-#-#-#-##--------##-------#-#--#-------#-#--#--#-#-#-
-------------##--------#--#----#------#--#--------#--#-#--##----##-##--#------##S##-------#--#--#---
-#--#------##-----#-#-#-##-------###---#-#-------------#-----##-#-------#-##--#-#-----#-#---##--##--
--###-#--------------#------##--#---#####-##--##-------------#--##------#---##---#------#---#---#--#
------#-----#---------#------------#--#-----#---##--#-##-#----------##--#---------#-------#--####-#-
-#-#------##---#----#-##-##-----#--------##-------#--#-###-##--#-#----#------#--#-#---------#------#
--#####-----#--#---###-###-#-#----#-##---#---#-###---#-----###-#-----#-#-###-##------#-#-###-#--##--
##----###---#------#-------#-#-#-----##------###---##-------#-#--##--#--#-##-##----#--####-###----##
--#---#-#-#-#--###---##-#---#--#----#------#-###-----#-#---##-----#-#-----#-#-##-##-##---#---------#
-#-------#--#---#---------------#-###--#-#-#--#-#-#-#--#--#-##--##----------#-------#--##----#---##-
#--#-#----#---------#----#-----#--#-##-#--###---#--#--#-----#---#-#----------#-----------#-#-------#
-#-#----#--##-#--##-----###---------#-------#-----#------#-###--#--##---#---#-#----#-##--#----#----#
##--#----#-------#--------#-----##----##-----#--#-#--#--#-###-#-#-#--###--##---#------##----#--#-#-#
#---###-#--------#---#---#--#-#-###-#-----------#--#-#-##-#---###-##-##-#####------#--------------#-
#--------#--#------#-#--#---#-#-###--#-----#----##-----#--#-#---#--#---#-#-----#-#-#---#-#----#---#-
-#-------##-#-#----#-#---#---##--#-####-#----#------#--#---#-#-#-#--#----#####-#--##-------#--##----
-#----------##-#-------#-#-----###-##-#---#-##-##------#------#---#-###--------#---#####-----##--#-#
----------#-#--#-#----##-#------#--####--------#--#----------#-------#---#---#-#-#--#--##-----------
--------##-------#------#-#------####---##--#-------####-#--##-#-#--###--#####---##-#---#------##---
----##-----#--#-#-#-#---##-----#-##--####--#---#-###---##------#-##--#------------##-----------#-#--
----##---------#-#-##--------#-##--#---###---#-#--------#----##---##-#-####-#-#---#----#-##--#------
---#-------#---##-#-#---#---#-#---#-#-####--#---#--##-------#--###---#-#-------------#---#---#----#-
--#-----#-#---#-#-----#---#-#----------#-#----#-------##---#----#----##-#-#---------------#-##-#-#--
----#--#-#--#-##-##-#-##-------#---#-##--#------###---------##---###-###------#-------#---####-----#
-##----#---##--#----##-#-#----#-----#-#--##---#-----#---#--##---#-##-##--------#-----------#--#----#
---###-#--##--#-##--##----------#--#--#----#---#---#----#-#-#-##---#-------#-###--##---#--###-#-----
--#----#-------#--#----###-----------#--#-#-----##--------#---##--------###------#---#----------#--#
##-----#---##-#------#------#-----###--#----###-------#-#------#--#-----#----#--##-#----#-----###---
--#-##------#----#---------#-------#-------------##-----####-#-##---##-##--#-##-------#-----##-#--##
--#-----##-#--##-----#-----#-------##-#-###-##-#-#---#---#-#-#--##-#----#-#------#-###-##---#--#--#-
-#--#-#---#####-#----##-##----------#---#--##------#-#-###-#--###-#---#-#--##--#--####--###---#----#
