-##------#-#---#-----###----##-----------#-#-#----#-#####-#-----#-----#-#---#------#---#-#------#---
---#---#--#----###----##-#--#------#--#--#----#---###--#--##-#-------#-------------####-#-------#--#
---#--#---##--#--#-##---------#---#-#--------#-#----#---#-#----#----#-----##-----###----#-##--#----#
#-##-#-----------------#--#---#-----#-#-#--#----####---##----#--##---#-#--#-#--#-------###--##------
-----#-#------#----#-----#---#-------##-#-#------#---#------##--#---##-#-##-#------##--------#---##-
##---###----#-##-#-----#-##-------#-#---------##--#####--##-------#----#-#------###-----#-#-#--#----
--#--##-#-##-----#--#---#--#---------------#-##---------#-------#--------#--#---#--------#--#-----##
##--###----------####---##--#---##-----#----#--###-#-------------#-------#----####-#---------#-#----
-#-##----------#--#----#-----##------------#####-##--------#--#---#------##--##------#-#--#---#-#---
####--#-------####---#------#--------#---##-#####-#--#-------##-##--##--#-----#--#--#-#---#---#---#-
-##-#-#--#--#---#------#--##--#----##-###---#----###--#-#--#---#-#------#-----#--####--##-----#-#--#
-#-##----##-#-----##--###-----###-#-----#--##-##----#--------#-#--##--#---#--------#----#--#-#-----#
-----##-----##-#--#-#--------#---#----#-######-#-----##--#-#--#-#---#----##----##--#---##-#-#--##-##
#----#----#---#-#------#----------#--#-###--#----------##--------##-------###-##---#-------#-#------
-##-##------#---#---#-#--#-#--#-##-#---#-#--#-#--#-#-##-----##---#-##------#------##---#-##-##-#---#
#-------------#-##--##---#---#---##------#--------##------------#----#--#----#--##-###------#--#----
---#--#---#--##--##-#-#--#-#-----#---#------#--#--###-##----#---#----------##-#-#-------##---#----##
-------##---###---#-#--#-----#-##-------#-------#------#-##--------#-##---#-----#-#-##------##-##---
----#------#---#--#---#-----#--#-#--##----------#-----#-###--------#---#-###-----###------#--#------
-----###-##-------#---#--#-------#---####-#--#-##---#-##---##-----##--#----#----#---##--##-#-#---#--
----#---#-----------##----###-##--##-###--#--#-#-----------##--#---#--#-#--##---#----#--#--###-#---#
------####-#--#-#-#-#-#-##-#----#--#-#--------------#-#----#-#-----------##-----------#-------#-##--
-##--#-#--#----#--##-#----#-#-#-###-#-#------#####----#-------#-#--#---##---------#---#----#--#--###
--##-#-#-##-#-#-#-#-----------#-#-#------#--##-----###-#-----##--------#-###-#---#-----#------------
##-#-#---##-#-#---#--#-#-#--#-###----------#-#----------#--#-----##--##------#---#-----#----#-----#-
#------#----##--#-#-----##-#-#----#-#----#-#-#---#--#-#-#-#---##-#--####-------#-#--#---#--#-#-----#
-#--------###--#--#----#-#---#-#-----#----##---##--#---#-------#------------###--#----##-----##--##-
-#---#-#-#-##-#-##----##------#---------#--##-#-#-#--------#--#--#--------#-##-#---#-##---------#---
-#-####-#--##-#---------#-#------####-#--#-#-#----#-#--#---#---#--------##-#--------------#-##------
##-------##----##-#--#----#-#---#-#---#-----#-------####---#---#-#-#--#--#-##------------#----------
---#---------##--#--#--##---#-#--#-##---#--#----##--###----#----#--#--#--#---##-#-#-####--#--#-#--#-
-#----##--##-#-##---#-#------###--#--------##---###---#----#-##-#----------##---------##--#--------#
-#--##--#---#-#--------##-#--#---------#--#------#-###-#-#-##-----#------#--#--#----#---#------#---#
#----#----##---##--###-##-----##------##-#----#----#--#-----------##-#----#--#------------#----#----
-##------##----#---#-#--#--##--#----#--#-----------###-#-#--#---#-##-##-------##---####--#---###--#-
#--#-#---##-#----##--#-#-#--#-#---#---#-#---#-#-#------##-#-------#----#------------#----#---#-#--#-
------#--------#-#--##-------#--##-#--#-#--######---#--#-#-#---#-#--#---#---##------#-##--#--##-##--
------#-#--#-#--##--#-#-###---------##--###------------------#---##--#-#--#----#-----#--#--------#--
----###-#-#-#----#-#-#--#------##---##-------#-S#----#---#-#-#---#-###--#----#-------##----------##-
#------##-#-##--#---#---#-#----#-#--#---#-----#-###-#--#-#------#---#-#-##-##-#-##-#---#--#---##----
-####-----------###--#-#---#----------#-#--####----#--##----##--#-#-#---###--------#----#-##--------
#--##-#--#----------###-#---#----#-------#---#---##--------#--#----##--#-###---#----------#---------
---------##--#--#--###-#-#----##--##--#-#--#-#--#----#-----#---#----#-#-##-##-#-------#--------##--#
-#--#------##-#-#-##--#----#--#####---#----#---#-##--#-##-----######-#-#-----####-----###------####-
-#--#-----#-#---#---#-------------##-##-###---#-#-##-####------##-----------##--#-#--##------#---#--
----#---#-#----------##-##------#------#-#-----##----#----##--#--#--#------#---#--------------#-#--#
--#---#-#--#------#-##-------------#--#----####-------------------#---#---#-#--------#----#---------
--#--#--#----------#-#-###-##------#---#-#-##-------##-#---##--####-#-#---#--#-#-#---#----#-#-------
-#-----------#-------------#--#-----#--##---##------##------#-----######-#-----###----##-#--#-----#-
---#-####---#--#---##------#---##---#--####-----#----------###------#--#-#----##----------###--###--
----#--##--#--------#####-----###-#-#----###---#---#---#---------###-#-#---#--------###----##-------
------##--#-###-#--#----#-#-###--#-------#-#--#-###-----#-#-#-#---#-#-----#-#---#-###---##-----#----
-#---#-##--------#----------#--#-#-###-------#--------##---#-#---#-#-#-#--##---#---#-#-----#---##---
#-----#-----##-#--#--#---#------##-----#---#---#-----###-#----#--#---------#--------#--#-----#---#--
----#--##---------#-----#-#--#-#---#-------###---------#------##-#---#---#--------#----#--------###-
---#------#--#----##---##--------#-#----#--#--#--------#--#-#-#-----##---##-#-#--------#--#--#---#--
--#---#---#---##----##-####--#-###--#---#-----##---#---#--#--#----#--#------------#--#--###-#-#-#-#-
#----#--------#---#------#--#--------##--#---##-#---------#----#---------##-----------#------###-#--
##-----#-#--##-#------###-----##-#-##-----#----#---#-###-#---#----##--#-#-----##---###--#-#---#-----
--#-#---#-#-----#------#-##-------##-#--#------##-----------#---#--#----#--#-#----#---####--#-#---##
--##-#-#-----##-----#-#---#---#---##-#----#--#------#---##-########----#----##--##----#--###-#------
-#--------------##-------#-#----##--###--#-#---##-#--------#--#-######--#----#----#-#-##--##---#-#--
---###-#----#-#------##---###--#----#-#-----#-##------#-##-----###-##--##------#------#--#-----##-##
------#-----#-###------##-#-#--#-##-------#----#-#-#-#----###-#----#####-#-#-###-#---#-#---#-##-#--#
--#------##----##-#---#----#---#----###---------#--#-#--#----#-#---##-------------####---#--#----#-#
---#-##------#-##----#---#--#---#-##--##-#---##-----#------#--#-##-----------------#-#-----#-#------
--------#---#-#----##-#-#---#----#--##-#---##--#--#---#-#-----###--#------###-##-#----#---#-#-#-#---
--##-##---------#---#--#-#------#-----#----#-###-#--#--#-#--##--#---#----#----#----------------###-#
---###----#---#----#------#---#---#--##---#-#-----------##--#---##--#---##-------#-#-#-#--#--##-----
###-##---#--##-###-###-#----#--#--#---#--#---#-#---#----##-#--#---#--#--#---#-----------####------#-
-----------#---#--------------#----##--#---#----#-#--#-##----#--------#--#---#-------------#-#-##-#-
--#--##----#-------##---#----##---------#---#-#--#------#---##-##----------#--#--####----##--#--#--#
##--------##--#--##----#--######--#-###---------#-###-----------##-----##------#--##----##-###--#---
------#---#---#---#----------#-----#--#-#-##---##---##-#--#-##-#-#---##---#---###-E---#--##---#-#---
##---#-#--#------#----#------#-##-#-#-----#--##----#---------#--###--#--#-#----#--##---##----#--##-#
-#-#------#--##---#----#------##------------##------------#--#-#---#----#--#--#---#--------#-##---#-
-------#----------#------------#-#---##----#--#-----#-##-#----#--#----#--#---#-##--#-#--------##----
#---#-----#------##---#--##----##---#-#-#--####----#-##--#-#----#-----#----#---#-#-----------#--#-#-
#-----#------#----#-#------#-#--###--#-----#-#--#--##----#--#----#-#---#-#---##----##--#-###-#-##--#
##---#----#--##----#------#--------------#-----##--#--###--#------#-#-----#--#-###-#-#---#-----#-###
--##-#--#-#-------#----#-#---#-----##---###----#-###--#-----#---##-----#-#----#-#--##------#---#--##
------##-#--#-------#--------#---#------#--#------#---#--#####---##---###---#-##-#----#----------#--
#--###-#--#-#-#----#---#-----------#-#-----#-#-##-------#-##-#---#---##-#-#------#--##-----#--##----
--#-#----#-##----#----#-#-------#--#--#---#-----####--#-#-#--#--#-----#-----#-##-#-#--#--#--#-#-##--
----------###-#-------##-----##-#-#-#-----#--#-------#--##--##--#-#--#-----#----#---#-----#-##--##--
#--##---##--#----#-##-###----#------#---#-##-#--#----#-#--------#---------##---#--#------#-##-----#-
-#--#---#-----#-##---------#---##--####-#-##-#---##----#----#-#-----#-##-#-###---------#--#--##---#-
#---##-#-#--#-----##--#----#------#---##---#-###-----#---#--#-###---------#------#---#--##----#-#--#
---##---###-##----#-#---#-----#--#----#--#--#-##-------------#-#---------#-----#-----#---#--#---#-##
---#-#------#--##-#####--#--##-###----#---------#--#--#-------#----#---#-----------#--#-#--#---#-#--
-#-#--#--##--#---#---#--#-----#---#-#-------#--#--#--#-----##-------------#--#-----#------#---------
---#----##-######--##--#----##----#--#--##-#-----#--#-#-------#-##-#---###---#-##-##---##-------#--#
--#-#---#---------#----#-###-###-#-###-##----------#---------#-#--#---#--##--------#----##-#----#--#
----#-----------------##---#-----------------#---#-#-#--#--#---##---#----###-----##---#-------#-#---
#----------###---##---------##---#--#--###-#--##-##-#####-#---#-###-#---#------#---#-----###-----#--
-##---------##----##----#------#-------##--##-##---#--###----------#-----##----------#-#--------##--
-###-#---##--------#---#-----#--##-----#-##------#####----#-#--------#------------##-#-#--##--###--#
-###---##------#--#---#-#--#--#-##-##----#---##-##--##---------#-------#---#----###-#####---###-----
-------#-----#-#--####---#-###--#-##----#-----###-#-----#--##----##-----#---##--#-------#---####--#-
-#-#--#-##--##---#--#----##-#-#----#-##-#-#----#-#---------##--------#-------------------#--#---##--
