--##-#-----##--#--------#--#----#----#---#-----###--##--#--###-##---#--------#-#-#--#----#-#----###-
-#-#---#-----###--##--#------#-------##--#-----#-------##--------###-#-#-#---#-####-##---##-----#---
------#-##-#---##---#----#---#----#----##--#--#---##---#---#-##----#-#------#------#------#-#---#---
-#------#-----###-#-#--#---#--#---#------#-##-----#--####-#--#---####--####--##-#-#--##-------#-----
---###-#--#--#----#-#----#---------#-#-----#--#--#---------#--#-----#-#-#--------#---#--#--#-------#
#-#--#-----#---#-#----#-#-------#--##--###-##-##---#-#----#--###--#-----#----#-#--##-----#-#####--##
---#---#-#---#---#------##-----#--#--#--##-#----#-###---#-###-------###--##---#-##--#-#----#------#-
#-#--#---##-----####------#--#--#-#----#------#----------#-##------#--#-##-#----#--------------#---#
--#-####--#--#--##----##------##-----#--#-###-###---#-----##-----#-#-#----#----#--#-----###----###--
#----#---E#---#--##-#-----##-------#----#---##--##-##-------#-#----#-----#-##-----#-#---###-#----#--
------#-###--#-----#-----##-#--#-##-#-#--------######------#---#-#--#----#-#------------------#----#
-#-----##--##-#----##---#-##-#--#-#---#-----#---#-#--####-###---####-#-#-----##---#----#------------
#--##-#---#-#--------------##-####-#---#--###-#-#----##-------#---#----##-#-##---#-#---#-------#-#--
------#-#-#--##-#-#-----###-#--###----------#------#--------#-----#----##---#--#--#---#-#--------#--
--#-#----------##-----#-#---#--#---#----##-----#-#-----##-#-#-#-##--###--------#-#---##-----------#-
#-#---#----##--###-#------###---###--#----#--#--------#--##------#-----#--###-#-##---#----#------#-#
--##-#---###--#--##--#--#---#####-##----##-------------#-----------#---#--#--#--#--#-----#-#-----#--
---#--#-#----##-#---#--##---#--------######-#-###-#---#-------------#--#----#----------#-----#-#--#-
---#-------###--##-####---###-#-#---##-#-#--#----#-#-------###----##--#-----#--------#---#-##-##-###
----#-#-##---#-#-------#---#--##-------#---##--#--#-----#---##--#--#---#-#--------#-#-####--##---###
---------#---##-##----##---##-###-#-#-#-###-----#-#----##--#--#------##-###--#---##-#---#-#----#-#--
#-------#---#-----#--#---###-###----#--#-#----#-#---##--#-#--------#--#--##-#-----#----####-##--#---
-##---#-#---#-#-#-#--#-#-#--#--------#----#----##-#--#----#----##-#----##--#--#--#---##-#----##--###
---#-#----#-#------#---#--#-----#---#-----#--##-#-#-------#-#--#------###-#-##--##------##---#-----#
-#----#----------##---##---#-##-#-#-------#-#-##-##-#--#-----#-#---#----#-----#-----##---#------#---
----#-###-##-#--##-----#--##-#---#--#-----#-#-----##----#------###-#--#--#---#-----------------#-#-#
#-----#----##---#------####-----#---#--#---#--#------------####----#-##------#-------##------#-##-#-
--#-#--#-#-#-##--###----##-#-###-#---#--#-#--------#-------#-#-#---#---##-#--##-#---#--#---##--#--#-
-----#-#-------#--------#--------##------####---#-------#-#----##--##-----#---##----#--------#--##-#
---#---#-----#----#--#-#-#-#----###---#---------#-----#-----#-#-------#-#--#----#---##----##-#------
#----#-------#-#--#----------#----#-#---------------#------#--####----##-----#-----####--------#----
--------#----###-#-##------#-#-##---#---------#----#---##---#---------#----#--#--##-----------------
------#----#----#--#----#-------#-#-##----#-##--------#-#--#-##---#---#--#--##-----#--#--##-#----#-#
-#---#---#---#--#--#--#-#-------#--#----S---#--##---##--#------#--#--#####--##----#--###-------##---
---------#----#-#---##---------------#-##-----##---#-------#--#-----#--##--#-----#---------#-###--#-
---#-##---#-#----#----#--##--#-#-----------####--#-#---#--#-#----#-----#-###--#-----#-#-----#-#-#---
--##--#--------#---#-#####----##-#-#--#-#-#-#----#-----#-#-#--------###-##-##--#-#-#--#-#-#---##--#-
-#-----------#-#--###--#-##-#--#-------##--##--#--#----##--#----##----#-#-----##--#---------###---#-
##-#-----##--#---#######----#--------------------##----#----##------####-#--------#-------#---#-#---
-----##---#--#-#-------#---##----#---##---#--#-#---#---#--------##-###--#--#------#-##-----#--#-----
####--------#-#--##-------#-#-#----##---#--------#--#-----#-#-#--##--#-#------#-----#------#-##-----
-##-#-#----------#---##---------------#----------#-#--#--#----#--------###-#-#--#----##-##----#-----
---#--#-#--#-##-#--#---------#-#-#---------------##----#---#----#---##----#---####-##--------###-#--
-----#-------#--#-#--##--##---##----#-----#---#--###------#--###---#-#--------------#-#--###----#---
-#-#---#--#-----#------##----#----------#--##--#----#--------#----##-#---#-----#-----#--#--#----#---
-----#-##-##-#--#-----#--#-#--#-#---#-#---#-----###-###---#-#-##------#-####--#----#-----###--#-##--
----#----#----##-#--#-#-#---#-#--##-----####-----#-#--#---##-#-#-#--#--#-##-#--##---#--#--#-#-#---#-
-#------------------#-----#-#----#---#--------#--##-##--#--#--#----#-#---#----##-##-##-----#--------
#---#----#-##-#--##-#-#--#------#---##---------###-##-#----#---##-----#------------###-##-------##-#
--------#--##--##-------##--##-#-------------#------#--###---#-#--##------##---------#---##-#-####--
----#---####-----##----#-##--###---##----#--##----------###------#####--#---##-----##----##-#--##--#
--#---#----------##-###--###-#--##--#--------##-#--#----#---#--#------#------#-----#-##--#--##-#--#-
----#----#--#----#---#---#----##-----#-#-#--###-#--------##------####--#-#--#--#---#--#---#---------
-----#-----###----####-#-#--#--##---##--###---######----------------#-#-#--#----##---###-#-#--#-----
#--#-----#----#-------#--##----#-#---##-#--#-####--#---##---#-##---#----###---#-------##---#-#---#--
-#---##-#----#----#--#------------------#----#-----###-#--#----##-#-#-#------#----------#---#-###-##
------#--#---#---------------#####---#-#---##--#-#--##-#----#####-------#-##----------------###--#-#
###---#----#--#--#-#-###--------#-##-#--###--#--#-#-####----#--------#-#--#--#-#-#----#---#-###-##-#
#----###-#-#--##-#---------#-#-#-#------------##-----#------#-----#--####--#------#-#-----#-#-------
#---#---#-##---#---#------#---##-##---#-#-----##--#---#-#-#-#-#--#------##---#-#-##-##----#-#-##----
---##--##-------#--#---#-#-----#-##---#---#--#-#-----#-#-##--#--------#----#-------#--##--------#--#
-#----#-##------##--------------#-#--#----##----#--###--#---#-------##-#-------##-#---#-------#-#---
--###--#-#--------#####-------#----#---#-------------#--------#--#-###-#-#----#-#-#---#----##----#-#
--#-#--#-#----#-##---####-#------#--#------#---#--###----#----#--#----#---##-#-#-#-------##--##-#--#
-----------###-###-----##-----#-----#-#---#--#----#-#---#-###-#--##--#-#----#----##-----#---#--##---
-#-##---#-#------##---------------###------------#--#-#--#---#------#-##-#---------#-----#-#--------
------------#---##----------#---#--###----#----#---#--------#-----#---##--#--#----#--#-#----#---#-#-
#----------###--------#-##---#--#-----------#-----#-----------#-----###----#-#-#---##-----#-##-#--#-
----######---#---##-#-#------##--#---#---####----#-###---#---#------#------#-#--#--#--#-----###-----
------#-------#-----##-#-----##--#-#-#----###-#-#-#-------#---#----#--##---##-#--#--#-------#----#--
-#-#---------##-#-----#---##-#-#-------##---##-#----#---#-----#-#----#-#-#-#---##--#----##----#---#-
-------#------##-#----#----##-#-----#-#--##--#----#-##---#------##----#---#--------##-#---#--###----
-#-###------------#---#-------#------------#-##---#----#--------##-#---#--##---#-#-----#--#--#---##-
#-------#-##-----#-##-#--#-#-#-#-----##-###-#--#--#-#--##-----#-------#--#----#--#-#--------####--#-
-#------#---#---#--#--##--##-#---#------#------#-----#----#-#-#---#########-----##------#--#-#-#-###
##-##-#-#--------##---#--###-##--###----#------#--#---##---#--------------##---#-#----#-##----#----#
---#--------#--#------#--#-###---#---#------##-----#--##---#-#--#---#---#------#----##---#---#--#---
-------##-#--#----#--#-----#--##-----##--#--##-##-#--#---##-#----#------#--##--##-###-#-#-----#----#
-----#---#-#--#-#----#-##------#---##---##-----#------------#-------##---#-------#--#--#------------
#------#-#---##---#-#--#--#----#----#-##---------#-----##-#-----#-#-##-#------#-------------####----
----#-##-#--#--#--#--------------##-#-----------------#------#-#-----#-#-###-----#-#--#-#----#-#-#--
#--#--##---#-#----#--#--#--------#---#-##--------#-----#---#-----####-#--#--#-#-###-#-#------#---##-
---#-#---#----##--------------#----#--###-#--#---##-#---#-#---###-##-#--#---##-##--#--#-#-----#---##
----#-----####------#-------##--####---#-#---#-----#-#-#-------#-###--------------#--#-#--#--###-#--
-#--##---------#-------##--#-#--#------------##-#--#-----##---#---#-#---###---#-#--#--#-#----------#
#----##-#--#---#--#-----##-----#--------####------#----------#---#-#---#-#--#---##-#--#--##--##-----
#--------#---#--#-----#-#####-#-#-#-#--#-------##-#--#----#--##-##-##-#--##----#-###---#----#-#---#-
------#-#-##-#--#---#--##---#-#---##----##--##---#-------####-##-#--#---#-------##--#----#---##-#---
----------#----#-----------##--##-#-#---##--#----#--------##--##-##-----------#---##--#-#----#####--
---#----##-#---##-------#--##-#---##-##-----#-#--#----------#---#---------##-----#-----#---#-##---#-
----#--#--#-#------##-#-#-#---#--##-#-----##------#-##--#---#-------#----##-----#---#----#----------
----#-####-#-####------#--------#--#----#----#--#--#-----##---#--##--#-#--------#-##-----##-----##-#
#-#-#---------#-##----------#-------#----#-#-#----#---##-#--###-#---##-##------#----#---#----###--#-
#----#-------#-#----###-------##--#------#---#-##----#-#----#-----##-#----#--------#-----###--#-----
#-----#----#--#-#-#--##----##----#---#--#----##----#--##--###--##-----##-#--#-----------#---#-------
------##-#-#----##-#-#----#----#----------##--##---#------#-#-#-#--#--##-#---#-#----#--##------####-
----------#--##--#-#----#----##------###---#---------#---###-----#---#####---###------#-#-----------
---#--#--------#-------#--#-----#------##-#--------#-#-#---####-----#---#----#-#-###--##-------##---
-#--#--###--#-#---##----###---#--##----#--###-#------#-#---#--#-#-#-#----#-#--------#--#----##--#--#
#--##-#---#-#---##--##--#-#-----#--#--#--------#--##--#----#------#--#--------------#-##----#-#---##
