#-----#-#-#----#------#----#-------##-#---#-#-#--------#-##----#----#-###------##---#-#---##--#-##--
---#-#-#----####--#--#--#---#----------##---#-###-#--#####--#----#-#--#-#-#----##--##---#--------#--
----#-##------------#-##-------#-#-##-####---###-#--#--#--#-#--##---##---#-----#-------##----------#
------##-------#-#-#-#----------#-----#-------##-#--#--#------##---#--##-#--#--#---#----##----##----
-----#----##--#---#-#---#-----##-----#####--#-###----#-#-#--#-#------##--#----###--#-#--##--#------#
-##----#------#----#####--#---#----####---#------#-#---#--##-#---###------##---#----------#---###---
-----#-#-----###--#-----####-###---#-##---##-##-----------#-#--#-#-#####-##--######-----##-----#----
#--------##------##-#--#--------#-#--#---#--------#--#-#--#-#-#------#-#-###---#-#-------#----------
----#----#-#--##-##---#--###-#--#--##-----###-----#-##----#-#-#-#-------#--#####----#---#-#--##-----
-#-####----------------#---#-#-##-------#--#--##-------#----#-------##-#-----#-#---#--##--------#---
--#-------#----#----#--------------#-#---#------###---#-#-----#-##-------##--#-#----#---##--###--##-
----#----#-#-#--#-#-#-----------##--#---##---#-####------#-#---####------#----##--##-#-#---#--#-#---
---#-##----#-#----####------------##------##----##-##--##------#-#----#-----------------##--##-##---
---#-##----#---#-##----#------##-#--#----#--####---------#----##-#---##-#-##-###------#--#----#-#---
--##-#-------#--#---#---#--#-#---#----#---#----#-#-#-----#-#-#---##-----#-#-----#-##-----------#----
-##-#------#----#-------##-#-----#-#--####--##-----##---#--#---------#-#-###-#----#--#-#-#---#-----#
#-#-#--#--#-#-#-#---#-#--##--#---#-#####-#----##-##---#####-#---#---##-------#-------#-#--#--####-#-
---------###--#----#---##-#-#-##------#-----#-##---##-------#-----#-#---#--#---#----##-#----#---#---
#-#----#--##--#-#--#------#--#------##-##-----##-##---##-------#-------------#--#-#---##-#-#--------
#-#---#--#-#-#--#-#---#--#--#---#----#-------##--#---###-----##-##-#--#--#----#-------------##-###-#
---#--------#-#-----##-##--##----#-----#----#---#--##--####-###-#--#--##-#-#-------#--#----####-#-#-
---#--####-------#--##------#---#----#----#---------#--#----------##-#-#--#----#--------##--#-#----#
#---#-##-------#-------##--#--#-#--#-----#-#-#-##---#-#---##-#------#-###-#---#----#--#---#------#--
--#------------------#--#--##-##---###---#----####---##--#--#------#-#-#--#------##----#-----#---##-
----#--#-#--##-##---#---#--##-##--#---##--##---#----#-#------#----#-----#--##-#----##--#----#-#-#-#-
-#--##----#-------#-----------#-#---#--###-------#----#------##--#-#---#---#-#--####---#-##----#--#-
--#----##-----------#--#----###-#---##----#-#-----#-------#-----#-#-#-------#-------#--#-###-#----##
--#####--#-#---#-------##--#-------------#--#--#------#-------#-#-#-#-###---#--##-----------#-#-#---
#--#---#-#-----#--#-###-----#---##-#----#---#------#-------#---#-#----#---#--##------#-#-##--#------
------#-#-#-----#--#-#-----#-#--#-#--##--------#-####-#-----#--#---##-#-----######--#-----##-###---#
-###-----------#-----##--###--------###---#------#------------##-#-#--###--#--#--------#------#---#-
#-###--##------------#-#--#-------#--------#-#----#----#---#-#-###-##---#-#--#----#--#-#--#--#-----#
----#--#-----#---#--#----##-####-#--#-#---##----#-###----#----#--#--#####--#--#-##-#---##---##----#-
--#--###--#--#--##---------#----##---##--#-------##-#-#-------#---#----#---#-----##-###-------#-#--#
#-----#---#------#---#-#-##----#-##---###-#####--##------#-##----#-----#-#--#####---#---#----###----
----#----#---#-#----#------#-#----##-##---#-------------##------####----###----------#--#-#---------
--##-#-#--#--##-#------#----#--#-#-----##-----###-#-----#---#---#-#--###-----#-##-----#-##--------#-
-#-#----#--###-#---##----#--##----##-##----#----------###-#-#---------##-----#--#-#----------#--#-#-
-#---##--##-#-------##-#####-#--------#---#-----------##--#------##-#---#--#---#--#----------#-----#
--#######-----#-#-#-##-#--#-#-----##---#-#-####------##----##------#------##-#--#----------#---#--##
--#--#-#---#------#--#-#-----#-#--------#----##-------#---#--###-#-####---##--#----##-#--#-------#-#
----#--#--##-#-#-----#-#-#-#-#----#--#---#-#-#--#-#---##--#--#--#-###-#--#------######-#--#-------#-
---##--#--#-##-------#-------##--#-#---------#--###--------#---------#-----#-#-------#--#---#--##-##
#--#----------###--###-----#-----##-----#-#---#------#-#--#-#---##----------#-#-#--#-#------------#-
#----#----------##--##-#--------#---#----#---#-##-#----#----#---------#--##---#--------#----#-#-----
-----#--##-----#------------#---#-------#----#-----####--#---###--#---#---------#---------#-#--#--#-
#------###-###---##--#-#--###-#-###-#-------#---#-#-----------#-#-----#---#---------------------#---
--#-##----#-#--####----#--##-#----#####---##--##-###------####--#---#-##---#--#-----#-##----#----#-#
----#---#------#--#----#---#---##----#---------#---#----####--##--#--#--#---#-------#---#--####--#--
----##------#----###---#######-#-##------------##------#-------###-#---##---#------#----#------E---#
---#--------------#---##---------#-------#-####-#-####--#----#-##---#---#------#-----#--------#-----
-------####-------------#-#-------#####---#--------#---#---##--###--#--#------#-#--####----#------#-
-#--------###--##-#----------------#----#---#-#-#---#------#--##-#-##--#---#-####-#---#---#-------#-
-#-###---#-##-------##-------#---#---#----#--#-####--#---####---#----#--#-#-#-###--##--#----##--#-##
---------#--##-----#-#----#---##--------##-----#----####--#-----###--#-#------#--#------##--#-#-#--#
#---#---#----#-##-#--##-#--#----#---#------#---------------#----#--#-#----#--###----##----#-####---#
#---#-##-----##---#---##--#--##--#--#-----##-#-#---#--#----###-#-------#---#-----###--------####----
-#-----#---#--------#--#--###---##-#---#-#-----------#--#-#-#--#-#----#-------##---#--#-##----------
--###-----##---#---#--#--##-------#-------#--#---##-------#-#----#-#---##-----#-#--#-##---#--###----
-----###-##--#----##----#-----#-#--------####-----#---#--------#----#---#--#-##-#-#--##-------------
-#--#-#-------##--#--#-#---#-#-----###----#--------#-####-#----#------###--------------#-#-#-#--#-#-
-##--##-#----##--#---#--#-------------#---#-#--#----##---#-----#----#-###--#----##---------#--------
##-#--#-----#--#--###-----##---#--##-------#----------#----#-#-#-##--#-----#####-#--#-#--##----#---#
-#-------####---------#--##--##----------###---------#-#----#----##--#--##----#-#--#-#---##---------
##----#--------##----#----###---#-####---#---##--#----------###---##-#---#--##-#----#--#------##----
#-###-#---#--#-#----##----#------#---#----------#-#-#-##----#-#-------#-#-----#-#---------#-----#---
------#-#-##-#--------#----#---#-----##--##------#---------##------##-----#--##----#---#-----#-#----
-#--#----##--#-----#---#--#-#--#----#--#---#--#------------##-#--##--#-#---#-#---------#---#-#----#-
---#------##--------------#-##-#---#------------#---#---------#--------###-###-#---#-##-##-#----#---
-#------#-#---#-###--#--#---#---------#--#-------####-------------#--##--##--------#-#-##-#---##-#-#
--###----------#-####-#---#---#-#-----#--#-----------##--------##----#--#-------##------#-##------#-
-----#-----#------##-----#-------#####----##---#-------##-###-#--#--##-------#--#-#--#---##--##---#-
----#---#-#-----#-#--------------#--#-----##-#----#------#-##--#--##-------##-#----#----#--#---#-#--
--#---##---------#--#---#--##----#----#--#-#-------#-##--#---##-#-##--#--###---#---#--#---#----#--#-
-##------#---------#----------##------#-----##----#-#--------#---#---#-----#---#---#-#---#----#--###
-##--#-###---##-#--------##--#-#-------#-#---##------#----##-----#---##------#---#---##---##-#--#---
---#-----#-##---#-##-####-#----#--#-###--#---#-#-#--#-------#--##---#--#-----#-----#-------##---####
---##---#---------#--#--#-----#-----#-#-----#--#---------------#--------#-----#####--#------#-#-##--
---##-#--##--------#-------##-------##--##-#--#--#-##---#-#---#--##-##--#----#---#---#-----#-#-##--#
--##-----#-#---##--#--#--#---#---#-#---#---#-#-----#--####--#-------#-------#------------##-----####
-#----#------##---##---------#-###---#----------#-------#-#-#----##----#----##----##--##-#-#-##--#-#
--#-#-##------#----#-#-##---#--#-#-#---------#---##----##-----##--#-#-----#-#--------##--#-#--#---##
##-##---##---####-#--------------###---#--#-#--#--#--#----#-#-------#----#-#-------#-#----###-##----
--#-----##-#--###----###--#-#-#-#--------#---#-#-#-#--#----##--###-##-----###--#----#-#####---##---#
---#-----#---#-------#--#---##----#---------#---------#------##-#--#---#------------##-###-#-##--##-
#-##---------#-#-#----#-#--#-#-#--#--##--#---##------##---------###---#-#--#---------------#-#----#-
--##--####-----------##-#-###-------#-#---#--###--####--#-------#-#----#--#---#-#------###--##-#----
#--#-----#-#------#--##-----#---#--------##-##--------####-#------#-##-#-----#-#--#------##----#----
---#----#--#####-#--#----#----#----##--#---#-#-#--##-#--------##-#--#----#----#----#--#--##-##-----#
---#-#--#---#---#--#-#-#-------#---#------#-#-##-#--##------##------####--------##---#---#--#---#-#-
-##------#----####-----#-#-#---#---#---#-#----##---------#--#------##--------#-------##------#------
#-------------##----##--##-##--#--###-#-#-#-----###---#------#--#-----##--#--#--##-#------#--#----#-
#-----#-----####-#------#----#-#---#-----#-----#---#####S-##---#---#-#-#----#---------#-------#-##--
-#----#-#---#####-#---##-------#-------#---#-##-#---#-----#---#-#--#-----#-#-----###-##----##--##-#-
#--#------#---##--#-----------#---#-#----#---###-##----#-----------------##--#------##-#-##--#---#-#
----#--------##---##--#--#---##------#-#--###-##---##-#-----#--##----#-#----#--#-#------#-#---##----
#-##--###-###-#-----##---##-----##------#-##--#----###-#-----###---##-#--------#------#--##---##-##-
--------#----#----#---#----#----#---#-##-#---###-#--#-------##---------#------#-#--##-#--#------#-##
##--#------#--###--#-#---#-------#------##--###-#-------#-#-#----#----------##-#----###---#---#-----
-#-#---------#--#----#-#-##--###----------#------------#--#----#----##----#---#--#-------#-------##-
