##------#--------#------#-#-------#-#-#--------#-#----####----#-----#----#----##----###------------#
-----#--------#-#-##--###----#----#----------##--##----#-----------#-##------#-##---#-#-------#--#--
---#-#--#-##---##--##---#-#--#-----#--##--#-#--#-##---###------###--#--------#-#-----#-#--####--##--
-----#------#-#--#--#--#-#--#-----#-#--##---#-#----#---#------#---------#--------#--#-#--#-##-#-----
#-##-##---#---#------#---##-#--##-#--#-#--##----#-----#-#-#-#-----#-#-----------##-----#----------#-
-#-#-#--#---#-#---##---#--##-####--#-------------#-#------------#----##--##---#-###--#--##--#--##---
#----#---#--------#-----#--#---#-#-#--##--#--###-#---#---#----#---####---#--#-###--#--#-----#-#-#---
#---#-##--------#--#--------#----#-##---##----#-#------###---###----#----##-##-------###-#---##----#
#-##---#-#--##---##-#-#----#-##-##-#-------##---###-##-##-----##----##-#---##--#-#-#-----------#-##-
#-#-----##-#--#---#--#---#-----#----------#-##-#-###--#-------##----#-#-----#-#------##-------------
#-#--#------#-----------#--#------##-#--#-##----#-##-#--#-##-#--#-#--#-----#-#####---###---#-#--#-#-
-----##--#----#-##-#-##-#------#-----##--#----#-------#-----##-##---#---#--------------------#------
-----#--###------#-------#---#----------#-#--##---#--#-#---##-###-#----##-------#---###-#-----##---#
#-#-----#-#---###-##-##-#-------#--##---#-##----##-#-#--##--##---##-##-#-#-#---#-###------------##--
----##-#-#-##---##--##----------#-----------#-#----##----#--#----------#--##---------#-------#-###-#
-#-#----#------#--#-###---##--#--------#-#----##----#------####--##-##-#--##------##-#--#-------#---
---#--##---#--------#-#-#-#----#---#------##-#-----##-------##-##-#---#-----#######---------#-#---##
---###---#-----#--------#-#-----#----##-##---####---##----###-#-#--###-----#----##-------#--------##
-#-------#---##---#--####-------##-----#--#-#--#--#---#-#-#--#---##---#--#-------##--#-#-##-#-###-#-
#-#-----#-------#--#----##-#--##-----##-#--##-#-#-##-#-#---#--#-##-#---#----###-------#-#---#---##-#
-##---#-#-----------#--##--------#--#---#-#-#-#-##--#---###-----##----#--#---##--------#-----#-#--##
-##-##---#--#---##-#---###-###--#-##-----#-#--#####--#--###-#--#---#-#-#-#-----##--#---------##-##--
-###-------#---------------#----#--##--#----#-------#-#----#--#-----###-#---#---#-##--------#--#---#
-#---###-#--#----#-#-#---#-#-#--#-----##--#----------###---#--#-#--#------#----##--##-##--#---#-#--#
-##----#-----##-#--#--#-#-----#-----#-#-----#--#---#----#-#----#---#-------#-------#-#----#-#------#
-##-----#----#-#-#--#-------#------#--------#--##----#------#------#---#-#---#-----#---#------#---##
-#----#---------#-#--#-#-#-----#-####---#---#-#--#--------#------#-#-##------#---###-------#-#--##--
-#--#------#---#-#-------##------#-#-##-#--##--#-##-------##--#--##--#-----##--##-#-#--##-----##-#--
#--#--#---#--------#-----###--#-#--###---#--#--#--------##----#-#----#-----##------###------###-----
---#-----------#----#---#--#-#-#---#---------#---#--#--------#--#-----#------#--#---#---##--#-###-#-
-----#-#--#-------------##---#--#-#--#-------#----##----#----#------##-----#-#-------###-#---##-----
--#----#-#-----#-----#--#--#---##--------#----#-#-----##--##-#-####--------------#-#-#----##--------
-#--##-#-###------#--#----#-##------#--------#-------#-------#-#---#--#---##------###------#--------
--#--#-#---#-------#---#--###-#-#--#---#--##-#--#---#----------##---#--#-#----------#-#-#--#--##----
----#--#----#-#--##--#-#---------#------#-#-------#--#-#-##-##--#-#--#-#-#-----#----#####----#-#-#--
--#--------#--#---------#---#---------#------#------#-#----#----#---#####-------##--#-###-------#-#-
---#-#---#--#---#-##-#-#--#-#---#-#-#-#------#---##---#-#---##--##------##-#---#-----#----#-#-#--#-#
----#-------------#--#--##--##-----#---#---##----##-------#---#-#-----##---#-----#---#--#---###-----
--#-#----####-#--#-###----#----##---#--####---##----#----#--##--------#------#--#----##--#---###----
--##------#----#---#--------#---#-----#----#----#-#--##---#--#--#------###---------#---##-#-#-#---#-
-----##---#--#-#---#--------#-#--##--###-##---#-#--#--#----#-#------#-###--#--------#-----#-##----#-
------###-#-----#--#---#------#-----#--#---#-----#--#-#-#-#-#--#--#--##----#-#---------#-----##---#-
-####-#--#----##----#-----##--#---#-#---#----------------##-----#-#-----#---#---#--------#-#--------
#-#--#--##--#------##-----##--#-#----#-#-#-###----------##--##---#-##--###---#----------------#---#-
#------##---------#--#---#-----#---###-#--##-#-###---------#--------#---##-#----#---#----#-----#----
--#---#--#--#--#----------###-#--#---------#---#####---####----##-###--##---------#--------------#-#
#----###-------#-#---#-----#---###-#-#---##-#-#--##---#-##---#-------#-#---------#--#----##-----#--#
#--#-##-#E##-##----#---#-------#---------##---#----#-#----#--##------#---#-####-#--##------------#--
---###-###-#----#------#--#-----#---#---#--#-##--#-----#----#------#-#---#--#----------#-#------#---
####----##-#--#--#-##--##--##--#-###---------#-##-##--##---#-#-------#-#------#----#----#--#--##-###
##-#-#-----#-#--#-----------##-#----#--#--#-----###---#-----##-#-#-#-#-------#--------#-------#---#-
---###----------#-----#----#-#--#---##------#-#-#--#-#------#--#--------##-------##---#--###-##--#--
---#-#-##---##------##-------#-#----####--#--##----#---##-#----#----#---#-#-----#---#---#--#-##--#--
---#-----#--#-###------#-----#---#-###---#------#----##--#----#---##-#---#-#---##-#-#-#--#-#-#-##-#-
--#-----#--###--###---##----#-----#------#-----#--##---#--------------#--##-#--#------#---##-----##-
#----------#--------##---#------###--#-#-#------#----##----#-#------#--#------##-##-##--#---#--#-#--
--#-#-#-#---###-#------#--##-#--#----#-------#--#-##--#--#----#-------#---##--#-###---------#----#--
--#---#-#-----#--#-##-##-###-#---------###-----#---#--##-#######--------------#-#----#---#--#-##----
#-#-------##----#----#-#-#--#-##--##-#--#-#----#-------##--#----##----##---#---#--#----#-----#----#-
--------#####-#-------#--#-#-#-##-##----#--#----------#---##-#-------#--#------#-#-#--##------###---
-----------##--#-#--------#---#--#-#-------#-#-#---#---#---#--------------##---#--#--#-#-----#------
--#----####-#---#---#--------#-#------------------###---------#--#-#-#----##--#-----#-#-#----##--#--
-#-----#-#--#----##--#---#-#-#------#-#--#---#####-##-#---#-##-#-#---------------##-##-#----#----#--
-####-##-#------#-----#-----#-##-##---#---#-#-#--#---#-##---#----#-#-----##-------#-#--------#-#--#-
#-#--#--------#-#-#------#-------##-#---#--##---#----##-#-#-##----#----#---#----###---#------#-#----
----#--#-----#-#-----#-#---#------#----##---##-------##------#-#-##--#-----#---#-#-----#-#--####----
-----#--#------##------##---#---###----#------###--##-#-#--#---#-#---#-#--------###----#-#----#-#---
-##------#------#-#-##--##-#-#-------#S------##-#---#-#----#-#------#---##-#-####---#---#-#----#----
#--#-----##-------#----#-----##--##-#-#-----#--------#---#---------#-#-------##---#------#-##---#-#-
###--#----#--##---##---------#-#--------#---##----###---#--#-######-##---#---#-----------#--###-#---
--------#-#--##----------#-------##--#--#-##-#-----#--#-------#-#-#---#-##--#-#-##-##---#-----#--#-#
-#-#---##--#-----------#-#--------##------##--#-#----#------#-----------###---#-#-#-##--##-----##---
-#----##-#-#--#-----#--#-#----##--#--#----#-----#--#-------##-##-##-#-#--#-##-----##--##----------##
---#----#-----#-----##-------#----#---------#------#--#-----------------------#----##--------##-----
-----------#-##-###-#---#--------##-------#---#--------#----------#------------#----------#---#-###-
--#-#--#------#--#-----#-----#-#-#-#--#-###---###-##--#--#-##-----##---#--#---##--#----#--------#--#
--#--#----#----#---#-##-#-----#--#-#-##-##----#-----#----#--#-#--#-#---#-#--#-----##-#--#-#----#-###
-#--#-#-#-----#-###--##---#------#---------##-##---#--##--###---#-#---#--##---#----##--#--#-----#---
####---#-#-#-#---#--####---#-#-#--##----#---###-#-##----###--#---#-##------#--#----#-#---------#----
--#---###-#-------#--##--##-------#---#-##-#--#---#-----#---#------#--#--###--##-#-#---#------------
---------#-#---#-#----#-##---#-----#-##---#---#--#-----------###---###--#-#-#----#------#####---#--#
#----###-#-#-#-###----#-#--#--#--#---#-##-------##------#-#------#--#-#-#----#-#-----####-#--#------
#####-#---######-----##-----------#----#----#----#-----#----#--#------#-#--#-------#-#--#---#---#-#-
---#-#--###-----#-----#-##----####----#-#-####-#----##-------#--#-##-##-----#--#-#-#--#-----#-#-----
---##-#------#-#----##---##-##--------#---#--#---#---#-----------#-#---#----#--#--##-#-#-#---##--#--
--#----#--#----#-----#--###------#-------##-----#-#----#--------###----------#-###-#-------##-##-#--
------##--###----#--#-#--###---------#------##-#----####-----#-#-##--##----##--#-##-#--#-#--#----##-
##--#--##-##--#-----#--#-#--#-#-#######--##---------##--#-####-----##--#--##------#---#--------#-#--
-----#-##----#--#-#---##-----##--#-#----#-##---#----#-#----###--##---#---##--##-###----#--#-###-#---
---#-----##--#---#---#---#-#---#-##------#------#--------------#--------------#---#-######-#-#--#-##
----#----#---#--#-#-------------###--#---##-##-##--#---#--##--#-##--#------#-----#----#-------###---
-#-#------##---#---#-----#-#---##--#-#------##---#--#-----###-#------##-##-#--#--------##---#-##-#--
#--#------------#----#--#--#----------#--#-##-----#--------#-#---##-#----#-#----#---##---#--#--##--#
-#-#--#-#----#---#---##-#--#-------#-#-####-##--#--##-#-##---#--##-----######--##--#-----###--------
#---------#---------#---#----#----#-----###---#----------------#---#-#-##-----#-------#--#---##-#-#-
#------######-#----#-#-#----------###-#----#--------##--#-###-#----#--------#-------#-#------#--##--
#---------#-#---#---#####--#-------#-------##--#-#-#----#-#------#----------#---#-#--#-#-----------#
#---###--#---------###-#-#--#-------#----------##-#-#--#--#-#----##--#-#-###-#-------#--#---#----#-#
--##-##--####-#----#-#------#-##-##-----#-----#---###----#-#--#-###---###--##---#--#--#-##----------
------##--#----#-------#-##------#--#-##-#------#---#-#---#---##-#-----#---#--#-#-##---###---#---#-#
