--#--#-#-##---##------#---------#-#---##-#---#------#--###--#--##-#-#-------#----##--#---##-#--#----
--#-#-------##---#-#-------#--##---##----##--#--#------#-#-#--------------------#-#-----#--#-##-----
#----------#-----##-----##-------##----#------#-------#-##---#-----#-#-#---##---#-###---##-----#----
-####-##-------#-##--#---#----------#-##---#-#-----##---#---#--------#-#-#--#--#----#-#--##----#----
-#-##-------##-##-----#--#-#-#------#--#-#-##-------#-##-----------#-#-------###----#--------###--#-
-###--##----#-----#---#-#----#-#-#--------#---#-------#----##-#-#-----##-#-#------#--#---#--####----
--##---##-##----#-#---#--------#--#-#-------##-------------#---------#-#--#-----#----##-#---#-----#-
--##---#--###-#---#----------#-#---##-#---#####---#-------#----#---#-##---#-#--##------##-------##--
-##---#---#------#---##-#----#--#---------#-#--##--#-##-------###----#-----#-#-------#-#-#--#-#-----
--#-----#--#-##-#------#--------#--#-##--##--##-##---#---------###--#--##-----------###---#---------
---#-----#--#----##--##----##--#---##-##--##-----#-----#---#--------###--###----##--####---#-#------
-#---#-------------------------#-##-#----##--------#-###-----##-#-#-#-#--#----#-#--#--####---#-#----
----##--#-----#----#------#---##--#-------#-------#----#--------####---#-##-#-#----#-----##-#-##--##
-#--#--##--#-#---#----##--#--#-#-#----#---#-------##-#--#---#-#--#--##-#-#---#----##-----#-------###
#-----------#---------------#----#---------#-##----------#-##--#--##--###-##--#-#-#--#---#---#-#-#--
-----#---#-#--#------#----##--#-#------#------#----#------#------#----##-#--###--####-##------##-##-
##-#----------##-----------------##---#---------#-###------###-##-#---#------------------#----------
----#-#------#------##-##----#---------#--#-###----##-#----#------####----#----#---#---###---#----##
------#-----##-----#--#---------###-#---#-###---#----#---##---#--#------#--#-#---#--##------#----#-#
-#-#-##-----#----#-------#--##-------#-##---##-#-###-----##--#--####---###---#----------#----------#
----#-----------##--#---------#---------##--#---#---#-----#---#--#---#-----#-----------#-------#----
--#-----##---#-##--#----##---##-###-##--#--#--#--#####-##--#---------#--#--####--#--###-##-#-------#
-----###--#####-###-##-#--####--###-#-####--#-#---#-#-#------#-------#-#----------#-##-#---###-#--#-
####-----#------###--##---#------##--#-#----##---------#-#--##--#----#-----#---#-###-----#--#-----#-
-----##-#--#------##--------##-------#---#---#--#-----###--#-----#-#------#--##-----------#-#--##---
-##---#-#-----#-#-#--#----#---#---#---#---#--#----#-#-----#---#--#-------###---#-#-#---#---#-#----#-
#--------------##-#-#--###-#--------##----###--##----#---##---------##---##---##---------#---##---#-
-#-----#--###-----#------#--####----###------#---------------#----##--#------###--#-------#--#---#--
-#-#-#----#--#-#------#--##------------###-##--#--#------#--#---#--------##--##-#-#----#--#-###-----
-#-----#-#--#----#-#----#---#-----##-#-#-------#-#-#-------##--##-----#---#-----#-#---#-#--#-------#
------#-----#-#-##--##---##----###-#---------#####---#----##-#-#---#----#-----#-#---#------------#--
#-#-------#--##--#-------#-----##------#-##-#----#--------###----##----#---------#--------#----##-#-
----##-###-##-#----###-------#--#---###--#-##---##-##-#-#--##--#-##-###---#-#--#------#-------------
-----#-------#-#------##---#--#---------##--------------#------#--#-##-##-#-##---#--#---#---#----#-#
----#---#--##----#--#-#----##---#---#---#-#----#--#####-----##---###-------#-#--#-#-----#-#-#--#----
-##---##-#-#------#---##--##--#-----#-#-#-#---#--###-##-----#--##--------##-#-#-##-------###-#----#-
-##----#------#----##----#---##------#-----#---#---#---------##-----#----##-#----###-----------##--#
-#---#-####-###-#------#--#--#------#----#------###-#-#----------#------##-#-#--#----#--#-#----#-#--
-#----------#----#----###---#-#-###---#--#---#--#---#--#------#------#-##-##-#----##--#-#---#-------
------#--#--#-------#---#-------#--#--##-#----S----##---#-#--#--#-##--#---#---#---#---#--#--#-#---##
---#----##-----#--#--#----#-#--------####----###----#-#---###---#---------###--#--###---#---#--#-#-#
--###-----#---##-----##--##-##-----#-#----#---#------####--##-##----#--#-##--#-#--#--##--------#----
----#---#---#####----######---#-#-------#-------#-##--##---###-###----###---##----#-#---------------
#-##------#-#--#-#------#--##----------###--#----#-#--#---------#-----#-##--#---#-----#---#-#---#---
-##-----#-#--#-###--#-----#--#-----#--##-#---##---###----###----###-#--####--------#----#---#--#---#
-#----#---#---#----##--#-#---##---##------------#-#-#---#-#----##--#-###---##----------#----##-#---#
---#--#----#-#---------###---------#------##---##-------#---#--##----#-#---#-#----#--##---#-#-#-#---
#--#-#-#---#--------##--#-#---#--##---##--#-#-------#--#---#-##---#-#------#-----###--##-------##---
--#-----------#-#-------#--------#-------------------###--##-------##-#------###-###-#-#-#--####-#--
#---#---#------#-----------#-##--#-###--#---#----##--#---#---#--#-#---####---##-#-#-#----#--###-#---
###-----#---#----#-#----#----##--#-###----#----#---#-#--##----##----#----##-----#----##-#-##---##---
#--#-----####-#---#------#--#-----#-----#---##-----#---####-#--#-----###-#---#------#---------#--##-
------####-#--#-#---------#-----#-#---#-#----##--#------##--#--#---#----#---#---------#--##--##---#-
-#-#--##--#-#-#------#----#---#-##-#-#-#--##--#-#-----#-#----#-#-#---#----#--##--#-----#-#-###------
---##---#-----##--#-----#--##---##----#-#--#-###----#---------#--#--#--#--#-----#-------##----#---#-
##---#---#####-----------#-##-##-#-#-#---#-##--#-#-#-----#---#-#----#------#---------##----#------##
----#---#-#----#--#----#------###-###-#--#-####--#-------#--------------##----------##--#-##-#-#--#-
-##--####---#--#---#-#-----#---##--##-#----#-#----------#------#----------#------------#---###------
--#####--##-#--#----####----##--#-#--#-#----###-#-##-#---------------#----#----#-------##---#----#--
-#-##----#-##-------#------------#--##-###-#-#--#--#--------#----------###-#--#-#--#-------#-##--###
#----#-----#-#--#------#--#-------#--##-#--------#-##-----#-##--#-#--------#--#-------#-##----#-#---
#------#-###----#-----#-#----#-#--#-#-#-#-----#--##----##-#---##--#---##-----#--###---#--##--###--#-
-----#---#---#-#-#--#-###---#---#--##-----#-----------##---###-----------###----#---#-E-#--------#--
-####---##---#--##----#-#-#---###-#-#--#-#-##---####---#-----#-#-------##-------##-###---#-#--##----
#-#--#--#------#-----##--#-#---#--#--##----#-##------#----#-#--------##-#-#-#-#------#--#--###------
-#------------#-#------#---#-#---#-------#-#-#-#---#---#--##----##-------##-#---##--#---------#-----
---#-#--###--------#--###-----####---#-#--#---#-##------#-#-----#--------#---#-#---##---------------
####--#-#---#---#-#-#--##------#--#-#-----##--#-##-------#---#------#---#----#-------#-#--##---#----
----##------##--------#--#-##-#---#------##---###---##----#---#--#----##-####-#-#--#--##-----####---
--#--#----###-#--##------#-#-#-##--#-#-#-#-##----#--###---##-#----#--#-----#---#--#---#--##------#--
#----#--#-#--#--#----#----#-----#-##-#-#-##--#-#-#-#----##--#---##-##--#----###-#-##-------##-#-#---
---------#----##--#-#--#-#--#-----#--##-#----------#----##---#--##----------#--#--#--------###-#----
----#---##-----#-#---#---###--##-#----#-----#--#--#---#----------#--#--#-#--#--######------##---##--
#-----#-##---#-----------##--#--##--##-#----##----#-------###---##--#-#--#----------#--#---###-###--
--#-#-#---#------###-----#----#---#----####--#-#---#-#-#-##------#-#--#-#-------#--##----#--###-#---
##--#--#--#####--------#-#-#----##-#---#-##--#--#---##--##---####--#-##---#-----#--#-#-#----#-#--#-#
--#--#-#-------------#---#---#-##---##-##------#-##-#---#--#-------#-#--#----##----#-----#--#-#-#-#-
------#-#-#----#----#----#--#-##--###-#-#--#-------#--#-----#--##---#-#--##----#--##--------###-#-#-
---#-#------------#-#---##----#-##--#-#----##--#--###--#--##----####---#---###-#-#--##-##--#--###-#-
---#-----#-#-#--###---------#---##-#---#-#------##-----#----#-------#--#--#----##------#----------#-
----#-##-----##---------#-----#-#--#-##----#---#------##-#------#---#-#--###---#-##--------#-##--#-#
##-#-##-##----#--#---#--#------------#------##-#-------###-#--#-----##-#-#--#--------#---##-#---#-##
--#####---------#-#-----#--###-----------#-##--#----#------#---##--#----#----####-#-----#---#--#-#--
-----#---##---#-##-#-###--------#-----##-#-------------#----#------------#--#-###---#-#---#---#-#--#
----#-----------###-#-#------#-------#-##--#----#---##---##--#----#-----------#--##-#----#--#-##---#
----#----#--#-------###-#--##-#--#-####-----###-#-#---#------#-#----#--------#-#----#--#------#-#--#
-##--#-##-#-#-##-------#--#-#-#--##--##--####-#--#---#--#-##----#--#-#---##----#-##--##------#-#----
#-#--#--#-##--#----#-----#-----#-#---#-------###-#---------#---------#-----#-##-#----#--##---#------
---#-###-####-##-#-#-##---#-------#-#------#---#-------#-##-----#-##---#-#--#----#------##----------
-##------#--#-#-#--#-#------##--##---##-#--#-###-#-#-#-#--------#---------##-----#---------#--#####-
---#--#-#---#-#-----#-#-#---#-#---##------##-#---#-###--------##------#-------#-#--####-------------
-#---------##-------##------#--#-#----###-----#-----#-----###---#--#-----------##--#-----##--#------
##------##----##----#--#--###----------#--------#--##--#--#--------##-#####--#--#----##----#-#----#-
--#-#---#--#-#----###--------#----#--##-#-#-#--#-----#-#--#--#--#--##---#-#----#-----#--##--#--##---
-##----#-#---#-----#----#------#-##-#------##--------#-##---##---------------------------#---#-----#
-----------#-##------#---#---#-#-##-#----#--------#------#-##------#---##--#-------##---#------####-
#--------#------#--#-------------------#---##---###-#--##-##------##---#--#---#-#-#-#---------##----
----####----#---##--------#---------#--##----##-##---##---##--#-#--#----##--------##-----------#--##
-#-#-#--------##------#-##-----####--#-------#-#--##-----###---###-##----#---#--#--##----##--#--#---
-##-##-##-#----##-#--#-##--------#---#---#---------###--####---#-------#--##----##-----#----#-------
