##---#-#----##--##--#------#-#---#----#-#-#-###-#-#--#--#----###----#--#--------#---#--#------#-##--
-###----#----#---------#-#-#-##-------##--#-####--#---##---#---#-#----------#---####-##-#----#----#-
##--#----#--------#--#-###----#--#-#-##-#-##-----#--#-####-----#-###---#---------#--#-#--------#--#-
--#######--#---#---#---##-----#-----------#-#---#--#-------##--#-------###-##-#--#-#----#--#---#--#-
-#-#-#------##----###--#-----###--#--###--#---#--#-------#--###------##----#---------#---##-#------#
--#--#--------##-----#-----##---#--#----#--------###--------------#----------#--#----#-#-#-#---#---#
---###-#-###-#---------------###------------##-###-#-#--------##-###-##-------##-#-#----#--####----#
-#-#-#-----#--#---#-----#-##-----###---#-----#--#---#-#--####----------#---#-#----#-##-#------------
#--#--####---#--------#-#--#--###---#-#---#----##----###-#--#-#-#-------####---##-##-#-------#--#-#-
-#--#-----#-#--###----#--#-###-##-#-#--###----#----##------#--####-----#---#-----##-#------#-----#--
---#----#---##-----#--#----------#-----#-##---###--#-#--#---#-#-###---#---#-------##--##---#-------#
-#-##-#--#--#--#-----#-##--------#-#--#--###-#-#---#-##--#--##--#--#----####--#---###----##------##-
--#--#-----##--------#--##------##---#-##-##---#-##--#----------#--#--#-#-#---------##-----###----##
-#------##-----#----#--#-##-#-#--#------#----#-#-----#-#-#-##------##----#-#-------#----#--#--#---#-
-#--#----##-#----#----##-----#-##-#-#--#---#--#---#-##-----##-#-#---#--#-#-----#-#----#-#--#---#----
-###---##------#---#--####---------#-#------------##----##-#-------#-##-#---#-#---#----#-#-----#--##
--##-#-#-----#--------#-#-#----#--##-##--#-#---#--------###--#-#----------#-##---##----------------#
#--#--------##--------###-#-#------#----#-#--#-###-----#-##-#---#---#----------###-#-#-#-----------#
---###---#--------#-#----##-----###---------------#--#----#-###---##--######--------#-#---#-###-----
-#--------#-#----##--#--#----#---#---------#------------------#-#--##----#----------#---###-----#---
#-#-#-#--------#--#------#----#-#-#-#-##-##----##-#---#-#------###-#--##--------##----##----------#-
#-#--##-###-#-----#---###----#-#----------##----##-#--#--####----#--#--#-#---#-#----------##--------
---------#----#----#-----#--------###--#--------#--#----#--------##----##-------#-#---#---#----#---#
-#-#----#-----#-#-#-##----##-------#--#----##----#---#-#---###--#---#-#--#-------#-----------#-##---
----#----##-#-------##-###---####----#-##-##--#-------#------######-#---#---#------#----##--#-#-----
-#----#--#----#---#--#----#-------#--###-----------#-#----#--#----#----####----#-----------#-#------
---#-##--#-#--##-##-#-----#----##----#--#---------###---#-##-#-##-------#-#---##-#---#---#--#-#-----
--##---#-------##-##-#------#---##----#---------####--#-#--#-------------##-----------#-#---##-#----
-##--#---#----#--#----------------#-#---#--#--#-#----#-#-----#-#-#-#---#----#--##---##---##------#--
###----###-----#-----##-#-----##-#------##-----###-----#----#-##--#---#-#-#--#--##---#----#-##------
------#--#---##-#----#--#---#-#-##--##-##---#-###-#-----##------##---#----#----##----------###-#--#-
#---#---------#--#-----#-##-#-----#--###-----#-----#-##---###------#-#-####-##-------#---##-----#-#-
---##---#----#--#--#-----#-------#--#-#-#----#--------#---#--------#-----###--#-##-----##-#--#-#----
-----####---#-#-####--#-------#-----#-#-##------#-------##-#-----#------##-##-------#--#-#--#-------
##-#-------------#--##--#-------#----###---#-#-#---------#----##-----#---------##-----#-#----#----#-
---##--#--#--------------#--#-------------#-##-#-#---#-------#--#--##--#------#######---#---##---#-#
----#---##-#----##----###-#----#------#-#--###--#--##-#--##-##-#-#--#-#---#------#--#---###--#--#---
#-----##------#--###---#--#E#--##------#---###----##--##----#--#---#---#---#-#---#----------##--##-#
-#------#------#-------##---###------##-#----####-#-------#-#---#-##----#---###------------#--##----
-###-##------####--#--#-#-#---##----##--##---#----##---#------#--------##-#-#-----------#------#--#-
##---###-#---#-##--#----------#-#-#------##---#--#-#-----#-#---#-#---#-#----#-----##--#---#-##----#-
-##---#-##-#-#--#-##-----##--------#-------#-----##-#----#----------------##-#---#--###------##--###
##-------#-----#----#-#-#--#-##--##---###-###--#---#----##-#--#--#-##----#--##---#--#------##-#---#-
--#-#----#-####--#-#####----##------##-###---##----#--#-#--#-----------#--#-##--##-###---#-----#----
#-------------------###-----#--------#----#-##--#--------#---#---------#--###---------------#--#--#-
---#------------#-#-#---##---------#--#---#----#-----##-----###-#--#---##-#-##--##----##-----##-----
----------#----#-----###---------#-#--#-----------##-#----#--#----#---##-#----#-#--#------#-#---##--
#-#---#---#--#-###-#--#-#--###---#-##-##---##----#######-##-#---#--#-##--#-----------#---#-#-##--#--
--#-#---#----##--#--#---#-------#-#-#---##-----#-#-##---#-------#---###----------#---------#--#-----
---##----#----------#-#-------------#---#---#----##------#----#-----##----#----##-#-#-#-----##---#--
-###-#----#---#-------#----#-#-----#-#--#---#-------#-#------#--##------#---#---#--#------####------
-----#---#-----##----#--##-#-#--##--#--#----#-#-#---#----#-----#--###-#---##----##-##----#-----#---#
--###--------##--#-------#----#-----#---#-##----##--##--###----#--------#---#-#-#--#-#-----#--#-##--
--#-------#-#-##-#--#-------#--#-#----##-#---------##---##--#----##-##-----#--#-------##---#----##--
#---#---##----#-----#--#-#-----#--#------------#-------##-##-----#-##----#-#--#-#----#----#--#####--
-##--#---#------#-#-##---#------##-#-----##--#-#-#------#-#-#-#--##-#-------#-#--#---#---#-#-#-#--#-
--##-#----###-#--#-#--#------#----#---#----##---#--##-----##-#--#-#---------#-#------------------##-
#----##-#----------------#-#-#-#-#-----#---#-#--###---#--------#----##-------##--#--#---------#-----
#---##-----##------#---#---####-#------#-#-#-#-#-#----#-#-----#-----#-------#---###--##-##---###--#-
--##--#-#------##----#-------------##--#-#-#-----#--#----###-------#------###-#-----##--#--#--###---
-------#-#--#-#------#--#--#---##----#----###---####--##--#-#-###--##----#---#---------###-#--##-#--
#---#----#------------#-###-#----#---#-#-###------#--#--#--##---#--##---#-#-#-#-#-####--##--#-#-----
#-###--#---##-##-#------#-#-###--#----#--#-#---#--#--##----##-##-#-----##---#--------#--#-#-#----#-#
-#------#-#-#-#-#--#-#--------#--#---##--##--#--#--------#----##------#---#----#-#---#--#----#------
#-#--####----#-##----#--------##-#---####----------##---#-#-----#------#---------#-#--#---#---##-#-#
-------#-#--##---#-------#----#---###--#--###-##--#-#--##-#-----#-#---------#-#---#--#-#-----#--###-
#---#---#------#----####--#-###--#---#---#--##-######-------##--#-#--------#--##---##--#---#--##----
---#-#-#-----#-##---#----#---##-------#-#-#--#-----#-#--#---##-#-----##------##-#--#-----------#----
--#--#-#---#-----#--####--------------#----##--#--#--------#-------#---##-#--#------#-#-#---#-#-----
--##-----###-----##--##--#-#--#----#---####-#---#--##--#-#---###--##---##--##-------#--#---#-#----#-
-##-#-#---#-##-----##-#----##---##-#-##---#--#-#--#--#-#-##--#----#-#-----#------#--##---######--#-#
#-#-----------#--#---#-----------------#----#--#---##--#------##-----#-#--------#--##-#----#--------
-##-#------#---#-#--#--##-##-#--#-#-###---#---#----###-#----#--######-##----#-#---#---##-----#---##-
---##----#--------#---#--#--------#-#----#--#--#--#-------#---#---##-#----#-----##--##---#-------##-
-#-----------#------#-#----#--#---#----#------##-#--#-#--#---#-##----#----#-#----##----#--#---#--#-#
--#-##-#--##-#------#----#------#-#-#-#-##---#------#------####-#---#-#---#--#--#----------#------#-
------------###----#-----------#------##-#-#----#------#-----#----##--###---#-#--#--#-----#-#---####
-#----#--###------#-#--#---#----#---#-##-#-------------#----#---##--#-----------###-#-#-#------#----
-###----#------#--------#--#--#----#-#----#-#---##---#--###------#-----###-----#--#--##-#------#-#-#
-#--#-----#-##--##--#------#---#----#----#----####-#------#--#---#-----##--#--#----####--###-#-##--#
----------#-###-#-#-----#----###---#--#---#---#--#-####--#----#--#--#------#-#-----#--#--#-##--#----
-#--#--##---##----#--------##-#--##----#-----#-----###---##--###---#-##-#------#---------#-#--------
#-----#--#-----##--#-#----#-##---##------#####---#-----##-#-#---#-#---#-#-##-#------#-##--------#-#-
#-------#----#--#---------#---#-#-##------#------------###-#-#--#----#--#-#--#-#------#-##----##--#-
-----#--#--##-#------#--##------#-------#--###-----#-##-#-----#------#-#--#-----#--###-#----##---##-
--##-#---#---#---#---###-#----#------#-------#---#--#--#-#-#--------#-#-----##--#----#----#----#--#-
-------###--##--#--##-#--------#--#--#-#-#----#-----#--#------#-#-----####----#--###-##-#--##--#---#
---###--------#--#--#-----#-#----#--------##-------#-----#-#--#-#-#S--#####-#-#--#-----#----#-------
------#---##--##--###--------------#-------##-----###-----#-#----#-#-#----#-------#--#----#--#-###--
#----#-------#----------##--##-#---------#--#--#-#----#----#-#-##----------##------#-#----#-##------
-------#-#--#--#-##---------#---------#----##-#------------#-#--------#-##-------##-------#-#----#-#
#-###--#-#-##-#-#-#--#-------#------#-##-----#--#-----###-----------#--##--#--#---#--#---#-#--####-#
--#--####---#---##--#-###-#-#-----#-#-#--###-----#--#-#----#-#----#-----#-#-#--#-----------###------
##----##--#-----#-#-####------#-------##--##--------#-#-------------#----#--##--------#-------#--##-
###------#--#-------##---#-####---#-#-###-#---##---#-###---#-#--#---#---#---#--###--#----##--#-#----
-###--#--##--#----#-#--##--##--#-------#-----##--------#-##-#--#----#----##------#---##---------#--#
#---##---#--#-#--------##--------#-#-----##-#-#-----#-------#-----#-##-#--------##---#-#--##-----###
#--###-#---#-----#-#-#-#--#-#----#---#---##----#-------#---#-#---#--#-------#-#-------#------#------
---#-#-###---#-#---#---#-#--#----------##-----#-----#--#-------#----###------#-----#---#-#-#--##---#
-----#-#---#--####--#---#-####--##-##---#-##-----------#-#-----###-----##-----------#-####-##-------
