-####--#--------##----#-#----###-#----#----#--#-#--#-#---###-----#---#----#--------##--##----##---#-
------#------#-####--##-#--#-##--#--##-----#------#--#----#--#-#-------##-------#---------#--#-#--##
---#-#-##---##------#---#--##-#-#--#-#--#----#-#--#-----##--#-##------##-#------###--------#----#-#-
---#-#-----#------#-#-----#--#--###--#--##-#-----#---#--#--#--#----##-----#--##---###---#-#----##-##
-###-##------##-------------#--E###-----#-#-##--#-#-##-#------#----#--#-----####--#------#-###----#-
---#-#-#----#--#-#----------#--#----##-------#-#-#--#--#-----------##------------#-#--------#-----##
-----##--##-#--------------##---#--####---#-#--#---###--##---------##--#----#--#--#------#--------#-
---#-#--##--##-#-#---#------#---------##-#-#--#--#---#--#-###----#----##-#-#---##-#-----#---##-##---
#---#-----------#-#----#-###---#-####--##-#--#-----#--###---#-#---#-------#-##-##-#-##--------#-##--
#----#-#-#------#----##-##-#--##-----#--#--##--------------#--#-#---##--#----#---------##--#-#--##--
#-----###-###-#-###--##---#---#---#-#--##---##-##----#--#-------##-##--#-#-#-#---#--#-#-#-#-----#--#
#-----#--#------#---##--##-#-#------------#-#---#---###--#---#-----#----#-#---#-##------#---##-#--#-
---#-#-#--------------#-#-------#---#-#--#-----##-----#--#--#------#--###--##---#---##-------#-#----
#-#-#--#--#-###-##-##-----#--#-#-##-#----#---------#--#--##---#-##---##--###---##-##-##--##----#----
----------#--#--#-#--##---##--#-#--##-----#-#-#-----------#---#----#---#------#-----#---##----#----#
---#--##--##-##-#--##-----#-#--#---#----#---#-------------#--#----#-----------##---##----#-#------#-
--#------###-----##---#--##----##--#-----------#-#-##---#-#-#-#--------#---##-#----#-#-###----#-#---
---#--#--#-#----###-##----#-#------------#---###--#----#-#--#----#-----####--#-#-##-----####----#--#
----##--#-----#----------##----##-#--#----#-#-----#-#---#-#--#------#-#-#-----#------#---#-#---##-#-
#-#--##-----#--##----#------###--##----#--#--#-----####---#---#-#--##------##-----#-#----#--##---#-#
-#--#--#--##---#-#--#----#----------##---#-#--##----#-####-----##-#-#---###----##--------#-##--#----
##--#-#-##-#---#-#----#-#-#-#---#--#-#------#--#--#------------#-------------##------#--###-##------
-##-#-##-#----#----#----#-#-#-------#--#---------#---#----#-#--##---#-#-#------##-------##-#--------
-----###-#-####--------##----#-------#-#-#-#----#--#---------##---##----#-----###-#------##---------
#-#-#---###-----------#--#-###-#-#-##----#-#--#----##--#-##--#--###-#--#--####---####-#---#-##--#---
------##---##-#---##-----#-------#--#---#------------#-------###-##-#--#-#---#--#-------#----##-----
--##----------##-#----#--#-------#--#---#-#--#-#-##------#----##-#---------#-----#--##-#-#--#--#---#
#---#--#-#----------###--##---####-###-#---------##--#-#--##-----#--###-###----------#--#------#---#
---#-##-#-#------#-#--#-##------#--##--#--##-#----#-#----#-------#-#---------------#----#---##---###
---#-###----#--#--##-----------------#-##-###-##-------#------##-##-##-#-#-##----#-##-##---#----##--
-######---#-#----#-------#----#-----###--#---#---##--#-#-#-##--##--#-#---##-##-#---#-----#-#-#--#---
#-#--------#--##----#-#---##--##--#-#-------#--#---#----####---#-#-#-#---##----##--###----##-#------
-----------#--------##--#-------#------##-----------#---##--#--#---------#-#--#--#-----#--#---------
##----#-##-#-#--------##--#-##-#---##---##-#-#------------##-##-#--------###-----#-----------#---#--
#-#-----###------##----#--#-------###-##-#-------#-#-#----##---#---##---##--##-----##--#-#----#--#-#
-#-#--#-#-####----#----##--#-###--###--#---#---#--##-#-#--#----#-----#-----##-----#--#---------#--#-
#---###---#--#----##----#-#-#---#-#----###--#-------#----#--------#--#----#--#--##---##--#-#----#--#
--#---------#--#-----#--#--##-##-##---#--##--#------#-#--#--##---#-#----###---#----#-#-#--#-----###-
###--#-#-###----#-####---#--###-#-##-----#---#-#---#---#--#-----#----------#----#--####----#----##--
--#-#---------#--#--###-#------##--#---------#-#----------#-#----#--#-#-#---##-----#-##---#-###-#-##
-----------#-#--#--#--#-##----####-#--##-#-#-------#-----#-#-#-##---#----#--##--#---#--#--#-#----#--
-----##-#-#----------#---------#-------#---###---#-#--#-#---#--#--##-#--#--#---#-#-#--###-#---#--###
-#---#-#----##----#-##-##----#-#---#------#---------#----------#-#--#---#-#---#---------#--------###
#-#---##--#------#-##--##-#-#-#--------#-#-----#----#------##-#-##--#-#-------------#-----#-#-##-##-
##-----#----------------#-#-####----#--##----------###-#---###-#----#----------#--####-#---#------#-
#--###-#-#--##------------#-------##----#--###---#-----#---##---#-------------#--#------#---#--##-##
--#---#--#----#-----#-----###---#-#--#-#-#####---#-#--#---#-#--#--#---------#---#-----------#-#-##--
##-----#--#------#----#---#--#-##-------#--#--#-----##--##---###--#--#---##----##-----##--#---#---#-
-#-#----#---##-------------#-#-#-##-#-#---------#--#---##-##-##--#-#--##---##---#-------#-----#---##
-##-###----#--------------#----------#--#-###---------#------##-##--###---#---####-#-###---#------#-
-------#-------#-####-------------#-#-###-------#----#-##-#---#----#--------#----##----#--#-##-##---
#-#--###--#-----#------#------##--##----#--#-##--##-----#--#-#------------#--------##-#--#---#---##-
##-#---------#-#-#######---#---------#---#-----###----------#--#--#--#--#----#--------------###---#-
-------#-----#-#----#-----#-##-#-----#-----####--##--#------#----##---#-----#-##--##---#----####-#--
--#--##--------#--#-###---###------##------#-##----##-#----##-----#-----#---##--##-#-------##--#-#--
-----#----##-----##----------------#----------##-#--#---#-#---#------###-----##--####--------#-#-#--
-------#-#-----#---#-----#----#--#--#-----##------#---#-----#---###--##----#-----#------#--####---#-
-------##---#--##-##---##-#---#-----#-#-#-##-#--------#---#--------###---#--#-------------##-----#--
-#------#-#-##------#-#-----###-#---#----#----##----#----#---#####-#---#-#-#--##---#######-#----##--
--##--##---#----#------###--#---#----#-#---#--##-#--#---##-##-----#---#-##-----##-#----#---#--#----#
-#----#-#--##-#-###---##-----#----------#-#------#---###-##-#---#--##--------#-------##--------#-###
-#--#------##----#-#----#------#-##-----##--#-##----------##--#--#-##-----------#--#-#-#---###----#-
-#--##---###-#----------##-#-#--#----##---#-#--####---#-#--#------#-#-----#-##---#--#-----#-----####
---#--#---#---#---#----#-----#-------#---#---##---#-----#-------##---#--##---#-##-----#-##-#-------#
---###-#-----#--##---#--------#---S#---#-----##--#-##---#-#----##-#-##--#---#--#------#-#--##-##---#
-####--------#---#----#----#---#----##-#----#--------#---##-------------#------------##-#---##------
--#--####------#-#-----#-#--#----##----##-------##------------#------#--#-#--##--#---##--#--##--###-
#--#-##----###--#-#---#-##-##--#-#-----#-##----#--#--#--##-#-##----#--#---------#----##-##-#-----#-#
--#--#--#-#---#--##---#---#--#-------------#-##--#---#--------------#---##--#####---------#-------#-
##-#--#--##----#-#--#---#------#---###---#--#---------------#-#-#-#-#---#-####----###---#--#-##---##
--##-----------#--##----#-#--##--#------#--#---###------#---#--#------###----####---###--#--#------#
--##-------#----#------#-###--#------------###-------#--#---#---#-####-#-#--##-----##--#-------#----
---#---#-#----##-#---##--##-------------#---#-##------###------#-------#-#------#----#-------##----#
--#-#---------#-------#----##---#--#--------##-#-###--------------#-#--##-#----------##--##----#-##-
-----##----##--#-##-----#--#-#----#--#---##--##-#-#-#-##-#------#----##------#-#--##-#-#---------#--
#-#--#---#-------#-####-##--------------#---#----#--#------#--#-##--#-#------#---#-#---##----##-----
#-#---------#-###----#--#------##--###-----#---#---#----#---#------#-#------#--#-#-#---#----#---#--#
--------#--#--#---#-#-#-------#------#-#---#-----------##---#--##---#-#--###---#--####--#---#-#-#--#
-----------#-#----##--#-#-----##-#-##----#----#-------#-----#-#-#-#-#---------#-#####-##--####--##--
--#--#------##-#---------#------#-#-###-#-#--##--#--#------##-------------##--#---#---#-----#-#-----
-#--#-------------##----------#----#-----#-------####---#-###-#----#-----#-#----#-#--##-#--#-#####--
---#--------##------##-#-#-##-###--#--------#--#---#--#---##-----#-#--#-----#-#-#---------#--#----#-
#-##-----#----#-----#--###----#-##------#--------###------#-#---#-----#---#-----##-#----#---##----#-
-###-------####--##-#------#--##--#--##------#---------#--##-##-------#--#-#---------#---#-#-#--##--
-#-#--#----#-##---######--#----#-#--#-------#--#--#--#-#----##-----##-----#----#-##---#------#------
---#-#--#-#-#-#--#---#----####-#--------#---#-#-------###-##------#-----------#---#--#---#--##--#-##
---#---##-------------##-#--##-#-#-#----##----#---#------#-##----------##--#--#--------#------#--#-#
--#--#----##-##------#-----#--#--#----##----#-----#------#-##-##----###---#-#-#---------#-#---------
--#-------#--#-------##-##-#--##-#--------#-#------###--##--#-------#---#----------#-------#--###---
------#-------##-#---#--------#--#-------#---#------#----#-----------#----#---#-#---#-----#-------#-
-#-#-----##-#---##---#-----#----##--###----#---##----#-#--#-#---##---#---#-#------#-------#-#-#-#---
--##-----#----#-----#-------#-----#-#--#----#----##--#------###-#----#-----#-#---#-----------#-----#
--#--##--#---##----##--##----#-----###-------#--##--#-##----#-#------#-#------##-----##-#--#--#-#---
--------##----#--#-#--#--#--##---#----##---#--#-###-----#----#-----###---#---------#--------##--#--#
##-#-##-#-#--####---#----#--#-----#----#----#---#-------#-----#--##---------#----#-#-#--#--###-#--#-
---###---##---##--#---#--#---#-------#-#---##------#-----#-------#-----#----#--#--#-------------#---
------#-#---#-----#-#------#-----##----#-#-----#--##--#-##-----##--#------#-#-----#--#-----##-###--#
-##----##-#-##-#--------#-#-----#--#----#-----#---##--#-#-###-----###-##-##--------#------##--##----
##----###------------#-##-#-##----#-#-#-#-----##--##----#-##--#---------#--------#-#--#-#-#--#-#-#--
---#--#--#---#-------##--------#-#------#---##---#-#---#-##---###-------##-##-##-#-#-#---------#----
