#-------#-#-------#-#-------#-#-------#-#-------#-#-------#-#-------#-#-------#-#-------#-#-------#-
----#---##----#---##----#---##----#---##----#---##----#---##----#---##----#---##----#---##----#---##
-----#-##------#-##------#-##------#-##------#-##------#-##------#-##------#-##------#-##------#-##-
#---#-----#---#-----#---#-----#---#-----#---#-----#---#-----#---#-----#---#-----#---#-----#---#-----
#-#-------#-#-------#-#-------#-#-------#-#-------#-#-------#-#-------#-#-------#-#-------#-#-------
-----#####-----#####-----#####-----#####-----#####-----#####-----#####-----#####-----#####-----#####
#-----#--##-----#--##-----#--##-----#--##-----#--##-----#--##-----#--##-----#--##-----#--##-----#--#
----#--#------#--#------#--#------#--#------#--#------#--#------#--#------#--#------#--#------#--#--
----#--#------#--#------#--#------#--#------#--#------#--#------#--#------#--#------#--#------#--#--
----------------------------------------------------------------------------------------------------
#-------#-#-------#-#-------#-#-------#-#-------#-#-------#-#-------#-#-------#-#-------#-#-------#-
----#---##----#---##----#---##----#---##----#---##----#---##----#---##----#---##----#---##----#---##
-----#-##------#-##------#-##------#-##------#-##------#-##------#-##------#-##------#-##------#-##-
#---#-----#---#-----#---#-----#---#-----#---#-----#---#-----#---#-----#---#-----#---#-----#---#-----
#-#-------#-#-------#-#-------#-#-------#-#-------#-#-------#-#-------#-#-------#-#-------#-#-------
-----#####-----#####-----#####-----#####-----#####-----#####-----#####-----#####-----#####-----#####
#-----#--##-----#--##-----#--##-----#--##-----#--##-----#--##-----#--##-----#--##-----#--##-----#--#
----#--#------#--#------#--#------#--#------#--#------#--#------#--#------#--#------#--#------#--#--
----#--#------#--#------#--#------#--#------#--#------#--#------#--#------#--#------#--#------#--#--
----------------------------------------------------------------------------------------------------
#-------#-#-------#-#-------#-#-------#-#-------#-#-------#-#-------#-#-------#-#-------#-#-------#-
----#---##----#---##----#---##----#---##----#---##----#---##----#---##----#---##----#---##----#---##
-----#-##------#-##------#-##------#-##------#-##------#-##------#-##------#-##------#-##------#-##-
#---#-----#---#-----#---#-----#---#-----#---#-----#---#-----#---#-----#---#-----#---#-----#---#-----
#-#-------#-#-------#-#-------#-#-------#-#-------#-#-------#-#-------#-#-------#-#-------#-#-------
-----#####-----#####-----#####-----#####-----#####-----#####-----#####-----#####-----#####-----#####
#-----#--##-----#--##-----#--##-----#--##-----#--##-----#--##-----#--##-----#--##-----#--##-----#--#
----#--#------#--#------#--#------#--#------#--#------#--#------#--#------#--#------#--#------#--#--
----#--#------#--#------#--#------#--#------#--#------#--#------#--#------#--#------#--#------#--#--
----------------------------------------------------------------------------------------------------
#-------#-#-------#-#-------#-#-------#-#-------#-#-------#-#-------#-#-------#-#-------#-#-------#-
----#---##----#---##----#---##----#---##----#---##----#---##----#---##----#---##----#---##----#---##
-----#-##------#-##------#-##------#-##------#-##------#-##------#-##------#-##------#-##------#-##-
#---#-----#---#-----#---#-----#---#-----#---#-----#---#-----#---#-----#---#-----#---#-----#---#-----
#-#-------#-#-------#-#-------#-#-------#-#-------#-#-------#-#-------#-#-------#-#-------#-#-------
-----#####-----#####-----#####-----#####-----#####-----#####-----#####-----#####-----#####-----#####
#-----#--##-----#--##-----#--##-----#--##-----#--##-----#--##-----#--##-----#--##-----#--##-----#--#
----#--#------#--#------#--#------#--#------#--#------#--#------#--#------#--#------#--#------#--#--
----#--#------#--#------#--#------#--#------#--#------#--#------#--#------#--#------#--#------#--#--
----------------------------------------------------------------------------------------------------
#-------#-#-------#-#-------#-#-------#-#-------#-#-------#-#-------#-#-------#-#-------#-#-------#-
----#---##----#---##----#---##----#---##----#---##----#---##----#---##----#---##----#---##----#---##
-----#-##------#-##------#-##------#-##------#-##------#-##------#-##------#-##------#-##------#-##-
#---#-----#---#-----#---#-----#---#-----#---#-----#---#-----#---#-----#---#-----#---#-----#---#-----
#-#-------#-#-------#-#-------#-#-------#-#-------#-#-------#-#-------#-#-------#-#-------#-#-------
-----#####-----#####-----#####-----#####-----#####-----#####-----#####-----#####-----#####-----#####
#-----#--##-----#--##-----#--##-----#--##-----#--##-----#--##-----#--##-----#--##-----#--##-----#--#
----#--#------#--#------#--#------#--#------#--#------#--#------#--#------#--#------#--#------#--#--
----#--#------#--#------#--#------#--#------#--#------#--#------#--#------#--#------#--#------#--#--
----------------------------------------------------------------------------------------------------
#-------#-#-------#-#-------#-#-------#-#-------#-#-------#-#-------#-#-------#-#-------#-#-------#-
----#---##----#---##----#---##----#---##----#---##----#---##----#---##----#---##----#---##----#---##
-----#-##------#-##------#-##------#-##------#-##------#-##------#-##------#-##------#-##------#-##-
#---#-----#--S#-----#---#-----#---#-----#---#-----#---#-----#---#-----#---#-----#---#-----#---#-----
#-#-------#-#-------#-#-------#-#-------#-#-------#-#-------#-#-------#-#-------#-#-------#-#-------
-----#####-----#####-----#####-----#####-----#####-----#####-----#####-----#####-----#####-----#####
#-----#--##-----#--##-----#--##-----#--##-----#--##-----#--##-----#--##-----#--##-----#--##-----#--#
----#--#------#--#------#--#------#--#------#--#------#--#------#--#------#--#------#--#------#--#--
----#--#------#--#------#--#------#--#------#--#------#--#------#--#------#--#------#--#------#--#--
----------------------------------------------------------------------------------------------------
#-------#-#-------#-#-------#-#-------#-#-------#-#-------#-#-------#-#-------#-#-------#-#-------#-
----#---##----#---##----#---##----#---##----#---##----#---##----#---##----#---##----#---##----#---##
-----#-##------#-##------#-##------#-##------#-##------#-##------#-##------#-##------#-##------#-##-
#---#-----#---#-----#---#-----#---#-----#---#-----#---#-----#---#-----#---#-----#---#-----#---#-----
#-#-------#-#-------#-#-------#-#-------#-#-------#-#-------#-#-------#-#-------#-#-------#-#-------
-----#####-----#####-----#####-----#####-----#####-----#####-----#####-----#####-----#####-----#####
#-----#--##-----#--##-----#--##-----#--##-----#--##-----#--##-----#--##-----#--##-----#--##-----#--#
----#--#------#--#------#--#------#--#------#--#------#--#------#--#------#--#------#--#------#--#--
----#--#------#--#------#--#------#--#------#--#------#--#------#--#------#--#------#--#------#--#--
----------------------------------------------------------------------------------------------------
#-------#-#-------#-#-------#-#-------#-#-------#-#-------#-#-------#-#-------#-#-------#-#-------#-
----#---##----#---##----#---##----#---##----#---##----#---##----#---##----#---##----#---##----#---##
-----#-##------#-##------#-##------#-##------#-##------#-##------#-##------#-##------#-##------#-##-
#---#-----#---#-----#---#-----#---#-----#---#-----#---#-----#---#-----#---#-----#---#-----#---#-----
#-#-------#-#-------#-#-------#-#-------#-#-------#-#-------#-#-------#-#-------#-#-------#-#-------
-----#####-----#####-----#####-----#####-----#####-----#####-----#####-----#####-----#####-----#####
#-----#--##-----#--##-----#--##-----#--##-----#--##-----#--##-----#--##-----#--##-----#--##-----#--#
----#--#------#--#------#--#------#--#------#--#------#--#------#--#------#--#------#--#------#--#--
----#--#------#--#------#--#------#--#------#--#------#--#------#--#------#--#------#--#------#--#--
----------------------------------------------------------------------------------------------------
#-------#-#-------#-#-------#-#-------#-#-------#-#-------#-#-------#-#-------#-#-------#-#-------#-
----#---##----#---##----#---##----#---##----#---##----#---##----#---##----#---##----#---##----#---##
-----#-##------#-##------#-##------#-##------#-##------#-##------#-##------#-##------#-##------#-##-
#---#-----#---#-----#---#-----#---#-----#---#-----#---#-----#---#-----#---#-----#---#-----#---#-----
#-#-------#-#-------#-#-------#-#-------#-#-------#-#-------#-#-------#-#-------#-#-------#-#-------
-----#####-----#####-----#####-----#####-----#####-----#####-----#####-----#####-----#####-----#####
#-----#--##-----#--##-----#--##-----#--##-----#--##-----#--##-----#--##-----#--##-----#--##-----#--#
----#--#------#--#------#--#------#--#------#--#------#--#------#--#------#--#------#--#------#--#--
----#--#------#--#------#--#------#--#------#--#------#--#------#--#------#--#------#--#------#--#--
----------------------------------------------------------------------------------------------------
#-------#-#-------#-#-------#-#-------#-#-------#-#-------#-#-------#-#-------#-#-------#-#-------#-
----#---##----#---##----#---##----#---##----#---##----#---##----#---##----#---##----#---##----#---##
-----#-##------#-##------#-##------#-##------#-##------#-##------#-##------#-##------#-##------#-##-
#---#-----#---#-----#---#-----#---#-----#---#-----#---#-----#---#-----#---#-----#---#-----#---#-----
#-#-------#-#-------#-#-------#-#-------#-#-------#-#-------#-#-------#-#-------#E#-------#-#-------
-----#####-----#####-----#####-----#####-----#####-----#####-----#####-----#####-----#####-----#####
#-----#--##-----#--##-----#--##-----#--##-----#--##-----#--##-----#--##-----#--##-----#--##-----#--#
----#--#------#--#------#--#------#--#------#--#------#--#------#--#------#--#------#--#------#--#--
----#--#------#--#------#--#------#--#------#--#------#--#------#--#------#--#------#--#------#--#--
----------------------------------------------------------------------------------------------------
