-------#---------#---------#---------#---------#---------#---------#---------#---------#---------#--
---------#---------#---------#---------#---------#---------#---------#---------#---------#---------#
----#-#--#----#-#--#----#-#--#----#-#--#----#-#--#----#-#--#----#-#--#----#-#--#----#-#--#----#-#--#
---#--#-#----#--#-#----#--#-#----#--#-#----#--#-#----#--#-#----#--#-#----#--#-#----#--#-#----#--#-#-
----###-##----###-##----###-##----###-##----###-##----###-##----###-##----###-##----###-##----###-##
-----#---#-----#---#-----#---#-----#---#-----#---#-----#---#-----#---#-----#---#-----#---#-----#---#
-#-----##--#-----##--#-----##--#-----##--#-----##--#-----##--#-----##--#-----##--#-----##--#-----##-
#--------##--------##--------##--------##--------##--------##--------##--------##--------##--------#
---##--#-----##--#-----##--#-----##--#-----##--#-----##--#-----##--#-----##--#-----##--#-----##--#--
--#-#-#--#--#-#-#--#--#-#-#--#--#-#-#--#--#-#-#--#--#-#-#--#--#-#-#--#--#-#-#--#--#-#-#--#--#-#-#--#
-------#---------#---------#---------#---------#---------#---------#---------#---------#---------#--
---------#---------#---------#---------#---------#---------#---------#---------#---------#---------#
----#-#--#----#-#--#----#-#--#----#-#--#----#-#--#----#-#--#----#-#--#----#-#--#----#-#--#----#-#--#
---#--#-#----#--#-#----#--#-#----#--#-#----#--#-#----#--#-#----#--#-#----#--#-#----#--#-#----#--#-#-
----###-##----###-##----###-##----###-##----###-##----###-##----###-##----###-##----###-##----###-##
-----#---#-----#---#-----#---#-----#---#-----#---#-----#---#-----#---#-----#---#-----#---#-----#---#
-#-----##--#-----##--#-----##--#-----##--#-----##--#-----##--#-----##--#-----##--#-----##--#-----##-
#--------##--------##--------##--------##--------##--------##--------##--------##--------##--------#
---##--#-----##--#-----##--#-----##--#-----##--#-----##--#-----##-S#-----##--#-----##--#-----##--#--
--#-#-#--#--#-#-#--#--#-#-#--#--#-#-#--#--#-#-#--#--#-#-#--#--#-#-#--#--#-#-#--#--#-#-#--#--#-#-#--#
-------#---------#---------#---------#---------#---------#---------#---------#---------#---------#--
---------#---------#---------#---------#---------#---------#---------#---------#---------#---------#
----#-#--#----#-#--#----#-#--#----#-#--#----#-#--#----#-#--#----#-#--#----#-#--#----#-#--#----#-#--#
---#--#-#----#--#-#----#--#-#----#--#-#----#--#-#----#--#-#----#--#-#----#--#-#----#--#-#----#--#-#-
----###-##----###-##----###-##----###-##----###-##----###-##----###-##----###-##----###-##----###-##
-----#---#-----#---#-----#---#-----#---#-----#---#-----#---#-----#---#-----#---#-----#---#-----#---#
-#-----##--#-----##--#-----##--#-----##--#-----##--#-----##--#-----##--#-----##--#-----##--#-----##-
#--------##--------##--------##--------##--------##--------##--------##--------##--------##--------#
---##--#-----##--#-----##--#-----##--#-----##--#-----##--#-----##--#-----##--#-----##--#-----##--#--
--#-#-#--#--#-#-#--#--#-#-#--#--#-#-#--#--#-#-#--#--#-#-#--#--#-#-#--#--#-#-#--#--#-#-#--#--#-#-#--#
-------#---------#---------#---------#---------#---------#---------#---------#---------#---------#--
---------#---------#---------#---------#---------#---------#---------#---------#---------#---------#
----#-#--#----#-#--#----#-#--#----#-#--#----#-#--#----#-#--#----#-#--#----#-#--#----#-#--#----#-#--#
---#--#-#----#--#-#----#--#-#----#--#-#----#--#-#----#--#-#----#--#-#----#--#-#----#--#-#----#--#-#-
----###-##----###-##----###-##----###-##----###-##----###-##----###-##----###-##----###-##----###-##
-----#---#-----#---#-----#---#-----#---#-----#---#-----#---#-----#---#-----#---#-----#---#-----#---#
-#-----##--#-----##--#-----##--#-----##--#-----##--#-----##--#-----##--#-----##--#-----##--#-----##-
#--------##--------##--------##--------##--------##--------##--------##--------##--------##--------#
---##--#-----##--#-----##--#-----##--#-----##--#-----##--#-----##--#-----##--#-----##--#-----##--#--
--#-#-#--#--#-#-#--#--#-#-#--#--#-#-#--#--#-#-#--#--#-#-#--#--#-#-#--#--#-#-#--#--#-#-#--#--#-#-#--#
-------#---------#---------#---------#---------#---------#---------#---------#---------#---------#--
---------#---------#---------#---------#---------#---------#---------#---------#---------#---------#
----#-#--#----#-#--#----#-#--#----#-#--#----#-#--#E---#-#--#----#-#--#----#-#--#----#-#--#----#-#--#
---#--#-#----#--#-#----#--#-#----#--#-#----#--#-#----#--#-#----#--#-#----#--#-#----#--#-#----#--#-#-
----###-##----###-##----###-##----###-##----###-##----###-##----###-##----###-##----###-##----###-##
-----#---#-----#---#-----#---#-----#---#-----#---#-----#---#-----#---#-----#---#-----#---#-----#---#
-#-----##--#-----##--#-----##--#-----##--#-----##--#-----##--#-----##--#-----##--#-----##--#-----##-
#--------##--------##--------##--------##--------##--------##--------##--------##--------##--------#
---##--#-----##--#-----##--#-----##--#-----##--#-----##--#-----##--#-----##--#-----##--#-----##--#--
--#-#-#--#--#-#-#--#--#-#-#--#--#-#-#--#--#-#-#--#--#-#-#--#--#-#-#--#--#-#-#--#--#-#-#--#--#-#-#--#
-------#---------#---------#---------#---------#---------#---------#---------#---------#---------#--
---------#---------#---------#---------#---------#---------#---------#---------#---------#---------#
----#-#--#----#-#--#----#-#--#----#-#--#----#-#--#----#-#--#----#-#--#----#-#--#----#-#--#----#-#--#
---#--#-#----#--#-#----#--#-#----#--#-#----#--#-#----#--#-#----#--#-#----#--#-#----#--#-#----#--#-#-
----###-##----###-##----###-##----###-##----###-##----###-##----###-##----###-##----###-##----###-##
-----#---#-----#---#-----#---#-----#---#-----#---#-----#---#-----#---#-----#---#-----#---#-----#---#
-#-----##--#-----##--#-----##--#-----##--#-----##--#-----##--#-----##--#-----##--#-----##--#-----##-
#--------##--------##--------##--------##--------##--------##--------##--------##--------##--------#
---##--#-----##--#-----##--#-----##--#-----##--#-----##--#-----##--#-----##--#-----##--#-----##--#--
--#-#-#--#--#-#-#--#--#-#-#--#--#-#-#--#--#-#-#--#--#-#-#--#--#-#-#--#--#-#-#--#--#-#-#--#--#-#-#--#
-------#---------#---------#---------#---------#---------#---------#---------#---------#---------#--
---------#---------#---------#---------#---------#---------#---------#---------#---------#---------#
----#-#--#----#-#--#----#-#--#----#-#--#----#-#--#----#-#--#----#-#--#----#-#--#----#-#--#----#-#--#
---#--#-#----#--#-#----#--#-#----#--#-#----#--#-#----#--#-#----#--#-#----#--#-#----#--#-#----#--#-#-
----###-##----###-##----###-##----###-##----###-##----###-##----###-##----###-##----###-##----###-##
-----#---#-----#---#-----#---#-----#---#-----#---#-----#---#-----#---#-----#---#-----#---#-----#---#
-#-----##--#-----##--#-----##--#-----##--#-----##--#-----##--#-----##--#-----##--#-----##--#-----##-
#--------##--------##--------##--------##--------##--------##--------##--------##--------##--------#
---##--#-----##--#-----##--#-----##--#-----##--#-----##--#-----##--#-----##--#-----##--#-----##--#--
--#-#-#--#--#-#-#--#--#-#-#--#--#-#-#--#--#-#-#--#--#-#-#--#--#-#-#--#--#-#-#--#--#-#-#--#--#-#-#--#
-------#---------#---------#---------#---------#---------#---------#---------#---------#---------#--
---------#---------#---------#---------#---------#---------#---------#---------#---------#---------#
----#-#--#----#-#--#----#-#--#----#-#--#----#-#--#----#-#--#----#-#--#----#-#--#----#-#--#----#-#--#
---#--#-#----#--#-#----#--#-#----#--#-#----#--#-#----#--#-#----#--#-#----#--#-#----#--#-#----#--#-#-
----###-##----###-##----###-##----###-##----###-##----###-##----###-##----###-##----###-##----###-##
-----#---#-----#---#-----#---#-----#---#-----#---#-----#---#-----#---#-----#---#-----#---#-----#---#
-#-----##--#-----##--#-----##--#-----##--#-----##--#-----##--#-----##--#-----##--#-----##--#-----##-
#--------##--------##--------##--------##--------##--------##--------##--------##--------##--------#
---##--#-----##--#-----##--#-----##--#-----##--#-----##--#-----##--#-----##--#-----##--#-----##--#--
--#-#-#--#--#-#-#--#--#-#-#--#--#-#-#--#--#-#-#--#--#-#-#--#--#-#-#--#--#-#-#--#--#-#-#--#--#-#-#--#
-------#---------#---------#---------#---------#---------#---------#---------#---------#---------#--
---------#---------#---------#---------#---------#---------#---------#---------#---------#---------#
----#-#--#----#-#--#----#-#--#----#-#--#----#-#--#----#-#--#----#-#--#----#-#--#----#-#--#----#-#--#
---#--#-#----#--#-#----#--#-#----#--#-#----#--#-#----#--#-#----#--#-#----#--#-#----#--#-#----#--#-#-
----###-##----###-##----###-##----###-##----###-##----###-##----###-##----###-##----###-##----###-##
-----#---#-----#---#-----#---#-----#---#-----#---#-----#---#-----#---#-----#---#-----#---#-----#---#
-#-----##--#-----##--#-----##--#-----##--#-----##--#-----##--#-----##--#-----##--#-----##--#-----##-
#--------##--------##--------##--------##--------##--------##--------##--------##--------##--------#
---##--#-----##--#-----##--#-----##--#-----##--#-----##--#-----##--#-----##--#-----##--#-----##--#--
--#-#-#--#--#-#-#--#--#-#-#--#--#-#-#--#--#-#-#--#--#-#-#--#--#-#-#--#--#-#-#--#--#-#-#--#--#-#-#--#
-------#---------#---------#---------#---------#---------#---------#---------#---------#---------#--
---------#---------#---------#---------#---------#---------#---------#---------#---------#---------#
----#-#--#----#-#--#----#-#--#----#-#--#----#-#--#----#-#--#----#-#--#----#-#--#----#-#--#----#-#--#
---#--#-#----#--#-#----#--#-#----#--#-#----#--#-#----#--#-#----#--#-#----#--#-#----#--#-#----#--#-#-
----###-##----###-##----###-##----###-##----###-##----###-##----###-##----###-##----###-##----###-##
-----#---#-----#---#-----#---#-----#---#-----#---#-----#---#-----#---#-----#---#-----#---#-----#---#
-#-----##--#-----##--#-----##--#-----##--#-----##--#-----##--#-----##--#-----##--#-----##--#-----##-
#--------##--------##--------##--------##--------##--------##--------##--------##--------##--------#
---##--#-----##--#-----##--#-----##--#-----##--#-----##--#-----##--#-----##--#-----##--#-----##--#--
--#-#-#--#--#-#-#--#--#-#-#--#--#-#-#--#--#-#-#--#--#-#-#--#--#-#-#--#--#-#-#--#--#-#-#--#--#-#-#--#
