--#---------#---------#---------#---------#---------#---------#---------#---------#---------#-------
--###-##----###-##----###-##----###-##----###-##----###-##----###-##----###-##----###-##----###-##--
#-----#---#-----#---#-----#---#-----#---#-----#---#-----#---#-----#---#-----#---#-----#---#-----#---
-----#-##------#-##------#-##------#-##------#-##------#-##------#-##------#-##------#-##------#-##-
#---#---###---#---###---#---###---#---###---#---###---#---###---#---###---#---###---#---###---#---##
------###-------###-------###-------###-------###-------###-------###-------###-------###-------###-
#--#----#-#--#----#-#--#----#-#--#----#-#--#----#-#--#----#-#--#----#-#--#----#-#--#----#-#--#----#-
-#--##--##-#--##--##-#--##--##-#--##--##-#--##--##-#--##--##-#--##--##-#--##--##-#--##--##-#--##--##
#---------#---------#---------#---------#---------#---------#---------#---------#---------#---------
----------------------------------------------------------------------------------------------------
--#---------#---------#---------#---------#---------#---------#---------#---------#---------#-------
--###-##----###-##----###-##----###-##----###-##----###-##----###-##----###-##----###-##----###-##--
#-----#---#-----#---#-----#---#-----#---#-----#---#-----#---#-----#---#-----#---#-----#---#-----#---
-----#-##------#-##------#-##------#-##------#-##------#-##------#-##------#-##------#-##------#-##-
#---#---###---#---###---#---###---#---###---#---###---#---###---#---###---#---###---#---###---#---##
------###-------###-------###-------###-------###-------###-------###-------###-------###-------###-
#--#----#-#--#----#-#--#----#-#--#----#-#--#----#-#--#----#-#--#----#-#--#----#-#--#----#-#--#----#-
-#--##--##-#--##--##-#--##--##-#--##--##-#--##--##-#--##--##-#--##--##-#--##--##-#--##--##-#--##--##
#---------#---------#---------#---------#---------#---------#---------#---------#---------#---------
----------------------------------------------------------------------------------------------------
--#---------#---------#---------#---------#---------#---------#---------#---------#---------#-------
--###-##----###-##----###-##----###-##----###-##----###-##----###-##----###-##----###-##----###-##--
#-----#---#-----#---#-----#---#-----#---#-----#---#-----#---#-----#---#-----#---#-----#---#-----#---
-----#-##------#-##------#-##------#-##------#-##------#-##------#-##------#-##------#-##------#-##-
#---#---###---#---###---#---###---#---###---#---###---#---###---#---###---#---###---#---###---#---##
------###-------###-------###-------###-------###-------###-------###-------###-------###-------###-
#--#----#-#--#----#-#--#----#-#--#----#-#--#----#-#--#----#-#--#----#-#--#----#-#--#----#-#--#----#-
-#--##--##-#--##--##-#--##--##-#--##--##-#--##--##-#--##--##-#--##--##-#--##--##-#--##--##-#--##--##
#---------#---------#---------#---------#---------#---------#---------#---------#---------#---------
----------------------------------------------------------------------------------------------------
--#---------#---------#---------#---------#---------#---------#---------#---------#---------#-------
--###-##----###-##----###-##----###-##----###-##----###-##----###-##----###-##----###-##----###-##--
#-----#---#-----#---#-----#---#-----#---#-----#---#-----#---#-----#---#-----#---#-----#---#-----#---
-----#-##------#-##------#-##------#-##------#-##------#-##------#-##------#-##------#-##------#-##-
#---#---###---#---###---#---###---#---###---#---###---#---###---#---###---#---###---#---###---#---##
------###-------###-------###-------###-------###-------###-------###-------###-------###-------###-
#--#----#-#--#----#-#--#----#-#--#----#-#--#----#-#--#----#-#--#----#-#--#----#-#--#----#-#--#----#-
-#--##--##-#--##--##-#--##--##-#--##--##-#--##--##-#--##--##-#--##--##-#--##--##-#--##--##-#--##--##
#---------#---------#---------#---------#---------#---------#---------#---------#---------#---------
----------------------------------------------------------------------------------------------------
--#---------#---------#---------#---------#---------#---------#---------#---------#---------#-------
--###-##----###-##----###-##----###-##----###-##----###-##----###-##----###-##----###-##----###-##--
#-----#---#-----#---#-----#---#-----#---#-----#---#-----#---#-----#---#-----#---#-----#---#-----#---
-----#-##------#-##------#-##------#-##------#-##------#-##------#-##------#-##------#-##------#-##-
#---#---###---#---###---#---###---#---###---#---###---#---###---#---###---#---###---#---###---#---##
------###-------###-------###-------###-------###-------###-------###-------###-------###-------###-
#--#----#-#--#----#-#--#----#-#--#----#-#--#----#-#--#----#-#--#----#-#--#----#-#--#----#-#--#----#-
-#--##--##-#--##--##-#--##--##-#--##--##-#--##--##-#--##--##-#--##--##-#--##--##-#--##--##-#--##--##
#---------#---------#---------#---------#---------#---------#---------#---------#---------#---------
----------------------------------------------------------------------------------------------------
--#---------#---------#---------#---------#---------#---------#---------#---------#---------#-------
--###-##----###-##----###-##----###-##----###-##----###-##----###-##----###-##----###-##----###-##--
#-----#---#-----#---#-----#---#-----#---#-----#---#-----#---#-----#---#-----#---#-----#---#-----#---
-----#-##------#-##------#-##------#-##------#-##------#-##------#-##------#-##------#-##------#-##-
#---#---###---#---###---#---###---#---###---#---###---#---###---#---###---#---###---#---###---#---##
------###-------###-------###-------###-------###-------###-------###-------###-------###-------###-
#--#----#-#--#----#-#--#----#-#--#----#-#--#----#-#--#----#-#--#----#-#--#----#-#--#----#-#--#----#-
-#--##--##-#--##--##-#--##--##-#--##--##-#--##--##-#--##--##-#--##--##-#--##--##-#--##--##-#--##--##
#---------#---------#---------#---------#---------#---------#---------#---------#---------#---------
----------------------------------------------------------------------------------------------------
--#---------#---------#---------#---------#---------#---------#---------#---------#---------#-------
--###-##----###-##----###-##----###-##----###-##----###-##----###-##----###-##----###-##----###-##--
#-----#---#-----#---#-----#---#-----#---#-----#---#-----#---#-----#---#-----#---#-----#---#-----#---
-----#-##------#-##------#-##------#-##------#-##------#-##------#-##------#-##------#-##------#-##-
#---#---###---#---###---#---###---#---###---#---###---#---###---#---###---#---###---#---###---#---##
------###-------###-------###-------###-------###-------###-------###-------###-------###-------###-
#--#----#-#--#----#-#--#----#-#--#----#-#--#----#-#--#----#-#--#----#-#--#----#-#--#----#-#--#---E#-
-#--##--##-#--##--##-#--##--##-#--##--##-#--##--##-#--##--##-#--##--##-#--##--##-#--##--##-#--##--##
#---------#---------#---------#---------#---------#---------#---------#---------#---------#---------
----------------------------------------------------------------------------------------------------
--#---------#---------#---------#---------#---------#---------#---------#---------#---------#-------
--###-##----###-##----###-##----###-##----###-##----###-##----###-##----###-##----###-##----###-##--
#-----#---#-----#---#-----#---#-----#---#-----#---#-----#---#-----#---#-----#---#-----#---#-----#---
-----#-##------#-##------#-##------#-##------#-##------#-##------#-##------#-##------#-##------#-##-
#---#---###---#---###---#---###---#---###---#---###---#---###---#---###-S-#---###---#---###---#---##
------###-------###-------###-------###-------###-------###-------###-------###-------###-------###-
#--#----#-#--#----#-#--#----#-#--#----#-#--#----#-#--#----#-#--#----#-#--#----#-#--#----#-#--#----#-
-#--##--##-#--##--##-#--##--##-#--##--##-#--##--##-#--##--##-#--##--##-#--##--##-#--##--##-#--##--##
#---------#---------#---------#---------#---------#---------#---------#---------#---------#---------
----------------------------------------------------------------------------------------------------
--#---------#---------#---------#---------#---------#---------#---------#---------#---------#-------
--###-##----###-##----###-##----###-##----###-##----###-##----###-##----###-##----###-##----###-##--
#-----#---#-----#---#-----#---#-----#---#-----#---#-----#---#-----#---#-----#---#-----#---#-----#---
-----#-##------#-##------#-##------#-##------#-##------#-##------#-##------#-##------#-##------#-##-
#---#---###---#---###---#---###---#---###---#---###---#---###---#---###---#---###---#---###---#---##
------###-------###-------###-------###-------###-------###-------###-------###-------###-------###-
#--#----#-#--#----#-#--#----#-#--#----#-#--#----#-#--#----#-#--#----#-#--#----#-#--#----#-#--#----#-
-#--##--##-#--##--##-#--##--##-#--##--##-#--##--##-#--##--##-#--##--##-#--##--##-#--##--##-#--##--##
#---------#---------#---------#---------#---------#---------#---------#---------#---------#---------
----------------------------------------------------------------------------------------------------
--#---------#---------#---------#---------#---------#---------#---------#---------#---------#-------
--###-##----###-##----###-##----###-##----###-##----###-##----###-##----###-##----###-##----###-##--
#-----#---#-----#---#-----#---#-----#---#-----#---#-----#---#-----#---#-----#---#-----#---#-----#---
-----#-##------#-##------#-##------#-##------#-##------#-##------#-##------#-##------#-##------#-##-
#---#---###---#---###---#---###---#---###---#---###---#---###---#---###---#---###---#---###---#---##
------###-------###-------###-------###-------###-------###-------###-------###-------###-------###-
#--#----#-#--#----#-#--#----#-#--#----#-#--#----#-#--#----#-#--#----#-#--#----#-#--#----#-#--#----#-
-#--##--##-#--##--##-#--##--##-#--##--##-#--##--##-#--##--##-#--##--##-#--##--##-#--##--##-#--##--##
#---------#---------#---------#---------#---------#---------#---------#---------#---------#---------
----------------------------------------------------------------------------------------------------
