#-#-------#-#-------#-#-------#-#-------#-#-------#-#-------#-#-------#-#-------#-#-------#-#-------
-#----##-#-#----##-#-#----##-#-#----##-#-#----##-#-#----##-#-#----##-#-#----##-#-#----##-#-#----##-#
-##-#-##---##-#-##---##-#-##---##-#-##---##-#-##---##-#-##---##-#-##---##-#-##---##-#-##---##-#-##--
--#---------#---------#---------#---------#---------#---------#---------#---------#---------#-------
---#----##---#----##---#----##---#----##---#----##---#----##---#----##---#----##---#----##---#----##
---#--#------#--#------#--#------#--#------#--#------#--#------#--#------#--#------#--#------#--#---
----#---------#---------#---------#---------#---------#---------#---------#---------#---------#-----
---##--------##--------##--------##--------##--------##--------##--------##--------##--------##-----
-#----#-#--#----#-#--#----#-#--#----#-#--#----#-#--#----#-#--#----#-#--#----#-#--#----#-#--#----#-#-
-#-------#-#-------#-#-------#-#-------#-#-------#-#-------#-#-------#-#-------#-#-------#-#-------#
#-#-------#-#-------#-#-------#-#-------#-#-------#-#-------#-#-------#-#-------#-#-------#-#-------
-#----##-#-#----##-#-#----##-#-#----##-#-#----##-#-#----##-#-#----##-#-#----##-#-#----##-#-#----##-#
-##-#-##---##-#-##---##-#-##---##-#-##---##-#-##---##-#-##---##-#-##---##-#-##---##-#-##---##-#-##--
--#---------#---------#---------#---------#---------#---------#---------#---------#---------#-------
---#----##---#----##---#----##---#----##---#----##---#----##---#----##---#----##---#----##---#----##
---#--#------#--#------#--#------#--#------#--#------#--#------#--#------#--#------#--#------#--#---
----#---------#---------#---------#---------#---------#---------#---------#---------#---------#-----
---##--------##--------##--------##--------##--------##--------##--------##--------##--------##-----
-#----#-#--#----#-#--#----#-#--#----#-#--#----#-#--#----#-#--#----#-#--#----#-#--#----#-#--#----#-#-
-#-------#-#-------#-#-------#-#-------#-#-------#-#-------#-#-------#-#-------#-#-------#-#-------#
#-#-------#-#-------#-#-------#-#-------#-#-------#-#-------#-#-------#-#-------#-#-------#-#-------
-#----##-#-#----##-#-#----##-#-#----##-#-#----##-#-#----##-#-#----##-#-#----##-#-#----##-#-#----##-#
-##-#-##---##-#-##---##-#-##---##-#-##---##-#-##---##-#-##---##-#-##---##-#-##---##-#-##---##-#-##--
--#---------#---------#---------#---------#---------#---------#---------#---------#---------#-------
---#----##---#----##---#----##---#----##---#----##---#----##---#----##---#----##---#----##---#----##
---#--#------#--#------#--#------#--#------#--#------#--#------#--#------#--#------#--#------#--#---
----#---------#---------#---------#---------#---------#---------#---------#---------#---------#-----
---##--------##--------##--------##--------##--------##--------##--------##--------##--------##-----
-#----#-#--#----#-#--#----#-#--#----#-#--#----#-#--#----#-#--#----#-#--#----#-#--#----#-#--#----#-#-
-#-------#-#-------#-#-------#-#-------#-#-------#-#-------#-#-------#-#-------#-#-------#-#-------#
#-#-------#-#-------#-#-------#-#-------#-#-------#-#-------#-#-------#-#-------#-#-------#-#-------
-#----##-#-#----##-#-#----##-#-#----##-#-#----##-#-#----##-#-#----##-#-#----##-#-#----##-#-#----##-#
-##-#-##---##-#-##---##-#-##---##-#-##---##-#-##---##-#-##---##-#-##---##-#-##---##-#-##---##-#-##--
--#---------#---------#---------#---------#---------#---------#---------#---------#---------#-------
---#----##---#----##---#----##---#----##---#----##---#----##---#----##---#----##---#----##---#----##
---#--#------#--#------#--#------#--#------#--#------#--#------#--#------#--#------#--#------#--#---
----#---------#---------#---------#---------#---------#---------#---------#---------#---------#-----
---##--------##--------##--------##--------##--------##--------##--------##--------##--------##-----
-#----#-#--#----#-#--#----#-#--#----#-#--#----#-#--#----#-#--#----#-#--#----#-#--#----#-#--#----#-#-
-#-------#-#-------#-#-------#-#-------#-#-------#-#-------#-#-------#-#-------#-#-------#-#-------#
#-#-------#-#-------#-#-------#-#-------#-#-------#-#-------#-#-------#-#-------#-#-------#-#-------
-#----##-#-#----##-#-#----##-#-#----##-#-#----##-#-#----##-#-#----##-#-#----##-#-#----##-#-#----##-#
-##-#-##---##-#-##---##-#-##---##-#-##---##-#-##---##-#-##---##-#-##---##-#-##---##-#-##---##-#-##--
--#---------#---------#---------#---------#---------#---------#---------#---------#---------#-------
---#----##---#----##---#----##---#----##---#----##---#----##---#----##---#----##---#----##---#----##
---#--#------#--#------#--#------#--#------#--#------#--#------#--#------#--#------#--#------#--#---
----#---------#---------#---------#---------#---------#---------#---------#---------#---------#-----
---##--------##--------##--------##--------##--------##--------##--------##--------##--------##-----
-#----#-#--#----#-#--#----#-#--#----#-#--#----#-#--#----#-#--#----#-#--#----#-#--#----#-#--#----#-#-
-#-------#-#-------#-#-------#-#-------#-#-------#-#-------#-#-------#-#-------#-#-------#-#-------#
#-#-------#-#-------#-#-------#-#-------#-#-------#-#-------#-#-------#-#-------#-#-------#-#-------
-#----##-#-#----##-#-#----##-#-#----##-#-#----##-#-#----##-#-#----##-#-#----##-#-#----##-#-#----##-#
-##-#-##---##-#-##---##-#-##---##-#-##---##-#-##---##-#-##---##-#-##---##-#-##---##-#-##---##-#-##--
--#---------#---------#---------#---------#---------#---------#---------#---------#---------#-------
---#----##---#----##---#----##---#----##---#----##---#----##---#----##---#----##---#----##---#----##
---#--#------#--#------#--#------#--#------#--#------#--#------#--#------#--#------#--#------#--#---
----#---------#---------#---------#---------#---------#---------#---------#---------#---------#-----
---##--------##--------##--------##--------##--------##--------##--------##--------##--------##-----
-#----#-#--#----#-#--#----#-#--#----#-#--#----#-#--#----#-#--#----#-#--#----#-#--#----#-#--#----#-#-
-#-------#-#-------#-#-------#-#-------#-#-------#-#-------#-#-------#-#-------#-#-------#-#-------#
#-#-------#-#-------#-#-------#-#-------#-#-------#-#-------#-#-------#-#-------#-#-------#-#-------
-#----##-#-#----##-#-#----##-#-#----##-#-#----##-#-#----##-#-#----##-#-#----##-#-#----##-#-#----##-#
-##-#-##---##-#-##---##-#-##---##-#-##---##-#-##---##-#-##---##-#-##---##-#-##---##-#-##---##-#-##--
--#---------#---------#---------#---------#---------#---------#---------#---------#---------#-------
---#----##---#----##---#----##---#----##---#----##---#----##---#----##---#----##---#----##---#----##
---#--#------#--#------#--#------#--#------#--#------#--#------#--#------#--#------#--#------#--#---
----#---------#---------#---------#---------#---------#---------#---------#---------#---------#-----
---##--------##--------##--------##--------##--------##--------##--------##--------##--------##-----
-#----#-#--#----#-#--#----#-#--#----#-#--#----#-#--#----#-#--#----#-#--#----#-#--#----#-#--#----#-#-
-#-------#-#-------#-#-------#-#-------#-#-------#-#-------#-#-------#-#-------#-#-------#-#-------#
#-#-------#-#-------#-#-------#-#-------#-#-------#-#-------#-#-------#-#-------#-#-------#-#-------
-#----##-#-#----##-#-#----##-#-#----##-#-#----##-#-#----##-#-#----##-#-#----##-#-#----##-#-#----##-#
-##-#-##---##-#-##---##-#-##---##-#-##---##-#-##---##-#-##---##-#-##---##-#-##---##-#-##---##-#-##--
--#---------#---------#---------#---------#---------#---------#---------#---------#---------#-------
---#----##---#----##---#----##---#----##---#----##---#----##---#----##---#----##---#----##---#----##
---#--#------#--#------#--#------#--#------#--#------#--#------#--#------#--#------#--#------#--#---
----#---------#---------#---------#---------#---------#---------#---------#---------#---------#-----
---##--------##--------##--------##--------##--------##--------##--------##--------##--------##-----
-#----#-#--#----#-#--#----#-#--#----#-#--#----#-#--#----#-#--#----#-#--#----#-#--#----#-#--#----#-#-
-#-------#-#-------#-#-------#-#-------#-#-------#-#-------#-#-------#-#-------#-#-------#-#-------#
#-#-------#-#-------#-#-------#-#-------#-#-------#-#-------#-#-------#-#-------#-#-------#-#-------
-#----##-#-#----##-#-#----##-#-#----##-#-#----##-#-#----##-#-#----##-#-#----##-#-#----##-#-#----##-#
-##-#-##---##-#-##---##-#-##---##-#-##---##-#-##---##-#-##---##-#-##---##-#-##---##-#-##---##-#-##--
--#---------#---------#---------#---------#---------#---------#---------#---------#---------#-------
---#----##---#----##---#----##---#----##---#----##---#----##---#----##---#----##---#----##---#----##
---#--#------#--#------#--#------#--#------#--#------#--#------#--#------#--#------#--#------#--#---
----#---------#---------#---------#---------#---------#---------#---------#---------#---------#-----
---##--------##--------##--------##--------##--------##--------##--------##------S-##--------##-----
-#----#-#--#----#-#--#----#-#--#----#-#--#----#-#--#----#-#--#----#-#--#----#-#--#----#-#--#----#-#-
-#-------#-#-------#-#-------#-#-------#-#-------#-#-------#-#-------#-#-------#-#-------#-#-------#
#-#-------#-#-------#-#-------#-#-------#-#-------#-#-------#-#-------#-#-------#-#-------#-#-------
-#----##-#-#----##-#-#----##-#-#----##-#-#----##-#-#----##-#-#----##-#-#----##-#-#----##-#-#----##-#
-##-#-##---##-#-##---##-#-##---##-#-##---##-#-##---##-#-##---##-#-##---##-#-##---##-#-##---##-#-##--
--#---------#---------#---------#--------E#---------#---------#---------#---------#---------#-------
---#----##---#----##---#----##---#----##---#----##---#----##---#----##---#----##---#----##---#----##
---#--#------#--#------#--#------#--#------#--#------#--#------#--#------#--#------#--#------#--#---
----#---------#---------#---------#---------#---------#---------#---------#---------#---------#-----
---##--------##--------##--------##--------##--------##--------##--------##--------##--------##-----
-#----#-#--#----#-#--#----#-#--#----#-#--#----#-#--#----#-#--#----#-#--#----#-#--#----#-#--#----#-#-
-#-------#-#-------#-#-------#-#-------#-#-------#-#-------#-#-------#-#-------#-#-------#-#-------#
