---##--------##--------##--------##--------##--------##--------##--------##--------##--------##-----
###----#--###----#--###----#--###----#--###----#--###----#--###----#--###----#--###----#--###----#--
-------#---------#---------#---------#---------#---------#---------#---------#---------#---------#--
---##--------##--------##--------##--------##--------##--------##--------##--------##--------##-----
----##---#----##---#----##---#----##---#----##---#----##---#----##---#----##---#----##---#----##---#
---#-#-#-----#-#-#-----#-#-#-----#-#-#-----#-#-#-----#-#-#-----#-#-#-----#-#-#-----#-#-#-----#-#-#--
---#---------#---------#---------#---------#---------#---------#---------#---------#---------#------
#-------#-#-------#-#-------#-#-------#-#-------#-#-------#-#-------#-#-------#-#-------#-#-------#-
--#---##----#---##----#---##----#---##----#---##----#---##----#---##----#---##----#---##----#---##--
--##-#------##-#------##-#------##-#------##-#------##-#------##-#------##-#------##-#------##-#----
---##--------##--------##--------##--------##--------##--------##--------##--------##--------##-----
###----#--###----#--###----#--###----#--###----#--###----#--###----#--###----#--###----#--###----#--
-------#---------#---------#---------#---------#---------#---------#---------#---------#---------#--
---##--------##--------##--------##--------##--------##--------##--------##--------##--------##-----
----##---#----##---#----##---#----##---#----##---#----##---#----##---#----##---#----##---#----##---#
---#-#-#-----#-#-#-----#-#-#-----#-#-#-----#-#-#-----#-#-#-----#-#-#-----#-#-#-----#-#-#-----#-#-#--
---#---------#---------#---------#---------#---------#---------#---------#---------#---------#------
#-------#-#-------#-#-------#-#-------#-#-------#-#-------#-#-------#-#-------#-#-------#-#-------#-
--#---##----#---##----#---##----#---##----#---##----#---##----#---##----#---##----#---##----#---##--
--##-#------##-#------##-#------##-#------##-#------##-#------##-#------##-#------##-#------##-#----
---##--------##--------##--------##--------##--------##--------##--------##--------##--------##-----
###----#--###----#--###----#--###----#--###----#--###----#--###----#--###----#--###----#--###----#--
-------#---------#---------#---------#---------#---------#---------#---------#---------#---------#--
---##--------##--------##--------##--------##--------##--------##--------##--------##--------##-----
----##---#----##---#----##---#----##---#----##---#----##---#----##---#----##---#----##---#----##---#
---#-#-#-----#-#-#-----#-#-#--E--#-#-#-----#-#-#-----#-#-#-----#-#-#-----#-#-#-----#-#-#-----#-#-#--
---#---------#---------#---------#---------#---------#---------#---------#---------#---------#------
#-------#-#-------#-#-------#-#-------#-#-------#-#-------#-#-------#-#-------#-#-------#-#-------#-
--#---##----#---##----#---##----#---##----#---##----#---##----#---##----#---##----#---##----#---##--
--##-#------##-#------##-#------##-#------##-#------##-#------##-#------##-#------##-#------##-#----
---##--------##--------##--------##--------##--------##--------##--------##--------##--------##-----
###----#--###----#--###----#--###----#--###----#--###----#--###----#--###----#--###----#--###----#--
-------#---------#---------#---------#---------#---------#---------#---------#---------#---------#--
---##--------##--------##--------##--------##--------##--------##--------##--------##--------##-----
----##---#----##---#----##---#----##---#----##---#----##---#----##---#----##---#----##---#----##---#
---#-#-#-----#-#-#-----#-#-#-----#-#-#-----#-#-#-----#-#-#-----#-#-#-----#-#-#-----#-#-#-----#-#-#--
---#---------#---------#---------#---------#---------#---------#---------#---------#---------#------
#-------#-#-------#-#-------#-#-------#-#-------#-#-------#-#-------#-#-------#-#-------#-#-------#-
--#---##----#---##----#---##----#---##----#---##----#---##----#---##----#---##----#---##----#---##--
--##-#------##-#------##-#------##-#------##-#------##-#------##-#------##-#------##-#------##-#----
---##--------##--------##--------##--------##--------##--------##--------##--------##--------##-----
###----#--###----#--###----#--###----#--###----#--###----#--###----#--###----#--###----#--###----#--
-------#---------#---------#---------#---------#---------#---------#---------#---------#---------#--
---##--------##--------##--------##--------##--------##--------##--------##--------##--------##-----
----##---#----##---#----##---#----##---#----##---#----##---#----##---#----##---#----##---#----##---#
---#-#-#-----#-#-#-----#-#-#-----#-#-#-----#-#-#-----#-#-#-----#-#-#-----#-#-#-----#-#-#-----#-#-#--
---#---------#---------#---------#---------#---------#---------#---------#---------#---------#------
#-------#-#-------#-#-------#-#-------#-#-------#-#-------#-#-------#-#-------#-#-------#-#-------#-
--#---##----#---##----#---##----#---##----#---##----#---##----#---##----#---##----#---##----#---##--
--##-#------##-#------##-#------##-#------##-#------##-#------##-#------##-#------##-#------##-#----
---##--------##--------##--------##--------##--------##--------##--------##--------##--------##-----
###----#--###----#--###----#--###----#--###----#--###----#--###----#--###----#--###----#--###----#--
-------#---------#---------#---------#---------#---------#---------#---------#---------#---------#--
---##--------##--------##--------##--------##--------##--------##--------##--------##--------##-----
----##---#----##---#----##---#----##---#----##---#----##---#----##---#----##---#----##---#----##---#
---#-#-#-----#-#-#-----#-#-#-----#-#-#-----#-#-#-----#-#-#-----#-#-#-----#-#-#-----#-#-#-----#-#-#--
---#---------#---------#---------#---------#---------#---------#---------#---------#---------#------
#-------#-#-------#-#-------#-#-------#-#-------#-#-------#-#-------#-#-------#-#-------#-#-------#-
--#---##----#---##----#---##----#---##----#---##----#---##----#---##----#---##----#---##----#---##--
--##-#------##-#------##-#------##-#------##-#------##-#------##-#------##-#------##-#------##-#----
---##--------##--------##--------##--------##--------##--------##--------##--------##--------##-----
###----#--###----#--###----#--###----#--###----#--###----#--###----#--###----#--###----#--###----#--
-------#---------#---------#---------#---------#---------#---------#---------#---------#---------#--
---##--------##--------##--------##--------##--------##--------##--------##--------##--------##-----
----##---#----##---#----##---#----##---#----##---#----##---#----##---#----##---#----##---#----##---#
---#-#-#-----#-#-#-----#-#-#-----#-#-#-----#-#-#-----#-#-#-----#-#-#-----#-#-#-----#-#-#-----#-#-#--
---#---------#---------#---------#---------#---------#---------#---------#---------#---------#------
#-------#-#-------#-#-------#-#-------#-#-------#-#-------#-#-------#-#-------#-#-------#-#-------#-
--#---##----#---##----#---##----#---##----#---##----#---##----#---##----#---##----#---##----#---##--
--##-#------##-#------##-#------##-#------##-#------##-#------##-#------##-#------##-#------##-#----
---##--------##--------##--------##--------##--------##--------##--------##--------##--------##-----
###----#--###----#--###----#--###----#--###----#--###----#--###----#--###----#--###----#--###----#--
-------#---------#---------#---------#---------#---------#---------#---------#---------#---------#--
---##--------##--------##--------##--------##--------##--------##--------##--------##--------##-----
----##---#----##---#----##---#----##---#----##---#----##---#----##---#----##---#----##---#----##---#
---#-#-#-----#-#-#-----#-#-#-----#-#-#-----#-#-#S----#-#-#-----#-#-#-----#-#-#-----#-#-#-----#-#-#--
---#---------#---------#---------#---------#---------#---------#---------#---------#---------#------
#-------#-#-------#-#-------#-#-------#-#-------#-#-------#-#-------#-#-------#-#-------#-#-------#-
--#---##----#---##----#---##----#---##----#---##----#---##----#---##----#---##----#---##----#---##--
--##-#------##-#------##-#------##-#------##-#------##-#------##-#------##-#------##-#------##-#----
---##--------##--------##--------##--------##--------##--------##--------##--------##--------##-----
###----#--###----#--###----#--###----#--###----#--###----#--###----#--###----#--###----#--###----#--
-------#---------#---------#---------#---------#---------#---------#---------#---------#---------#--
---##--------##--------##--------##--------##--------##--------##--------##--------##--------##-----
----##---#----##---#----##---#----##---#----##---#----##---#----##---#----##---#----##---#----##---#
---#-#-#-----#-#-#-----#-#-#-----#-#-#-----#-#-#-----#-#-#-----#-#-#-----#-#-#-----#-#-#-----#-#-#--
---#---------#---------#---------#---------#---------#---------#---------#---------#---------#------
#-------#-#-------#-#-------#-#-------#-#-------#-#-------#-#-------#-#-------#-#-------#-#-------#-
--#---##----#---##----#---##----#---##----#---##----#---##----#---##----#---##----#---##----#---##--
--##-#------##-#------##-#------##-#------##-#------##-#------##-#------##-#------##-#------##-#----
---##--------##--------##--------##--------##--------##--------##--------##--------##--------##-----
###----#--###----#--###----#--###----#--###----#--###----#--###----#--###----#--###----#--###----#--
-------#---------#---------#---------#---------#---------#---------#---------#---------#---------#--
---##--------##--------##--------##--------##--------##--------##--------##--------##--------##-----
----##---#----##---#----##---#----##---#----##---#----##---#----##---#----##---#----##---#----##---#
---#-#-#-----#-#-#-----#-#-#-----#-#-#-----#-#-#-----#-#-#-----#-#-#-----#-#-#-----#-#-#-----#-#-#--
---#---------#---------#---------#---------#---------#---------#---------#---------#---------#------
#-------#-#-------#-#-------#-#-------#-#-------#-#-------#-#-------#-#-------#-#-------#-#-------#-
--#---##----#---##----#---##----#---##----#---##----#---##----#---##----#---##----#---##----#---##--
--##-#------##-#------##-#------##-#------##-#------##-#------##-#------##-#------##-#------##-#----
