##-#--#-#-##-#--#-#-##-#--#-#-##-#--#-#-##-#--#-#-##-#--#-#-##-#--#-#-##-#--#-#-##-#--#-#-##-#--#-#-
---###-------###-------###-------###-------###-------###-------###-------###-------###-------###----
-#-#-------#-#-------#-#-------#-#-------#-#-------#-#-------#-#-------#-#-------#-#-------#-#------
---#---#-----#---#-----#---#-----#---#-----#---#-----#---#-----#---#-----#---#-----#---#-----#---#--
##-------###-------###-------###-------###-------###-------###-------###-------###-------###-------#
---#-##--#---#-##--#---#-##--#---#-##--#---#-##--#---#-##--#---#-##--#---#-##--#---#-##--#---#-##--#
---------#---------#---------#---------#---------#---------#---------#---------#---------#---------#
----#---------#---------#---------#---------#---------#---------#---------#---------#---------#-----
------#---------#---------#---------#---------#---------#---------#---------#---------#---------#---
#---------#---------#---------#---------#---------#---------#---------#---------#---------#---------
##-#--#-#-##-#--#-#-##-#--#-#-##-#--#-#-##-#--#-#-##-#--#-#-##-#--#-#-##-#--#-#-##-#--#-#-##-#--#-#-
---###-------###-------###-------###-------###-------###-------###-------###-------###-------###----
-#-#-------#-#-------#-#-------#-#-------#-#-------#-#-------#-#-------#-#-------#-#-------#-#------
---#---#-----#---#-----#---#-----#---#-----#---#-----#---#-----#---#-----#---#-----#---#-----#---#--
##-------###-------###-------###-------###-------###-------###-------###-------###-------###-------#
---#-##--#---#-##-S#---#-##--#---#-##--#---#-##--#---#-##--#---#-##--#---#-##--#---#-##--#---#-##--#
---------#---------#---------#---------#---------#---------#---------#---------#---------#---------#
----#---------#---------#---------#---------#---------#---------#---------#---------#---------#-----
------#---------#---------#---------#---------#---------#---------#---------#---------#---------#---
#---------#---------#---------#---------#---------#---------#---------#---------#---------#---------
##-#--#-#-##-#--#-#-##-#--#-#-##-#--#-#-##-#--#-#-##-#--#-#-##-#--#-#-##-#--#-#-##-#--#-#-##-#--#-#-
---###-------###-------###-------###-------###-------###-------###-------###-------###-------###----
-#-#-------#-#-------#-#-------#-#-------#-#-------#-#-------#-#-------#-#-------#-#-------#-#------
---#---#-----#---#-----#---#-----#---#-----#---#-----#---#-----#---#-----#---#-----#---#-----#---#--
##-------###-------###-------###-------###-------###-------###-------###-------###-------###-------#
---#-##--#---#-##--#---#-##--#---#-##--#---#-##--#---#-##--#---#-##--#---#-##--#---#-##--#---#-##--#
---------#---------#---------#---------#---------#---------#---------#---------#---------#---------#
----#---------#---------#---------#---------#---------#---------#---------#---------#---------#-----
------#---------#---------#---------#---------#---------#---------#---------#---------#---------#---
#---------#---------#---------#---------#---------#---------#---------#---------#---------#---------
##-#--#-#-##-#--#-#-##-#--#-#-##-#--#-#-##-#--#-#-##-#--#-#-##-#--#-#-##-#--#-#-##-#--#-#-##-#--#-#-
---###-------###-------###-------###-------###-------###-------###-------###-------###-------###----
-#-#-------#-#-------#-#-------#-#-------#-#-------#-#-------#-#-------#-#-------#-#-------#-#------
---#---#-----#---#-----#---#-----#---#-----#---#-----#---#-----#---#-----#---#-----#---#-----#---#--
##-------###-------###-------###-------###-------###-------###-------###-------###-------###-------#
---#-##--#---#-##--#---#-##--#---#-##--#---#-##--#---#-##--#---#-##--#---#-##--#---#-##--#---#-##--#
---------#---------#---------#---------#---------#---------#---------#---------#---------#---------#
----#---------#---------#---------#---------#---------#---------#---------#---------#---------#-----
------#---------#---------#---------#---------#---------#---------#---------#---------#---------#---
#---------#---------#---------#---------#---------#---------#---------#---------#---------#---------
##-#--#-#-##-#--#-#-##-#--#-#-##-#--#-#-##-#--#-#-##-#--#-#-##-#--#-#-##-#--#-#-##-#--#-#-##-#--#-#-
---###-------###-------###-------###-------###-------###-------###-------###-------###-------###----
-#-#-------#-#-------#-#-------#-#-------#-#-------#-#-------#-#-------#-#-------#-#-------#-#------
---#---#-----#---#-----#---#-----#---#-----#---#-----#---#-----#---#-----#---#-----#---#-----#---#--
##-------###-------###-------###-------###-------###-------###-------###-------###-------###-------#
---#-##--#---#-##--#---#-##--#---#-##--#---#-##--#---#-##--#---#-##--#---#-##--#---#-##--#---#-##--#
---------#---------#---------#---------#---------#---------#---------#---------#---------#---------#
----#---------#---------#---------#---------#---------#---------#---------#---------#---------#-----
------#---------#---------#---------#---------#---------#---------#---------#---------#---------#---
#---------#---------#---------#---------#---------#---------#---------#---------#---------#---------
##-#--#-#-##-#--#-#-##-#--#-#-##-#--#-#-##-#--#-#-##-#--#-#-##-#--#-#-##-#--#-#-##-#--#-#-##-#--#-#-
---###-------###-------###-------###-------###-------###-------###-------###-------###-------###----
-#-#-------#-#-------#-#-------#-#-------#-#-------#-#-------#-#-------#-#-------#-#-------#-#------
---#---#-----#---#-----#---#-----#---#-----#---#-----#---#-----#---#-----#---#-----#---#-----#---#--
##-------###-------###-------###-------###-------###-------###-------###-------###-------###-------#
---#-##--#---#-##--#---#-##--#---#-##--#---#-##--#---#-##--#---#-##--#---#-##--#---#-##--#---#-##--#
---------#---------#---------#---------#---------#---------#---------#---------#---------#---------#
----#---------#---------#---------#---------#---------#---------#---------#---------#---------#-----
------#---------#---------#---------#---------#---------#---------#---------#--------E#---------#---
#---------#---------#---------#---------#---------#---------#---------#---------#---------#---------
##-#--#-#-##-#--#-#-##-#--#-#-##-#--#-#-##-#--#-#-##-#--#-#-##-#--#-#-##-#--#-#-##-#--#-#-##-#--#-#-
---###-------###-------###-------###-------###-------###-------###-------###-------###-------###----
-#-#-------#-#-------#-#-------#-#-------#-#-------#-#-------#-#-------#-#-------#-#-------#-#------
---#---#-----#---#-----#---#-----#---#-----#---#-----#---#-----#---#-----#---#-----#---#-----#---#--
##-------###-------###-------###-------###-------###-------###-------###-------###-------###-------#
---#-##--#---#-##--#---#-##--#---#-##--#---#-##--#---#-##--#---#-##--#---#-##--#---#-##--#---#-##--#
---------#---------#---------#---------#---------#---------#---------#---------#---------#---------#
----#---------#---------#---------#---------#---------#---------#---------#---------#---------#-----
------#---------#---------#---------#---------#---------#---------#---------#---------#---------#---
#---------#---------#---------#---------#---------#---------#---------#---------#---------#---------
##-#--#-#-##-#--#-#-##-#--#-#-##-#--#-#-##-#--#-#-##-#--#-#-##-#--#-#-##-#--#-#-##-#--#-#-##-#--#-#-
---###-------###-------###-------###-------###-------###-------###-------###-------###-------###----
-#-#-------#-#-------#-#-------#-#-------#-#-------#-#-------#-#-------#-#-------#-#-------#-#------
---#---#-----#---#-----#---#-----#---#-----#---#-----#---#-----#---#-----#---#-----#---#-----#---#--
##-------###-------###-------###-------###-------###-------###-------###-------###-------###-------#
---#-##--#---#-##--#---#-##--#---#-##--#---#-##--#---#-##--#---#-##--#---#-##--#---#-##--#---#-##--#
---------#---------#---------#---------#---------#---------#---------#---------#---------#---------#
----#---------#---------#---------#---------#---------#---------#---------#---------#---------#-----
------#---------#---------#---------#---------#---------#---------#---------#---------#---------#---
#---------#---------#---------#---------#---------#---------#---------#---------#---------#---------
##-#--#-#-##-#--#-#-##-#--#-#-##-#--#-#-##-#--#-#-##-#--#-#-##-#--#-#-##-#--#-#-##-#--#-#-##-#--#-#-
---###-------###-------###-------###-------###-------###-------###-------###-------###-------###----
-#-#-------#-#-------#-#-------#-#-------#-#-------#-#-------#-#-------#-#-------#-#-------#-#------
---#---#-----#---#-----#---#-----#---#-----#---#-----#---#-----#---#-----#---#-----#---#-----#---#--
##-------###-------###-------###-------###-------###-------###-------###-------###-------###-------#
---#-##--#---#-##--#---#-##--#---#-##--#---#-##--#---#-##--#---#-##--#---#-##--#---#-##--#---#-##--#
---------#---------#---------#---------#---------#---------#---------#---------#---------#---------#
----#---------#---------#---------#---------#---------#---------#---------#---------#---------#-----
------#---------#---------#---------#---------#---------#---------#---------#---------#---------#---
#---------#---------#---------#---------#---------#---------#---------#---------#---------#---------
##-#--#-#-##-#--#-#-##-#--#-#-##-#--#-#-##-#--#-#-##-#--#-#-##-#--#-#-##-#--#-#-##-#--#-#-##-#--#-#-
---###-------###-------###-------###-------###-------###-------###-------###-------###-------###----
-#-#-------#-#-------#-#-------#-#-------#-#-------#-#-------#-#-------#-#-------#-#-------#-#------
---#---#-----#---#-----#---#-----#---#-----#---#-----#---#-----#---#-----#---#-----#---#-----#---#--
##-------###-------###-------###-------###-------###-------###-------###-------###-------###-------#
---#-##--#---#-##--#---#-##--#---#-##--#---#-##--#---#-##--#---#-##--#---#-##--#---#-##--#---#-##--#
---------#---------#---------#---------#---------#---------#---------#---------#---------#---------#
----#---------#---------#---------#---------#---------#---------#---------#---------#---------#-----
------#---------#---------#---------#---------#---------#---------#---------#---------#---------#---
#---------#---------#---------#---------#---------#---------#---------#---------#---------#---------
