#----#----#----#----#----#----#----#----#----#----#----#----#----#----#----#----#----#----#----#----
--#-##-#----#-##-#----#-##-#----#-##-#----#-##-#----#-##-#----#-##-#----#-##-#----#-##-#----#-##-#--
-#---------#---------#---------#---------#---------#---------#---------#---------#---------#--------
-#------#--#------#--#------#--#------#--#------#--#------#--#------#--#------#--#------#--#------#-
#---------#---------#---------#---------#---------#---------#---------#---------#---------#---------
--#---------#---------#---------#---------#---------#---------#---------#---------#---------#-------
-##-----##-##-----##-##-----##-##-----##-##-----##-##-----##-##-----##-##-----##-##-----##-##-----##
-----#---#-----#---#-----#---#-----#---#-----#---#-----#---#-----#---#-----#---#-----#---#-----#---#
#---#---###---#---###---#---###---#---###---#---###---#---###---#---###---#---###---#---###---#---##
--###-#-----###-#-----###-#-----###-#-----###-#-----###-#-----###-#-----###-#-----###-#-----###-#---
#----#----#----#----#----#----#----#----#----#----#----#----#----#----#----#----#----#----#----#----
--#-##-#----#-##-#----#-##-#----#-##-#----#-##-#----#-##-#----#-##-#----#-##-#----#-##-#----#-##-#--
-#---------#---------#---------#---------#---------#---------#---------#---------#---------#--------
-#------#--#------#--#------#--#------#--#------#--#------#--#------#--#------#--#------#--#------#-
#---------#---------#---------#---------#---------#---------#---------#---------#---------#---------
--#---------#---------#---------#---------#---------#---------#---------#---------#---------#-------
-##-----##-##-----##-##-----##-##-----##-##-----##-##-----##-##-----##-##-----##-##-----##-##-----##
-----#---#-----#---#-----#---#-----#---#-----#---#-----#---#-----#---#-----#---#-----#---#-----#---#
#---#---###---#---###---#---###---#---###---#---###---#---###---#---###---#---###---#---###---#---##
--###-#-----###-#-----###-#-----###-#-----###-#-----###-#-----###-#-----###-#-----###-#-----###-#---
#----#----#----#----#----#----#----#----#----#----#----#----#----#----#----#----#----#----#----#----
--#-##-#----#-##-#----#-##-#----#-##-#----#-##-#----#-##-#----#-##-#----#-##-#----#-##-#----#-##-#--
-#---------#---------#---------#---------#---------#---------#---------#---------#---------#--------
-#------#--#------#--#------#--#------#--#------#--#------#--#------#--#------#--#------#--#------#-
#---------#---------#---------#---------#---------#---------#---------#---------#---------#---------
--#---------#---------#---------#---------#---------#---------#---------#---------#---------#-------
-##-----##-##-----##-##-----##-##-----##-##-----##-##-----##-##-----##-##-----##-##-----##-##-----##
-----#---#-----#---#-----#---#-----#---#-----#---#-----#---#-----#---#-----#---#-----#---#-----#---#
#---#---###---#---###---#---###---#---###---#---###---#---###---#---###---#---###---#---###---#---##
--###-#-----###-#-----###-#-----###-#-----###-#-----###-#-----###-#-----###-#-----###-#-----###-#---
#----#----#----#----#----#----#----#----#----#----#----#----#----#----#----#----#----#----#----#----
--#-##-#----#-##-#----#-##-#----#-##-#----#-##-#----#-##-#----#-##-#----#-##-#----#-##-#----#-##-#--
-#---------#---------#---------#---------#---------#---------#---------#---------#---------#--------
-#------#--#------#--#------#--#------#--#------#--#------#--#------#--#------#--#------#--#------#-
#---------#---------#---------#---------#---------#---------#---------#---------#---------#---------
--#---------#---------#---------#---------#---------#---------#---------#---------#---------#-------
-##-----##-##-----##-##-----##-##-----##-##-----##-##-----##-##-----##-##-----##-##-----##-##-----##
-----#---#-----#---#-----#---#-----#---#-----#---#-----#---#-----#---#-----#---#-----#---#-----#---#
#---#---###---#---###---#---###---#---###---#---###---#---###---#---###---#---###---#---###---#---##
--###-#-----###-#-----###-#-----###-#-----###-#-----###-#-----###-#-----###-#-----###-#-----###-#---
#----#----#----#----#----#----#----#----#----#----#----#----#----#----#----#----#----#----#----#----
--#-##-#----#-##-#----#-##-#----#-##-#----#-##-#----#-##-#----#-##-#----#-##-#----#-##-#----#-##-#--
-#---------#---------#---------#---------#---------#---------#---------#---------#---------#--------
-#------#--#------#--#------#--#------#--#------#--#------#--#------#--#------#--#------#--#------#-
#---------#---------#S--------#---------#---------#---------#---------#---------#---------#---------
--#---------#---------#---------#---------#---------#---------#---------#---------#---------#-------
-##-----##-##-----##-##-----##-##-----##-##-----##-##-----##-##-----##-##-----##-##-----##-##-----##
-----#---#-----#---#-----#---#-----#---#-----#---#-----#---#-----#---#-----#---#-----#---#-----#---#
#---#---###---#---###---#---###---#---###---#---###---#---###---#---###---#---###---#---###---#---##
--###-#-----###-#-----###-#-----###-#-----###-#-----###-#-----###-#-----###-#-----###-#-----###-#---
#----#----#----#----#----#----#----#----#----#----#----#----#----#----#----#----#----#----#----#----
--#-##-#----#-##-#----#-##-#----#-##-#----#-##-#----#-##-#----#-##-#----#-##-#----#-##-#----#-##-#--
-#---------#---------#---------#---------#---------#---------#---------#---------#---------#--------
-#------#--#------#--#------#--#------#--#------#--#------#--#------#--#------#--#------#--#------#-
#---------#---------#---------#---------#---------#---------#---------#---------#---------#---------
--#---------#---------#---------#---------#---------#---------#---------#---------#---------#-------
-##-----##-##-----##-##-----##-##-----##-##-----##-##-----##-##-----##-##-----##-##-----##-##-----##
-----#---#-----#---#-----#---#-----#---#-----#---#-----#---#-----#---#-----#---#-----#---#-----#---#
#---#---###---#---###---#---###---#---###---#---###---#---###---#---###---#---###---#---###---#---##
--###-#-----###-#-----###-#-----###-#-----###-#-----###-#-----###-#-----###-#-----###-#-----###-#---
#----#----#----#----#----#----#----#----#----#----#----#----#----#----#----#----#----#----#----#----
--#-##-#----#-##-#----#-##-#----#-##-#----#-##-#----#-##-#----#-##-#----#-##-#----#-##-#----#-##-#--
-#---------#---------#---------#---------#---------#---------#---------#---------#---------#--------
-#------#--#------#--#------#--#------#--#------#--#------#--#------#--#------#--#------#--#------#-
#---------#---------#---------#---------#---------#---------#---------#---------#---------#---------
--#---------#---------#---------#---------#---------#---------#---------#---------#---------#-------
-##-----##-##-----##-##-----##-##-----##-##-----##-##-----##-##-----##-##-----##-##-----##-##-----##
-----#---#-----#---#-----#---#-----#---#-----#---#-----#---#-----#---#-----#---#-----#---#-----#---#
#---#---###---#---###---#---###---#---###---#---###---#---###---#---###---#---###---#---###---#---##
--###-#-----###-#-----###-#-----###-#-----###-#-----###-#-----###-#-----###-#-----###-#-----###-#---
#----#----#----#----#----#----#----#----#----#----#----#----#----#----#----#----#----#----#----#----
--#-##-#----#-##-#----#-##-#----#-##-#----#-##-#----#-##-#----#-##-#----#-##-#----#-##-#----#-##-#--
-#---E-----#---------#---------#---------#---------#---------#---------#---------#---------#--------
-#------#--#------#--#------#--#------#--#------#--#------#--#------#--#------#--#------#--#------#-
#---------#---------#---------#---------#---------#---------#---------#---------#---------#---------
--#---------#---------#---------#---------#---------#---------#---------#---------#---------#-------
-##-----##-##-----##-##-----##-##-----##-##-----##-##-----##-##-----##-##-----##-##-----##-##-----##
-----#---#-----#---#-----#---#-----#---#-----#---#-----#---#-----#---#-----#---#-----#---#-----#---#
#---#---###---#---###---#---###---#---###---#---###---#---###---#---###---#---###---#---###---#---##
--###-#-----###-#-----###-#-----###-#-----###-#-----###-#-----###-#-----###-#-----###-#-----###-#---
#----#----#----#----#----#----#----#----#----#----#----#----#----#----#----#----#----#----#----#----
--#-##-#----#-##-#----#-##-#----#-##-#----#-##-#----#-##-#----#-##-#----#-##-#----#-##-#----#-##-#--
-#---------#---------#---------#---------#---------#---------#---------#---------#---------#--------
-#------#--#------#--#------#--#------#--#------#--#------#--#------#--#------#--#------#--#------#-
#---------#---------#---------#---------#---------#---------#---------#---------#---------#---------
--#---------#---------#---------#---------#---------#---------#---------#---------#---------#-------
-##-----##-##-----##-##-----##-##-----##-##-----##-##-----##-##-----##-##-----##-##-----##-##-----##
-----#---#-----#---#-----#---#-----#---#-----#---#-----#---#-----#---#-----#---#-----#---#-----#---#
#---#---###---#---###---#---###---#---###---#---###---#---###---#---###---#---###---#---###---#---##
--###-#-----###-#-----###-#-----###-#-----###-#-----###-#-----###-#-----###-#-----###-#-----###-#---
#----#----#----#----#----#----#----#----#----#----#----#----#----#----#----#----#----#----#----#----
--#-##-#----#-##-#----#-##-#----#-##-#----#-##-#----#-##-#----#-##-#----#-##-#----#-##-#----#-##-#--
-#---------#---------#---------#---------#---------#---------#---------#---------#---------#--------
-#------#--#------#--#------#--#------#--#------#--#------#--#------#--#------#--#------#--#------#-
#---------#---------#---------#---------#---------#---------#---------#---------#---------#---------
--#---------#---------#---------#---------#---------#---------#---------#---------#---------#-------
-##-----##-##-----##-##-----##-##-----##-##-----##-##-----##-##-----##-##-----##-##-----##-##-----##
-----#---#-----#---#-----#---#-----#---#-----#---#-----#---#-----#---#-----#---#-----#---#-----#---#
#---#---###---#---###---#---###---#---###---#---###---#---###---#---###---#---###---#---###---#---##
--###-#-----###-#-----###-#-----###-#-----###-#-----###-#-----###-#-----###-#-----###-#-----###-#---
