----#---------#---------#---------#---------#---------#---------#---------#---------#---------#-----
#--#------#--#------#--#------#--#------#--#------#--#------#--#------#--#------#--#------#--#------
--#--#--##--#--#--##--#--#--##--#--#--##--#--#--##--#--#--##--#--#--##--#--#--##--#--#--##--#--#--##
------#---------#---------#---------#---------#---------#---------#---------#---------#---------#---
--##--#--#--##--#--#--##--#--#--##--#--#--##--#--#--##--#--#--##--#--#--##--#--#--##--#--#--##--#--#
-#--#--#-#-#--#--#-#-#--#--#-#-#--#--#-#-#--#--#-#-#--#--#-#-#--#--#-#-#--#--#-#-#--#--#-#-#--#--#-#
-#---------#---------#---------#---------#---------#---------#---------#---------#---------#--------
-##--#-#-#-##--#-#-#-##--#-#-#-##--#-#-#-##--#-#-#-##--#-#-#-##--#-#-#-##--#-#-#-##--#-#-#-##--#-#-#
-#-#-------#-#-------#-#-------#-#-------#-#-------#-#-------#-#-------#-#-------#-#-------#-#------
##---#-#--##---#-#--##---#-#--##---#-#--##---#-#--##---#-#--##---#-#--##---#-#--##---#-#--##---#-#--
----#---------#---------#---------#---------#---------#---------#---------#---------#---------#-----
#--#------#--#------#--#------#--#------#--#------#--#------#--#------#--#------#--#------#--#------
--#--#--##--#--#--##--#--#--##--#--#--##--#--#--##--#--#--##--#--#--##--#--#--##--#--#--##--#--#--##
------#---------#---------#---------#---------#---------#---------#---------#---------#---------#---
--##--#--#--##--#--#--##--#--#--##--#--#--##--#--#--##--#--#--##--#--#--##--#--#--##--#--#--##--#--#
-#--#--#-#-#--#--#-#-#--#--#-#-#--#--#-#-#--#--#-#-#--#--#-#-#--#--#-#-#--#--#-#-#--#--#-#-#--#--#-#
-#---------#---------#---------#---------#---------#---------#---------#---------#---------#--------
-##--#-#-#-##--#-#-#-##--#-#-#-##--#-#-#-##--#-#-#-##--#-#-#-##--#-#-#-##--#-#-#-##--#-#-#-##--#-#-#
-#-#-------#-#-------#-#-------#-#-------#-#----S--#-#-------#-#-------#-#-------#-#-------#-#------
##---#-#--##---#-#--##---#-#--##---#-#--##---#-#--##---#-#--##---#-#--##---#-#--##---#-#--##---#-#--
----#---------#---------#---------#---------#---------#---------#---------#---------#---------#-----
#--#------#--#------#--#------#--#------#--#------#--#------#--#------#--#------#--#------#--#------
--#--#--##--#--#--##--#--#--##--#--#--##--#--#--##--#--#--##--#--#--##--#--#--##--#--#--##--#--#--##
------#---------#---------#---------#---------#---------#---------#---------#---------#---------#---
--##--#--#--##--#--#--##--#--#--##--#--#--##--#--#--##--#--#--##--#--#--##--#--#--##--#--#--##--#--#
-#--#--#-#-#--#--#-#-#--#--#-#-#--#--#-#-#--#--#-#-#--#--#-#-#--#--#-#-#--#--#-#-#--#--#-#-#--#--#-#
-#---------#---------#---------#---------#---------#---------#---------#---------#---------#--------
-##--#-#-#-##--#-#-#-##--#-#-#-##--#-#-#-##--#-#-#-##--#-#-#-##--#-#-#-##--#-#-#-##--#-#-#-##--#-#-#
-#-#-------#-#-------#-#-------#-#-------#-#-------#-#-------#-#-------#-#-------#-#-------#-#------
##---#-#--##---#-#--##---#-#--##---#-#--##---#-#--##---#-#--##---#-#--##---#-#--##---#-#--##---#-#--
----#---------#---------#---------#---------#---------#---------#---------#---------#---------#-----
#--#------#--#------#--#------#--#------#--#------#--#------#--#------#--#------#--#------#--#------
--#--#--##--#--#--##--#--#--##--#--#--##--#--#--##--#--#--##--#--#--##--#--#--##--#--#--##--#--#--##
------#---------#---------#---------#---------#---------#---------#---------#---------#---------#---
--##--#--#--##--#--#--##--#--#--##--#--#--##--#--#--##--#--#--##--#--#--##--#--#--##--#--#--##--#--#
-#--#--#-#-#--#--#-#-#--#--#-#-#--#--#-#-#--#--#-#-#--#--#-#-#--#--#-#-#--#--#-#-#--#--#-#-#--#--#-#
-#---------#---------#---------#---------#---------#---------#---------#---------#---------#--------
-##--#-#-#-##--#-#-#-##--#-#-#-##--#-#-#-##--#-#-#-##--#-#-#-##--#-#-#-##--#-#-#-##--#-#-#-##--#-#-#
-#-#-------#-#-------#-#-------#-#-------#-#-------#-#-------#-#-------#-#-------#-#-------#-#------
##---#-#--##---#-#--##---#-#--##---#-#--##---#-#--##---#-#--##---#-#--##---#-#--##---#-#--##---#-#--
----#---------#---------#---------#---------#---------#---------#---------#---------#---------#-----
#--#------#--#------#--#------#--#------#--#------#--#------#--#------#--#------#--#------#--#------
--#--#--##--#--#--##--#--#--##--#--#--##--#--#--##--#--#--##--#--#--##--#--#--##--#--#--##--#--#--##
------#---------#---------#---------#---------#---------#---------#---------#---------#---------#---
--##--#--#--##--#--#--##--#--#--##--#--#--##--#--#--##--#--#--##--#--#--##--#--#--##--#--#--##--#--#
-#--#--#-#-#--#--#-#-#--#--#-#-#--#--#-#-#--#--#-#-#--#--#-#-#--#--#-#-#--#--#-#-#--#--#-#-#--#--#-#
-#---------#---------#---------#---------#---------#---------#---------#---------#---------#--------
-##--#-#-#-##--#-#-#-##--#-#-#-##--#-#-#-##--#-#-#-##--#-#-#-##--#-#-#-##--#-#-#-##--#-#-#-##--#-#-#
-#-#-------#-#-------#-#-------#-#-------#-#-------#-#-------#-#-------#-#-------#-#-------#-#------
##---#-#--##---#-#--##---#-#--##---#-#--##---#-#--##---#-#--##---#-#--##---#-#--##---#-#--##---#-#--
----#---------#---------#---------#---------#---------#---------#---------#---------#---------#-----
#--#------#--#------#--#------#--#------#--#------#--#------#--#------#--#------#--#------#--#------
--#--#--##--#--#--##--#--#--##--#--#--##--#--#--##--#--#--##--#--#--##--#--#--##--#--#--##--#--#--##
------#---------#---------#---------#---------#---------#---------#---------#---------#---------#---
--##--#--#--##--#--#--##--#--#--##--#--#--##--#--#--##--#--#--##--#--#--##--#--#--##--#--#--##--#--#
-#--#--#-#-#--#--#-#-#--#--#-#-#--#--#-#-#--#--#-#-#--#--#-#-#--#--#-#-#--#--#-#-#--#--#-#-#--#--#-#
-#---------#---------#---------#---------#---------#---------#---------#---------#---------#--------
-##--#-#-#-##--#-#-#-##--#-#-#-##--#-#-#-##--#-#-#-##--#-#-#-##--#-#-#-##--#-#-#-##--#-#-#-##--#-#-#
-#-#-------#-#-------#-#-------#-#-------#-#-------#-#-------#-#-------#-#-------#-#-------#-#------
##---#-#--##---#-#--##---#-#--##---#-#--##---#-#--##---#-#--##---#-#--##---#-#--##---#-#--##---#-#--
----#---------#---------#---------#---------#---------#---------#---------#---------#---------#-----
#--#------#--#------#--#------#--#------#--#------#--#------#--#------#--#------#--#------#--#------
--#--#--##--#--#--##--#--#--##--#--#--##--#--#--##--#--#--##--#--#--##--#--#--##--#--#--##--#--#--##
------#---------#---------#---------#---------#---------#---------#---------#---------#---------#---
--##--#--#--##--#--#--##--#--#--##--#--#--##--#--#--##--#--#--##--#--#--##--#--#--##--#--#--##--#--#
-#--#--#-#-#--#--#-#-#--#--#-#-#--#--#-#-#--#--#-#-#--#--#-#-#--#--#-#-#--#--#-#-#--#--#-#-#--#--#-#
-#---------#---------#---------#---------#---------#---------#---------#---------#---------#--------
-##--#-#-#-##--#-#-#-##--#-#-#-##--#-#-#-##--#-#-#-##--#-#-#-##--#-#-#-##--#-#-#-##--#-#-#-##--#-#-#
-#-#-------#-#-------#-#-------#-#-------#-#-------#-#-------#-#-------#-#-------#-#-------#-#------
##---#-#--##---#-#--##---#-#--##---#-#--##---#-#--##---#-#--##---#-#--##---#-#--##---#-#--##---#-#--
----#---------#---------#---------#---------#---------#---------#---------#---------#---------#-----
#--#------#--#------#--#------#--#------#--#------#--#------#--#------#--#------#--#------#--#------
--#--#--##--#--#--##--#--#--##--#--#--##--#--#--##--#--#--##--#--#--##--#--#--##--#--#--##--#--#--##
------#---------#---------#---------#---------#---------#---------#---------#---------#---------#---
--##--#--#--##--#--#--##--#--#--##--#--#--##--#--#--##--#--#--##--#--#--##--#--#--##--#--#--##--#--#
-#--#--#-#-#--#--#-#-#--#--#-#-#--#--#-#-#--#--#-#-#--#--#-#-#--#--#-#-#--#--#-#-#--#--#-#-#--#--#-#
-#---------#---------#---------#---------#---------#---------#---------#---------#---------#--------
-##--#-#-#-##--#-#-#-##--#-#-#-##-E#-#-#-##--#-#-#-##--#-#-#-##--#-#-#-##--#-#-#-##--#-#-#-##--#-#-#
-#-#-------#-#-------#-#-------#-#-------#-#-------#-#-------#-#-------#-#-------#-#-------#-#------
##---#-#--##---#-#--##---#-#--##---#-#--##---#-#--##---#-#--##---#-#--##---#-#--##---#-#--##---#-#--
----#---------#---------#---------#---------#---------#---------#---------#---------#---------#-----
#--#------#--#------#--#------#--#------#--#------#--#------#--#------#--#------#--#------#--#------
--#--#--##--#--#--##--#--#--##--#--#--##--#--#--##--#--#--##--#--#--##--#--#--##--#--#--##--#--#--##
------#---------#---------#---------#---------#---------#---------#---------#---------#---------#---
--##--#--#--##--#--#--##--#--#--##--#--#--##--#--#--##--#--#--##--#--#--##--#--#--##--#--#--##--#--#
-#--#--#-#-#--#--#-#-#--#--#-#-#--#--#-#-#--#--#-#-#--#--#-#-#--#--#-#-#--#--#-#-#--#--#-#-#--#--#-#
-#---------#---------#---------#---------#---------#---------#---------#---------#---------#--------
-##--#-#-#-##--#-#-#-##--#-#-#-##--#-#-#-##--#-#-#-##--#-#-#-##--#-#-#-##--#-#-#-##--#-#-#-##--#-#-#
-#-#-------#-#-------#-#-------#-#-------#-#-------#-#-------#-#-------#-#-------#-#-------#-#------
##---#-#--##---#-#--##---#-#--##---#-#--##---#-#--##---#-#--##---#-#--##---#-#--##---#-#--##---#-#--
----#---------#---------#---------#---------#---------#---------#---------#---------#---------#-----
#--#------#--#------#--#------#--#------#--#------#--#------#--#------#--#------#--#------#--#------
--#--#--##--#--#--##--#--#--##--#--#--##--#--#--##--#--#--##--#--#--##--#--#--##--#--#--##--#--#--##
------#---------#---------#---------#---------#---------#---------#---------#---------#---------#---
--##--#--#--##--#--#--##--#--#--##--#--#--##--#--#--##--#--#--##--#--#--##--#--#--##--#--#--##--#--#
-#--#--#-#-#--#--#-#-#--#--#-#-#--#--#-#-#--#--#-#-#--#--#-#-#--#--#-#-#--#--#-#-#--#--#-#-#--#--#-#
-#---------#---------#---------#---------#---------#---------#---------#---------#---------#--------
-##--#-#-#-##--#-#-#-##--#-#-#-##--#-#-#-##--#-#-#-##--#-#-#-##--#-#-#-##--#-#-#-##--#-#-#-##--#-#-#
-#-#-------#-#-------#-#-------#-#-------#-#-------#-#-------#-#-------#-#-------#-#-------#-#------
##---#-#--##---#-#--##---#-#--##---#-#--##---#-#--##---#-#--##---#-#--##---#-#--##---#-#--##---#-#--
