-#----#-#--#----#-#--#----#-#--#----#-#--#----#-#--#----#-#--#----#-#--#----#-#--#----#-#--#----#-#-
----#---------#---------#---------#---------#---------#---------#---------#---------#---------#-----
##----##-###----##-###----##-###----##-###----##-###----##-###--E-##-###----##-###----##-###----##-#
#---------#---------#---------#---------#---------#---------#---------#---------#---------#---------
----------------------------------------------------------------------------------------------------
-##-#----#-##-#----#-##-#----#-##-#----#-##-#----#-##-#----#-##-#----#-##-#----#-##-#----#-##-#----#
##--#-#---##--#-#---##--#-#---##--#-#---##--#-#---##--#-#---##--#-#---##--#-#---##--#-#---##--#-#---
--------#---------#---------#---------#---------#---------#---------#---------#---------#---------#-
----------------------------------------------------------------------------------------------------
--#-#----#--#-#----#--#-#----#--#-#----#--#-#----#--#-#----#--#-#----#--#-#----#--#-#----#--#-#----#
-#----#-#--#----#-#--#----#-#--#----#-#--#----#-#--#----#-#--#----#-#--#----#-#--#----#-#--#----#-#-
----#---------#---------#---------#---------#---------#---------#---------#---------#---------#-----
##----##-###----##-###----##-###----##-###----##-###----##-###----##-###----##-###----##-###----##-#
#---------#---------#---------#---------#---------#---------#---------#---------#---------#---------
----------------------------------------------------------------------------------------------------
-##-#----#-##-#----#-##-#----#-##-#----#-##-#----#-##-#----#-##-#----#-##-#----#-##-#----#-##-#----#
##--#-#---##--#-#---##--#-#---##--#-#---##--#-#---##--#-#---##--#-#---##--#-#---##--#-#---##--#-#---
--------#---------#---------#---------#---------#---------#---------#---------#---------#---------#-
----------------------------------------------------------------------------------------------------
--#-#----#--#-#----#--#-#----#--#-#----#--#-#----#--#-#----#--#-#----#--#-#----#--#-#----#--#-#----#
-#----#-#--#----#-#--#----#-#--#----#-#--#----#-#--#----#-#--#----#-#--#----#-#--#----#-#--#----#-#-
----#---------#---------#---------#---------#---------#---------#---------#---------#---------#-----
##----##-###----##-###----##-###----##-###----##-###----##-###----##-###----##-###----##-###----##-#
#---------#---------#---------#---------#---------#---------#---------#---------#---------#---------
----------------------------------------------------------------------------------------------------
-##-#----#-##-#----#-##-#----#-##-#----#-##-#----#-##-#----#-##-#----#-##-#----#-##-#----#-##-#----#
##--#-#---##--#-#---##--#-#---##--#-#---##--#-#---##--#-#---##--#-#---##--#-#---##--#-#---##--#-#---
--------#---------#---------#---------#---------#---------#---------#---------#---------#---------#-
----------------------------------------------------------------------------------------------------
--#-#----#--#-#----#--#-#----#--#-#----#--#-#----#--#-#----#--#-#----#--#-#----#--#-#----#--#-#----#
-#----#-#--#----#-#--#----#-#--#----#-#--#----#-#--#----#-#--#----#-#--#----#-#--#----#-#--#----#-#-
----#---------#---------#---------#---------#---------#---------#---------#---------#---------#-----
##----##-###----##-###----##-###----##-###----##-###----##-###----##-###----##-###----##-###----##-#
#---------#---------#---------#---------#---------#---------#---------#---------#---------#---------
----------------------------------------------------------------------------------------------------
-##-#----#-##-#----#-##-#----#-##-#----#-##-#----#-##-#----#-##-#----#-##-#----#-##-#----#-##-#----#
##--#-#---##--#-#---##--#-#---##--#-#---##--#-#---##--#-#---##--#-#---##--#-#---##--#-#---##--#-#---
--------#---------#---------#---------#---------#---------#---------#---------#---------#---------#-
----------------------------------------------------------------------------------------------------
--#-#----#--#-#----#--#-#----#--#-#----#--#-#----#--#-#----#--#-#----#--#-#----#--#-#----#--#-#----#
-#----#-#--#----#-#--#----#-#--#----#-#--#----#-#--#----#-#--#----#-#--#----#-#--#----#-#--#----#-#-
----#---------#---------#---------#---------#---------#---------#---------#---------#---------#-----
##----##-###----##-###----##-###----##-###----##-###----##-###----##-###----##-###----##-###----##-#
#---------#---------#---------#---------#---------#---------#---------#---------#---------#---------
----------------------------------------------------------------------------------------------------
-##-#----#-##-#----#-##-#----#-##-#----#-##-#----#-##-#----#-##-#----#-##-#----#-##-#----#-##-#----#
##--#-#---##--#-#---##--#-#---##--#-#---##--#-#---##--#-#---##--#-#---##--#-#---##--#-#---##--#-#---
--------#---------#---------#---------#---------#---------#---------#---------#---------#---------#-
----------------------------------------------------------------------------------------------------
--#-#----#--#-#----#--#-#----#--#-#----#--#-#----#--#-#----#--#-#----#--#-#----#--#-#----#--#-#----#
-#----#-#--#----#-#--#----#-#--#----#-#--#----#-#--#----#-#--#----#-#--#----#-#--#----#-#--#----#-#-
----#---------#---------#---------#---------#---------#---------#---------#---------#---------#-----
##----##-###----##-###----##-###----##-###----##-###----##-###----##-###----##-###----##-###----##-#
#---------#---------#---------#---------#---------#---------#---------#---------#---------#---------
----------------------------------------------------------------------------------------------------
-##-#----#-##-#----#-##-#----#-##-#----#-##-#----#-##-#----#-##-#----#-##-#----#-##-#----#-##-#----#
##--#-#---##--#-#---##--#-#---##--#-#---##--#-#---##--#-#---##--#-#---##--#S#---##--#-#---##--#-#---
--------#---------#---------#---------#---------#---------#---------#---------#---------#---------#-
----------------------------------------------------------------------------------------------------
--#-#----#--#-#----#--#-#----#--#-#----#--#-#----#--#-#----#--#-#----#--#-#----#--#-#----#--#-#----#
-#----#-#--#----#-#--#----#-#--#----#-#--#----#-#--#----#-#--#----#-#--#----#-#--#----#-#--#----#-#-
----#---------#---------#---------#---------#---------#---------#---------#---------#---------#-----
##----##-###----##-###----##-###----##-###----##-###----##-###----##-###----##-###----##-###----##-#
#---------#---------#---------#---------#---------#---------#---------#---------#---------#---------
----------------------------------------------------------------------------------------------------
-##-#----#-##-#----#-##-#----#-##-#----#-##-#----#-##-#----#-##-#----#-##-#----#-##-#----#-##-#----#
##--#-#---##--#-#---##--#-#---##--#-#---##--#-#---##--#-#---##--#-#---##--#-#---##--#-#---##--#-#---
--------#---------#---------#---------#---------#---------#---------#---------#---------#---------#-
----------------------------------------------------------------------------------------------------
--#-#----#--#-#----#--#-#----#--#-#----#--#-#----#--#-#----#--#-#----#--#-#----#--#-#----#--#-#----#
-#----#-#--#----#-#--#----#-#--#----#-#--#----#-#--#----#-#--#----#-#--#----#-#--#----#-#--#----#-#-
----#---------#---------#---------#---------#---------#---------#---------#---------#---------#-----
##----##-###----##-###----##-###----##-###----##-###----##-###----##-###----##-###----##-###----##-#
#---------#---------#---------#---------#---------#---------#---------#---------#---------#---------
----------------------------------------------------------------------------------------------------
-##-#----#-##-#----#-##-#----#-##-#----#-##-#----#-##-#----#-##-#----#-##-#----#-##-#----#-##-#----#
##--#-#---##--#-#---##--#-#---##--#-#---##--#-#---##--#-#---##--#-#---##--#-#---##--#-#---##--#-#---
--------#---------#---------#---------#---------#---------#---------#---------#---------#---------#-
----------------------------------------------------------------------------------------------------
--#-#----#--#-#----#--#-#----#--#-#----#--#-#----#--#-#----#--#-#----#--#-#----#--#-#----#--#-#----#
-#----#-#--#----#-#--#----#-#--#----#-#--#----#-#--#----#-#--#----#-#--#----#-#--#----#-#--#----#-#-
----#---------#---------#---------#---------#---------#---------#---------#---------#---------#-----
##----##-###----##-###----##-###----##-###----##-###----##-###----##-###----##-###----##-###----##-#
#---------#---------#---------#---------#---------#---------#---------#---------#---------#---------
----------------------------------------------------------------------------------------------------
-##-#----#-##-#----#-##-#----#-##-#----#-##-#----#-##-#----#-##-#----#-##-#----#-##-#----#-##-#----#
##--#-#---##--#-#---##--#-#---##--#-#---##--#-#---##--#-#---##--#-#---##--#-#---##--#-#---##--#-#---
--------#---------#---------#---------#---------#---------#---------#---------#---------#---------#-
----------------------------------------------------------------------------------------------------
--#-#----#--#-#----#--#-#----#--#-#----#--#-#----#--#-#----#--#-#----#--#-#----#--#-#----#--#-#----#
-#----#-#--#----#-#--#----#-#--#----#-#--#----#-#--#----#-#--#----#-#--#----#-#--#----#-#--#----#-#-
----#---------#---------#---------#---------#---------#---------#---------#---------#---------#-----
##----##-###----##-###----##-###----##-###----##-###----##-###----##-###----##-###----##-###----##-#
#---------#---------#---------#---------#---------#---------#---------#---------#---------#---------
----------------------------------------------------------------------------------------------------
-##-#----#-##-#----#-##-#----#-##-#----#-##-#----#-##-#----#-##-#----#-##-#----#-##-#----#-##-#----#
##--#-#---##--#-#---##--#-#---##--#-#---##--#-#---##--#-#---##--#-#---##--#-#---##--#-#---##--#-#---
--------#---------#---------#---------#---------#---------#---------#---------#---------#---------#-
----------------------------------------------------------------------------------------------------
--#-#----#--#-#----#--#-#----#--#-#----#--#-#----#--#-#----#--#-#----#--#-#----#--#-#----#--#-#----#
