--------#---------#---------#---------#---------#---------#---------#---------#---------#---------#-
-----##--------##--------##--------##--------##--------##--------##--------##--------##--------##---
-#-#-----#-#-#-----#-#-#-----#-#-#-----#-#-#-----#-#-#-----#-#-#-----#-#-#-----#-#-#-----#-#-#-----#
#-#-------#-#-------#-#-------#-#-------#-#-------#-#-------#-#-------#-#-------#-#-------#-#-------
-##---##-#-##---##-#-##---##-#-##---##-#-##---##-#-##---##-#-##---##-#-##---##-#-##---##-#-##---##-#
#----#----#----#----#----#----#----#----#----#----#----#----#----#----#----#----#----#----#----#----
-#---#-----#---#-----#---#-----#---#-----#---#-----#---#-----#---#-----#---#-----#---#-----#---#----
---###--#----###--#----###--#----###--#----###--#----###--#----###--#----###--#----###--#----###--#-
#-----#---#-----#---#-----#---#-----#---#-----#---#-----#---#-----#---#-----#---#-----#---#-----#---
#----###-##----###-##----###-##----###-##----###-##----###-##----###-##----###-##----###-##----###-#
--------#---------#---------#---------#---------#---------#---------#---------#---------#---------#-
-----##--------##--------##--------##--------##--------##--------##--------##--------##--------##---
-#-#-----#-#-#-----#-#-#-----#-#-#-----#-#-#-----#-#-#-----#-#-#-----#-#-#-----#-#-#-----#-#-#-----#
#-#-------#-#-------#-#-------#-#-------#-#-------#-#-------#-#-------#-#-------#-#-------#-#-------
-##---##-#-##---##-#-##---##-#-##---##-#-##---##-#-##---##-#-##---##-#-##---##-#-##---##-#-##---##-#
#----#----#----#----#----#----#----#----#----#----#----#----#----#----#----#----#----#----#----#----
-#---#-----#---#-----#---#-----#---#-----#---#-----#---#-----#---#-----#---#-----#---#-----#---#----
---###--#----###--#----###--#----###--#----###--#----###--#----###--#----###--#----###--#----###--#-
#-----#---#-----#---#-----#---#-----#---#-----#---#-----#---#-----#---#-----#---#-----#---#-----#---
#----###-##----###-##----###-##----###-##----###-##----###-##----###-##----###-##----###-##----###-#
--------#---------#---------#---------#---------#---------#---------#---------#---------#---------#-
-----##--------##--------##--------##--------##--------##--------##--------##--------##--------##---
-#-#-----#-#-#---E-#-#-#-----#-#-#-----#-#-#-----#-#-#-----#-#-#-----#-#-#-----#-#-#-----#-#-#-----#
#-#-------#-#-------#-#-------#-#-------#-#-------#-#-------#-#-------#-#-------#-#-------#-#-------
-##---##-#-##---##-#-##---##-#-##---##-#-##---##-#-##---##-#-##---##-#-##---##-#-##---##-#-##---##-#
#----#----#----#----#----#----#----#----#----#----#----#----#----#----#----#----#----#----#----#----
-#---#-----#---#-----#---#-----#---#-----#---#-----#---#-----#---#-----#---#-----#---#-----#---#----
---###--#----###--#----###--#----###--#----###--#----###--#----###--#----###--#----###--#----###--#-
#-----#---#-----#---#-----#---#-----#---#-----#---#-----#---#-----#---#-----#---#-----#---#-----#---
#----###-##----###-##----###-##----###-##----###-##----###-##----###-##----###-##----###-##----###-#
--------#---------#---------#---------#---------#---------#---------#---------#---------#---------#-
-----##--------##--------##--------##--------##--------##--------##--------##--------##--------##---
-#-#-----#-#-#-----#-#-#-----#-#-#-----#-#-#-----#-#-#-----#-#-#-----#-#-#-----#-#-#-----#-#-#-----#
#-#-------#-#-------#-#-------#-#-------#-#-------#-#-------#-#-------#-#-------#-#-------#-#-------
-##---##-#-##---##-#-##---##-#-##---##-#-##---##-#-##---##-#-##---##-#-##---##-#-##---##-#-##---##-#
#----#----#----#----#----#----#----#----#----#----#----#----#----#----#----#----#----#----#----#----
-#---#-----#---#-----#---#-----#---#-----#---#-----#---#-----#---#-----#---#-----#---#-----#---#----
---###--#----###--#----###--#----###--#----###--#----###--#----###--#----###--#----###--#----###--#-
#-----#---#-----#---#-----#---#-----#---#-----#---#-----#---#-----#---#-----#---#-----#---#-----#---
#----###-##----###-##----###-##----###-##----###-##----###-##----###-##----###-##----###-##----###-#
--------#---------#---------#---------#---------#---------#---------#---------#---------#---------#-
-----##--------##--------##--------##--------##--------##--------##--------##--------##--------##---
-#-#-----#-#-#-----#-#-#-----#-#-#-----#-#-#-----#-#-#-----#-#-#-----#-#-#-----#-#-#-----#-#-#-----#
#-#-------#-#-------#-#-------#-#-------#-#-------#-#-------#-#-------#-#-------#-#-------#-#-------
-##---##-#-##---##-#-##---##-#-##---##-#-##---##-#-##---##-#-##---##-#-##---##-#-##---##-#-##---##-#
#----#----#----#----#----#----#----#----#----#----#----#----#----#----#----#----#----#----#----#----
-#---#-----#---#-----#---#-----#---#-----#---#-----#---#-----#---#-----#---#-----#---#-----#---#----
---###--#----###--#----###--#----###--#----###--#----###--#----###--#----###--#----###--#----###--#-
#-----#---#-----#---#-----#---#-----#---#-----#---#-----#---#-----#---#-----#---#-----#---#-----#---
#----###-##----###-##----###-##----###-##----###-##----###-##----###-##----###-##----###-##----###-#
--------#---------#---------#---------#---------#---------#---------#---------#---------#---------#-
-----##--------##--------##--------##--------##--------##--------##--------##--------##--------##---
-#-#-----#-#-#-----#-#-#-----#-#-#-----#-#-#-----#-#-#-----#-#-#-----#-#-#-----#-#-#-----#-#-#-----#
#-#-------#-#-------#-#-------#-#-------#-#-------#-#-------#-#-------#-#-------#-#-------#-#-------
-##---##-#-##---##-#-##---##-#-##---##-#-##---##-#-##---##-#-##---##-#-##---##-#-##---##-#-##---##-#
#----#----#----#----#----#----#----#----#----#----#----#----#----#----#----#----#----#----#----#----
-#---#-----#---#-----#---#-----#---#-----#---#-----#---#-----#---#-----#---#-----#---#-----#---#----
---###--#----###--#----###--#----###--#----###--#----###--#----###--#----###--#----###--#----###--#-
#-----#---#-----#---#-----#---#-----#---#-----#---#-----#---#-----#---#-----#---#-----#---#-----#---
#----###-##----###-##----###-##----###-##----###-##----###-##----###-##----###-##----###-##----###-#
--------#---------#---------#---------#---------#---------#---------#---------#---------#---------#-
-----##--------##--------##--------##--------##--------##--------##--------##--------##--------##---
-#-#-----#-#-#-----#-#-#-----#-#-#-----#-#-#-----#-#-#-----#-#-#-----#-#-#-----#-#-#-----#-#-#-----#
#-#-------#-#-------#-#-------#-#-------#-#-------#-#-------#-#-------#-#-------#-#-------#-#-------
-##---##-#-##---##-#-##---##-#-##---##-#-##---##-#-##---##-#-##---##-#-##---##-#-##---##-#-##---##-#
#----#----#----#----#----#----#----#----#----#----#----#----#----#----#----#----#----#----#----#----
-#---#-----#---#-----#---#-----#---#-----#---#-----#---#-----#---#-----#---#-----#---#-----#---#----
---###--#----###--#----###--#----###--#----###--#----###--#----###--#----###--#----###--#----###--#-
#-----#---#-----#---#-----#---#-----#---#-----#---#-----#---#-----#---#-----#---#-----#---#-----#---
#----###-##----###-##----###-##----###-##----###-##----###-##----###-##----###-##----###-##----###-#
--------#---------#---------#---------#---------#---------#---------#---------#---------#---------#-
-----##--------##--------##--------##--------##--------##--------##--------##--------##--------##---
-#-#-----#-#-#-----#-#-#-----#-#-#-----#-#-#-----#-#-#-----#-#-#-----#-#-#-----#-#-#-----#-#-#-----#
#-#-------#-#-------#-#-------#-#-------#-#-------#-#-------#-#-------#-#-------#-#-------#-#-------
-##---##-#-##---##-#-##---##-#-##---##-#-##---##-#-##---##-#-##---##-#-##---##-#-##---##-#-##---##-#
#----#----#----#----#----#----#----#----#----#----#----#----#----#----#----#----#----#----#----#----
-#---#-----#---#-----#---#-----#---#-----#---#-----#---#-----#---#-----#---#-----#---#-----#---#----
---###--#----###--#----###--#----###--#----###--#----###--#----###--#----###--#----###--#----###--#-
#-----#---#-----#---#-----#---#-----#---#-----#---#-----#---#-----#---#-----#---#-----#---#-----#---
#----###-##----###-##----###-##----###-##----###-##----###-##----###-##----###-##----###-##----###-#
--------#---------#---------#---------#---------#---------#---------#---------#---------#---------#-
-----##--------##--------##--------##--------##--------##--------##--------##--------##--------##---
-#-#-----#-#-#-----#-#-#-----#-#-#-----#-#-#-----#-#-#-----#-#-#-----#-#-#-----#-#-#-----#-#-#-----#
#-#-------#-#-------#-#-------#-#-------#-#-------#-#-------#-#-------#-#-------#-#-------#-#-------
-##---##-#-##---##-#-##---##-#-##---##-#-##---##-#-##---##-#-##---##-#-##---##-#-##---##-#-##---##-#
#----#----#----#----#----#----#----#----#----#----#----#----#----#----#----#----#----#----#----#----
-#---#-----#---#-----#---#-----#---#-----#---#-----#---#-----#---#-----#---#-----#---#-----#---#----
---###--#----###--#----###--#----###--#----###--#----###--#----###--#----###--#----###--#----###--#-
#-----#---#-----#---#-----#---#-----#---#-----#---#-----#---#-----#---#-----#---#-----#---#-----#---
#----###-##----###-##----###-##----###-##----###-##----###-##----###-##----###-##----###-##----###-#
--------#---------#---------#---------#---------#---------#---------#---------#---------#---------#-
-----##--------##--------##--------##S-------##--------##--------##--------##--------##--------##---
-#-#-----#-#-#-----#-#-#-----#-#-#-----#-#-#-----#-#-#-----#-#-#-----#-#-#-----#-#-#-----#-#-#-----#
#-#-------#-#-------#-#-------#-#-------#-#-------#-#-------#-#-------#-#-------#-#-------#-#-------
-##---##-#-##---##-#-##---##-#-##---##-#-##---##-#-##---##-#-##---##-#-##---##-#-##---##-#-##---##-#
#----#----#----#----#----#----#----#----#----#----#----#----#----#----#----#----#----#----#----#----
-#---#-----#---#-----#---#-----#---#-----#---#-----#---#-----#---#-----#---#-----#---#-----#---#----
---###--#----###--#----###--#----###--#----###--#----###--#----###--#----###--#----###--#----###--#-
#-----#---#-----#---#-----#---#-----#---#-----#---#-----#---#-----#---#-----#---#-----#---#-----#---
#----###-##----###-##----###-##----###-##----###-##----###-##----###-##----###-##----###-##----###-#
