-----#---------#---------#---------#---------#---------#---------#---------#---------#---------#----
##--------##--------##--------##--------##--------##--------##--------##--------##--------##--------
--#--##-----#--##-----#--##-----#--##-----#--##-----#--##-----#--##-----#--##-----#--##-----#--##---
-#--#------#--#------#--#------#--#------#--#------#--#------#--#------#--#------#--#------#--#-----
###-------###-------###-------###-------###-------###-------###-------###-------###-------###-------
-#------#--#------#--#------#--#------#--#------#--#------#--#------#--#------#--#------#--#------#-
-#-#--#-#--#-#--#-#--#-#--#-#--#-#--#-#--#-#--#-#--#-#--#-#--#-#--#-#--#-#--#-#--#-#--#-#--#-#--#-#-
##---##--###---##--###---##--###---##--###---##--###---##--###---##--###---##--###---##--###---##--#
#---#-----#---#-----#---#-----#---#-----#---#----S#---#-----#---#-----#---#-----#---#-----#---#-----
#----#---##----#---##----#---##----#---##----#---##----#---##----#---##----#---##----#---##----#---#
-----#---------#---------#---------#---------#---------#---------#---------#---------#---------#----
##--------##--------##--------##--------##--------##--------##--------##--------##--------##--------
--#--##-----#--##-----#--##-----#--##-----#--##-----#--##-----#--##-----#--##-----#--##-----#--##---
-#--#------#--#------#--#------#--#------#--#------#--#------#--#------#--#------#--#------#--#-----
###-------###-------###-------###-------###-------###-------###-------###-------###-------###-------
-#------#--#------#--#------#--#------#--#------#--#------#--#------#--#------#--#------#--#------#-
-#-#--#-#--#-#--#-#--#-#--#-#--#-#--#-#--#-#--#-#--#-#--#-#--#-#--#-#--#-#--#-#--#-#--#-#--#-#--#-#-
##---##--###---##--###---##--###---##--###---##--###---##--###---##--###---##--###---##--###---##--#
#---#-----#---#-----#---#-----#---#-----#---#-----#---#-----#---#-----#---#-----#---#-----#---#-----
#----#---##----#---##----#---##----#---##----#---##----#---##----#---##----#---##----#---##----#---#
-----#---------#---------#---------#---------#---------#---------#---------#---------#---------#----
##--------##--------##--------##--------##--------##--------##--------##--------##--------##--------
--#--##-----#--##-----#--##-----#--##-----#--##-----#--##-----#--##-----#--##-----#--##-----#--##---
-#--#------#--#------#--#------#--#------#--#------#--#------#--#------#--#------#--#------#--#-----
###-------###-------###-------###-------###-------###-------###-------###-------###-------###-------
-#------#--#------#--#------#--#------#--#------#--#------#--#------#--#------#--#------#--#------#-
-#-#--#-#--#-#--#-#--#-#--#-#--#-#--#-#--#-#--#-#--#-#--#-#--#-#--#-#--#-#--#-#--#-#--#-#--#-#--#-#-
##---##--###---##--###---##--###---##--###---##--###---##--###---##--###---##--###---##--###---##--#
#---#-----#---#-----#---#-----#---#-----#---#-----#---#-----#---#-----#---#-----#---#-----#---#-----
#----#---##----#---##----#---##----#---##----#---##----#---##----#---##----#---##----#---##----#---#
-----#---------#---------#---------#---------#---------#---------#---------#---------#---------#----
##--------##--------##--------##--------##--------##--------##--------##--------##--------##--------
--#--##-----#--##-----#--##-----#--##-----#--##-----#--##-----#--##-----#--##-----#--##-----#--##---
-#--#------#--#------#--#------#--#------#--#------#--#------#--#------#--#------#--#------#--#-----
###-------###-------###-------###-------###-------###-------###-------###-------###-------###-------
-#------#--#------#--#------#--#------#--#------#--#------#--#------#--#------#--#------#--#------#-
-#-#--#-#--#-#--#-#--#-#--#-#--#-#--#-#--#-#--#-#--#-#--#-#--#-#--#-#--#-#--#-#--#-#--#-#--#-#--#-#-
##---##--###---##--###---##--###---##--###---##--###---##--###---##--###---##--###---##--###---##--#
#---#-----#---#-----#---#-----#---#-----#---#-----#---#-----#---#-----#---#-----#---#-----#---#-----
#----#---##----#---##----#---##----#---##----#---##----#---##----#---##----#---##----#---##----#---#
-----#---------#---------#---------#---------#---------#---------#---------#---------#---------#----
##--------##--------##--------##--------##--------##--------##--------##--------##--------##--------
--#--##-----#--##-----#--##-----#--##-----#--##-----#--##-----#--##-----#--##-----#--##-----#--##---
-#--#------#--#------#--#------#--#------#--#------#--#------#--#------#--#------#--#------#--#-----
###-------###-------###-------###-------###-------###-------###-------###-------###-------###-------
-#------#--#------#--#------#--#------#--#------#--#------#--#------#--#------#--#------#--#------#-
-#-#--#-#--#-#--#-#--#-#--#-#--#-#--#-#--#-#--#-#--#-#--#-#--#-#--#-#--#-#--#-#--#-#--#-#--#-#--#-#-
##---##--###---##--###---##--###---##--###---##--###---##--###---##--###---##--###---##--###---##--#
#---#-----#---#-----#---#-----#---#-----#---#-----#---#-----#---#-----#---#-----#---#-----#---#-----
#----#---##----#---##----#---##----#---##----#---##----#---##----#---##----#---##----#---##----#---#
-----#---------#---------#---------#---------#---------#---------#---------#---------#---------#----
##--------##--------##--------##--------##--------##--------##--------##--------##--------##--------
--#--##-----#--##-----#--##-----#--##-----#--##-----#--##-----#--##-----#--##-----#--##-----#--##---
-#--#------#--#------#--#------#--#------#--#------#--#------#--#------#--#------#--#------#--#-----
###-------###-------###-------###-------###-------###-------###-------###-------###-------###-------
-#------#--#------#--#------#--#------#--#------#--#------#--#------#--#------#--#------#--#------#-
-#-#--#-#--#-#--#-#--#-#--#-#--#-#--#-#--#-#--#-#--#-#--#-#--#-#--#-#--#-#--#-#--#-#--#-#--#-#--#-#-
##---##--###---##--###---##--###---##--###---##--###---##--###---##--###---##--###---##--###---##--#
#---#-----#---#-----#---#-----#---#-----#---#-----#---#-----#---#-----#---#-----#---#-----#---#-----
#----#---##----#---##----#---##----#---##----#---##----#---##----#---##----#---##----#---##----#---#
-----#---------#---------#---------#---------#---------#---------#---------#---------#---------#----
##--------##--------##--------##--------##--------##--------##--------##--------##--------##--------
--#--##-----#--##-----#--##-----#--##-----#--##-----#--##-----#--##-----#--##-----#--##-----#--##---
-#--#------#--#------#--#------#--#------#--#------#--#------#--#------#--#------#--#------#--#-----
###-------###-------###-------###-------###-------###-------###-------###-------###-------###-------
-#------#--#------#--#------#--#------#--#------#--#------#--#------#--#------#--#------#--#------#-
-#-#--#-#--#-#--#-#--#-#--#-#--#-#--#-#--#-#--#-#--#-#--#-#--#-#--#-#--#-#--#-#--#-#--#-#--#-#--#-#-
##---##--###---##--###---##--###---##--###---##--###---##--###---##--###---##--###---##--###---##--#
#---#-----#---#-----#---#-----#---#-----#---#-----#---#-----#---#-----#---#-----#---#-----#---#-----
#----#---##----#---##----#---##----#---##----#---##----#---##----#---##----#---##----#---##----#---#
-----#------E--#---------#---------#---------#---------#---------#---------#---------#---------#----
##--------##--------##--------##--------##--------##--------##--------##--------##--------##--------
--#--##-----#--##-----#--##-----#--##-----#--##-----#--##-----#--##-----#--##-----#--##-----#--##---
-#--#------#--#------#--#------#--#------#--#------#--#------#--#------#--#------#--#------#--#-----
###-------###-------###-------###-------###-------###-------###-------###-------###-------###-------
-#------#--#------#--#------#--#------#--#------#--#------#--#------#--#------#--#------#--#------#-
-#-#--#-#--#-#--#-#--#-#--#-#--#-#--#-#--#-#--#-#--#-#--#-#--#-#--#-#--#-#--#-#--#-#--#-#--#-#--#-#-
##---##--###---##--###---##--###---##--###---##--###---##--###---##--###---##--###---##--###---##--#
#---#-----#---#-----#---#-----#---#-----#---#-----#---#-----#---#-----#---#-----#---#-----#---#-----
#----#---##----#---##----#---##----#---##----#---##----#---##----#---##----#---##----#---##----#---#
-----#---------#---------#---------#---------#---------#---------#---------#---------#---------#----
##--------##--------##--------##--------##--------##--------##--------##--------##--------##--------
--#--##-----#--##-----#--##-----#--##-----#--##-----#--##-----#--##-----#--##-----#--##-----#--##---
-#--#------#--#------#--#------#--#------#--#------#--#------#--#------#--#------#--#------#--#-----
###-------###-------###-------###-------###-------###-------###-------###-------###-------###-------
-#------#--#------#--#------#--#------#--#------#--#------#--#------#--#------#--#------#--#------#-
-#-#--#-#--#-#--#-#--#-#--#-#--#-#--#-#--#-#--#-#--#-#--#-#--#-#--#-#--#-#--#-#--#-#--#-#--#-#--#-#-
##---##--###---##--###---##--###---##--###---##--###---##--###---##--###---##--###---##--###---##--#
#---#-----#---#-----#---#-----#---#-----#---#-----#---#-----#---#-----#---#-----#---#-----#---#-----
#----#---##----#---##----#---##----#---##----#---##----#---##----#---##----#---##----#---##----#---#
-----#---------#---------#---------#---------#---------#---------#---------#---------#---------#----
##--------##--------##--------##--------##--------##--------##--------##--------##--------##--------
--#--##-----#--##-----#--##-----#--##-----#--##-----#--##-----#--##-----#--##-----#--##-----#--##---
-#--#------#--#------#--#------#--#------#--#------#--#------#--#------#--#------#--#------#--#-----
###-------###-------###-------###-------###-------###-------###-------###-------###-------###-------
-#------#--#------#--#------#--#------#--#------#--#------#--#------#--#------#--#------#--#------#-
-#-#--#-#--#-#--#-#--#-#--#-#--#-#--#-#--#-#--#-#--#-#--#-#--#-#--#-#--#-#--#-#--#-#--#-#--#-#--#-#-
##---##--###---##--###---##--###---##--###---##--###---##--###---##--###---##--###---##--###---##--#
#---#-----#---#-----#---#-----#---#-----#---#-----#---#-----#---#-----#---#-----#---#-----#---#-----
#----#---##----#---##----#---##----#---##----#---##----#---##----#---##----#---##----#---##----#---#
