--#---#-#---#---#-#---#---#-#---#---#-#---#---#-#---#---#-#---#---#-#---#---#-#---#---#-#---#---#-#-
--------#---------#---------#---------#---------#---------#---------#---------#---------#---------#-
##-#------##-#------##-#------##-#------##-#------##-#------##-#------##-#------##-#------##-#------
-------#---------#---------#---------#---------#---------#---------#---------#---------#---------#--
---#--##-----#--##-----#--##-----#--##-----#--##-----#--##-----#--##-----#--##-----#--##-----#--##--
-#-#-###-#-#-#-###-#-#-#-###-#-#-#-###-#-#-#-###-#-#-#-###-#-#-#-###-#-#-#-###-#-#-#-###-#-#-#-###-#
--#-#---#---#-#---#---#-#---#---#-#---#---#-#---#---#-#---#---#-#---#---#-#---#---#-#---#---#-#---#-
----##--------##--------##--------##--------##--------##--------##--------##--------##--------##----
-----#---#-----#---#-----#---#-----#---#-----#---#-----#---#-----#---#-----#---#-----#---#-----#---#
---#---------#---------#---------#---------#---------#---------#---------#---------#---------#------
--#---#-#---#---#-#---#---#-#---#---#-#---#---#-#---#---#-#---#---#-#---#---#-#---#---#-#---#---#-#-
--------#---------#---------#---------#---------#---------#---------#---------#---------#---------#-
##-#------##-#------##-#------##-#------##-#------##-#------##-#------##-#------##-#------##-#------
-------#---------#---------#---------#---------#---------#---------#---------#---------#---------#--
---#--##-----#--##-----#--##-----#--##-----#--##-----#--##-----#--##-----#--##-----#--##-----#--##--
-#-#-###-#-#-#-###-#-#-#-###-#-#-#-###-#-#-#-###-#-#-#-###-#-#-#-###-#-#-#-###-#-#-#-###-#-#-#-###-#
--#-#---#---#-#---#---#-#---#---#-#---#---#-#---#---#-#---#---#-#---#---#-#---#---#-#---#---#-#---#-
----##--------##--------##--------##--------##--------##--------##--------##--------##--------##----
-----#---#-----#---#-----#---#-----#---#-----#---#-----#---#-----#---#-----#---#-----#---#-----#---#
---#---------#---------#---------#---------#---------#---------#---------#---------#---------#------
--#---#-#---#---#-#---#---#-#---#---#-#---#---#-#---#---#-#---#---#-#---#---#-#---#---#-#---#---#-#-
--------#---------#---------#---------#---------#---------#---------#---------#---------#---------#-
##-#------##-#------##-#------##-#------##-#------##-#------##-#------##-#------##-#------##-#------
-------#---------#---------#---------#---------#---------#---------#---------#---------#---------#--
---#--##-----#--##-----#--##-----#--##-----#--##-----#--##-----#--##-----#--##-----#--##-----#--##--
-#-#-###-#-#-#-###-#-#-#-###-#-#-#-###-#-#-#-###-#-#-#-###-#-#-#-###-#-#-#-###-#-#-#-###-#-#-#-###-#
--#-#---#---#-#---#---#-#---#---#-#---#---#-#---#---#-#---#---#-#---#---#-#---#---#-#---#---#-#---#-
----##--------##--------##--------##--------##--------##--------##--------##--------##--------##----
-----#---#-----#---#-----#---#-----#---#-----#---#-----#---#-----#---#-----#---#-----#---#-----#---#
---#---------#---------#---------#---------#---------#---------#---------#-------E-#---------#------
--#---#-#---#---#-#---#---#-#---#---#-#---#---#-#---#---#-#---#---#-#---#---#-#---#---#-#---#---#-#-
--------#---------#---------#---------#---------#---------#---------#---------#---------#---------#-
##-#------##-#------##-#------##-#------##-#------##-#------##-#------##-#------##-#------##-#------
-------#---------#---------#---------#---------#---------#---------#---------#---------#---------#--
---#--##-----#--##-----#--##-----#--##-----#--##-----#--##-----#--##-----#--##-----#--##-----#--##--
-#-#-###-#-#-#-###-#-#-#-###-#-#-#-###-#-#-#-###-#-#-#-###-#-#-#-###-#-#-#-###-#-#-#-###-#-#-#-###-#
--#-#---#---#-#---#---#-#---#---#-#---#---#-#---#---#-#---#---#-#---#---#-#---#---#-#---#---#-#---#-
----##--------##--------##--------##--------##--------##--------##--------##--------##--------##----
-----#---#-----#---#-----#---#-----#---#-----#---#-----#---#-----#---#-----#---#-----#---#-----#---#
---#---------#---------#---------#---------#---------#---------#---------#---------#---------#------
--#---#-#---#---#-#---#---#-#---#---#-#---#---#-#---#---#-#---#---#-#---#---#-#---#---#-#---#---#-#-
--------#---------#---------#---------#---------#---------#---------#---------#---------#---------#-
##-#------##-#------##-#------##-#------##-#------##-#------##-#------##-#------##-#------##-#------
-------#---------#---------#---------#---------#---------#---------#---------#---------#---------#--
---#--##-----#--##-----#--##-----#--##-----#--##-----#--##-----#--##-----#--##-----#--##-----#--##--
-#-#-###-#-#-#-###-#-#-#-###-#-#-#-###-#-#-#-###-#-#-#-###-#-#-#-###-#-#-#-###-#-#-#-###-#-#-#-###-#
--#-#---#---#-#---#---#-#---#---#-#---#---#-#---#---#-#---#---#-#---#---#-#---#---#-#---#---#-#---#-
----##--------##--------##--------##--------##--------##--------##--------##--------##--------##----
-----#---#-----#---#-----#---#-----#---#-----#---#-----#---#-----#---#-----#---#-----#---#-----#---#
---#---------#---------#---------#---------#---------#---------#---------#---------#---------#------
--#---#-#---#---#-#---#---#-#---#---#-#---#---#-#---#---#-#---#---#-#---#---#-#---#---#-#---#---#-#-
--------#---------#---------#---------#---------#---------#---------#---------#---------#---------#-
##-#------##-#------##-#------##-#------##-#------##-#------##-#------##-#------##-#------##-#------
-------#---------#---------#---------#---------#---------#---------#---------#---------#---------#--
---#--##-----#--##-----#--##-----#--##-----#--##-----#--##-----#--##-----#--##-----#--##-----#--##--
-#-#-###-#-#-#-###-#-#-#-###-#-#-#-###-#-#-#-###-#-#-#-###-#-#-#-###-#-#-#-###-#-#-#-###-#-#-#-###-#
--#-#---#---#-#---#---#-#---#---#-#---#---#-#---#---#-#---#---#-#---#---#-#---#---#-#---#---#-#---#-
----##--------##--------##--------##--------##--------##--------##--------##--------##--------##----
-----#---#-----#---#-----#---#-----#---#-----#---#-----#---#-----#---#-----#---#-----#---#-----#---#
---#---------#---------#---------#---------#---------#---------#---------#---------#---------#------
--#---#-#---#---#-#---#---#-#---#---#-#---#---#-#---#---#-#---#---#-#---#---#-#---#---#-#---#---#-#-
--------#---------#---------#---------#---------#---------#---------#---------#---------#---------#-
##-#------##-#------##-#------##-#------##-#------##-#------##-#------##-#------##-#------##-#------
-------#---------#---------#---------#---------#---------#---------#---------#---------#---------#--
---#--##-----#--##-----#--##-----#--##-----#--##-----#--##-----#--##-----#--##-----#--##-----#--##--
-#-#-###-#-#-#-###-#-#-#-###-#-#-#-###-#-#-#-###-#-#-#-###-#-#-#-###-#-#-#-###-#-#-#-###-#-#-#-###-#
--#-#---#---#-#---#---#-#---#---#-#---#---#-#---#---#-#---#---#-#---#---#-#---#---#-#---#---#-#---#-
----##--------##--------##--------##--------##--------##--------##--------##--------##--------##----
-----#---#-----#---#-----#---#-----#---#-----#---#-----#---#-----#---#-----#---#-----#---#-----#---#
---#---------#---------#---------#---------#---------#---------#---------#---------#---------#------
--#---#-#---#---#-#---#---#-#---#---#-#---#---#-#---#---#-#---#---#-#---#---#-#---#---#-#---#---#-#-
--------#---------#---------#---------#---------#---------#---------#---------#---------#---------#-
##-#------##-#------##-#------##-#------##-#------##-#------##-#------##-#------##-#------##-#------
-------#---------#---------#---------#---------#---------#---------#---------#---------#---------#--
---#--##-----#--##-----#--##-----#--##-----#--##-----#--##-----#--##-----#--##-----#--##-----#--##--
-#-#-###-#-#-#-###-#-#-#-###-#-#-#-###-#-#-#-###-#-#-#-###-#-#-#-###-#-#-#-###-#-#-#-###-#-#-#-###-#
--#-#---#---#-#---#---#-#---#---#-#---#---#-#---#---#-#---#---#-#---#---#-#---#---#-#---#---#-#---#-
----##--------##--------##--------##--------##--------##--------##--------##--------##--------##----
-----#---#-----#---#-----#---#-----#---#-----#---#-----#---#-----#---#-----#---#-----#---#-----#---#
---#---------#---------#---------#---------#---------#---------#---------#---------#---------#------
--#---#-#---#---#-#---#---#-#---#---#-#---#---#-#---#---#-#---#---#-#---#---#-#---#---#-#---#---#-#-
--------#---------#---------#---------#---------#---------#---------#---------#---------#---------#-
##-#------##-#------##-#------##-#------##-#------##-#------##-#------##-#------##-#------##-#------
-------#---------#---------#---------#---------#---------#---------#---------#---------#---------#--
---#--##-----#--##-----#--##-----#--##-----#--##-----#--##-----#--##-----#--##-----#--##-----#--##--
-#-#-###-#-#-#-###-#-#-#-###-#-#-#-###-#-#-#-###-#-#-#-###-#-#-#-###-#-#-#-###-#-#-#-###-#-#-#-###-#
--#-#---#---#-#---#---#-#---#---#-#---#---#-#---#---#-#---#---#-#---#---#-#---#---#-#---#---#-#---#-
----##--------##--------##--------##--------##--------##--------##--------##--------##--------##----
-----#---#-----#---#-----#---#-----#---#-----#-S-#-----#---#-----#---#-----#---#-----#---#-----#---#
---#---------#---------#---------#---------#---------#---------#---------#---------#---------#------
--#---#-#---#---#-#---#---#-#---#---#-#---#---#-#---#---#-#---#---#-#---#---#-#---#---#-#---#---#-#-
--------#---------#---------#---------#---------#---------#---------#---------#---------#---------#-
##-#------##-#------##-#------##-#------##-#------##-#------##-#------##-#------##-#------##-#------
-------#---------#---------#---------#---------#---------#---------#---------#---------#---------#--
---#--##-----#--##-----#--##-----#--##-----#--##-----#--##-----#--##-----#--##-----#--##-----#--##--
-#-#-###-#-#-#-###-#-#-#-###-#-#-#-###-#-#-#-###-#-#-#-###-#-#-#-###-#-#-#-###-#-#-#-###-#-#-#-###-#
--#-#---#---#-#---#---#-#---#---#-#---#---#-#---#---#-#---#---#-#---#---#-#---#---#-#---#---#-#---#-
----##--------##--------##--------##--------##--------##--------##--------##--------##--------##----
-----#---#-----#---#-----#---#-----#---#-----#---#-----#---#-----#---#-----#---#-----#---#-----#---#
---#---------#---------#---------#---------#---------#---------#---------#---------#---------#------
