--#---#--#--#---#--#--#---#--#--#---#--#--#---#--#--#---#--#--#---#--#--#---#--#--#---#--#--#---#--#
--#--#-#----#--#-#----#--#-#----#--#-#----#--#-#----#--#-#----#--#-#----#--#-#----#--#-#----#--#-#--
---#--#-##---#--#-##---#--#-##---#--#-##---#--#-##---#--#-##---#--#-##---#--#-##---#--#-##---#--#-##
#------#--#------#--#------#--#------#--#------#--#------#--#------#--#------#--#------#--#------#--
----------------------------------------------------------------------------------------------------
----------------------------------------------------------------------------------------------------
-#-----##--#-----##--#-----##--#-----##--#-----##--#-----##--#-----##--#-----##--#-----##--#-----##-
--###-#-#---###-#-#---###-#-#---###-#-#---###-#-#---###-#-#---###-#-#---###-#-#---###-#-#---###-#-#-
##----#---##----#---##----#---##----#---##----#---##----#---##----#---##----#---##----#---##----#---
--------#---------#---------#---------#---------#---------#---------#---------#---------#---------#-
--#---#--#--#---#--#--#---#--#--#---#--#--#---#--#--#---#--#--#---#--#--#---#--#--#---#--#--#---#--#
--#--#-#----#--#-#----#--#-#----#--#-#----#--#-#----#--#-#----#--#-#----#--#-#----#--#-#----#--#-#--
---#--#-##---#--#-##---#--#-##---#--#-##---#--#-##---#--#-##---#--#-##---#--#-##---#--#-##---#--#-##
#------#--#------#--#------#--#------#--#------#--#------#--#------#--#------#--#------#--#------#--
----------------------------------------------------------------------------------------------------
----------------------------------------------------------------------------------------------------
-#-----##--#-----##--#-----##--#-----##--#-----##--#-----##--#-----##--#-----##--#-----##--#-----##-
--###-#-#---###-#-#---###-#-#---###-#-#---###-#-#---###-#-#---###-#-#---###-#-#---###-#-#---###-#-#-
##----#---##----#---##----#---##----#---##----#---##----#---##----#---##----#---##----#---##----#---
--------#---------#---------#---------#---------#---------#---------#---------#---------#---------#-
--#---#--#--#---#--#--#---#--#--#---#--#--#---#--#--#---#--#--#---#--#--#---#--#--#---#--#--#---#--#
--#--#-#----#--#-#----#--#-#----#--#-#----#--#-#----#--#-#----#--#-#----#--#-#----#--#-#----#--#-#--
---#--#-##---#--#-##---#--#-##---#--#-##---#--#-##---#--#-##---#--#-##---#--#-##---#--#-##---#--#-##
#------#--#------#--#------#--#------#--#------#--#------#--#------#--#------#--#------#--#------#--
----------------------------------------------------------------------------------------------------
----------------------------------------------------------------------------------------------------
-#-----##--#-----##--#-----##--#-----##--#-----##--#-----##--#-----##--#-----##--#-----##--#-----##-
--###-#-#---###-#-#---###-#-#---###-#-#---###-#-#---###-#-#---###-#-#---###-#-#---###-#-#---###-#-#-
##----#---##----#---##----#---##----#---##----#---##----#---##----#---##----#---##----#---##----#---
--------#---------#---------#---------#---------#---------#---------#---------#---------#---------#-
--#---#--#--#---#--#--#---#--#--#---#--#--#---#--#--#---#--#--#---#--#--#---#--#--#---#--#--#---#--#
--#--#-#----#--#-#----#--#-#----#--#-#----#--#-#----#--#-#----#--#-#----#--#-#----#--#-#----#--#-#--
---#--#-##---#--#-##---#--#-##---#--#-##---#--#-##---#--#-##---#--#-##---#--#-##---#--#-##---#--#-##
#------#--#------#--#------#--#------#--#------#--#------#--#------#--#------#--#------#--#------#--
----------------------------------------------------------------------------------------------------
-------------S--------------------------------------------------------------------------------------
-#-----##--#-----##--#-----##--#-----##--#-----##--#-----##--#-----##--#-----##--#-----##--#-----##-
--###-#-#---###-#-#---###-#-#---###-#-#---###-#-#---###-#-#---###-#-#---###-#-#---###-#-#---###-#-#-
##----#---##----#---##----#---##----#---##----#---##----#---##----#---##----#---##----#---##----#---
--------#---------#---------#---------#---------#---------#---------#---------#---------#---------#-
--#---#--#--#---#--#--#---#--#--#---#--#--#---#--#--#---#--#--#---#--#--#---#--#--#---#--#--#---#--#
--#--#-#----#--#-#----#--#-#----#--#-#----#--#-#----#--#-#----#--#-#----#--#-#----#--#-#----#--#-#--
---#--#-##---#--#-##---#--#-##---#--#-##---#--#-##---#--#-##---#--#-##---#--#-##---#--#-##---#--#-##
#------#--#------#--#------#--#------#--#------#--#------#--#------#--#------#--#------#--#------#--
----------------------------------------------------------------------------------------------------
----------------------------------------------------------------------------------------------------
-#-----##--#-----##--#-----##--#-----##--#-----##--#-----##--#-----##--#-----##--#-----##--#-----##-
--###-#-#---###-#-#---###-#-#---###-#-#---###-#-#---###-#-#---###-#-#---###-#-#---###-#-#---###-#-#-
##----#---##----#---##----#---##----#---##----#---##----#---##----#---##----#---##----#---##----#---
--------#---------#---------#---------#---------#---------#---------#---------#---------#---------#-
--#---#--#--#---#--#--#---#--#--#---#--#--#---#--#--#---#--#--#---#--#--#---#--#--#---#--#--#---#--#
--#--#-#----#--#-#----#--#-#----#--#-#----#--#-#----#--#-#----#--#-#----#--#-#----#--#-#----#--#-#--
---#--#-##---#--#-##---#--#-##---#--#-##---#--#-##---#--#-##---#--#-##---#--#-##---#--#-##---#--#-##
#------#--#------#--#------#--#------#--#------#--#------#--#------#--#------#--#------#--#------#--
----------------------------------------------------------------------------------------------------
----------------------------------------------------------------------------------------------------
-#-----##--#-----##--#-----##--#-----##--#-----##--#-----##--#-----##--#-----##--#-----##--#-----##-
--###-#-#---###-#-#---###-#-#---###-#-#---###-#-#---###-#-#---###-#-#---###-#-#---###-#-#---###-#-#-
##----#---##----#---##----#---##----#---##----#---##----#---##----#---##----#---##----#---##----#---
--------#---------#---------#---------#---------#---------#---------#---------#---------#---------#-
--#---#--#--#---#--#--#---#--#--#---#--#--#---#--#--#---#--#--#---#--#--#---#--#--#---#--#--#---#--#
--#--#-#----#--#-#----#--#-#----#--#-#----#--#-#----#--#-#----#--#-#----#--#-#----#--#-#----#--#-#--
---#--#-##---#--#-##---#--#-##---#--#-##---#--#-##---#--#-##---#--#-##---#--#-##---#--#-##---#--#-##
#------#--#------#--#------#--#------#--#------#--#------#--#------#--#------#--#------#--#------#--
----------------------------------------------------------------------------------------------------
----------------------------------------------------------------------------------------------------
-#-----##--#-----##--#-----##--#-----##--#-----##--#-----##--#-----##--#-----##--#-----##--#-----##-
--###-#-#---###-#-#---###-#-#---###-#-#---###-#-#---###-#-#---###-#-#---###-#-#---###-#-#---###-#-#-
##----#---##----#---##----#---##----#---##----#---##----#---##----#---##----#---##----#---##----#---
--------#---------#---------#---------#---------#---------#---------#---------#---------#---------#-
--#---#--#--#---#--#--#---#--#--#---#--#--#---#--#--#---#--#--#---#--#--#---#--#--#---#--#--#---#--#
--#--#-#----#--#-#----#--#-#----#--#-#----#--#-#----#--#-#----#--#-#----#--#-#----#--#-#----#--#-#--
---#--#-##---#--#-##---#--#-##---#--#-##---#--#-##---#--#-##---#--#-##---#--#-##---#--#-##---#--#-##
#------#--#------#--#------#--#------#--#------#--#------#--#------#--#------#--#------#--#------#--
----------------------------------------------------------------------------------------------------
----------------------------------------------------------------------------------------------------
-#-----##--#-----##--#-----##--#-----##--#-----##--#-----##--#-----##--#-----##--#-----##--#-----##-
--###-#-#---###-#-#---###-#-#---###-#-#---###-#-#---###-#-#---###-#-#---###-#-#---###-#-#---###-#-#-
##----#---##----#---##----#---##----#---##----#---##----#---##----#---##----#---##----#---##----#---
--------#---------#---------#---------#---------#---------#---------#---------#---------#---------#-
--#---#--#--#---#--#--#---#--#--#---#--#--#---#--#--#---#--#--#---#--#--#---#--#--#---#--#--#---#--#
--#--#-#----#--#-#----#--#-#----#--#-#----#--#-#----#--#-#----#--#-#----#--#-#----#--#-#----#--#-#--
---#--#-##---#--#-##---#--#-##---#--#-##---#--#-##---#--#-##---#--#-##---#--#-##---#--#-##---#--#-##
#------#--#------#--#------#--#------#--#------#--#------#--#------#--#------#--#------#--#------#--
----------------------------------------------------------------------------------------------------
----------------------------------------------------------------------------------------------------
-#-----##--#-----##--#-----##--#-----##--#-----##--#-----##--#-----##--#-----##--#-----##--#-----##-
--###-#-#---###-#-#---###-#-#---###-#-#---###-#-#---###-#-#---###-#-#---###-#-#---###-#-#---###-#-#-
##----#---##----#---##----#---##----#---##----#---##----#---##----#---##----#---##----#---##----#---
--------#---------#---------#---------#---------#---------#---------#---------#---------#---------#-
--#---#--#--#---#--#--#---#--#--#---#--#--#---#--#--#---#--#--#---#--#--#---#--#--#---#--#--#---#--#
--#--#-#----#--#-#----#--#-#----#--#-#----#--#-#----#--#-#----#--#-#----#--#-#----#--#-#----#--#-#--
---#--#-##---#--#-##---#--#-##---#--#-##---#--#-##---#--#-##---#--#-##---#--#-##---#--#-##---#--#-##
#------#--#------#--#------#--#------#--#------#--#------#--#------#--#------#--#------#--#------#--
----------------------------------------------------------------------------------------------------
---------------------------------------------------E------------------------------------------------
-#-----##--#-----##--#-----##--#-----##--#-----##--#-----##--#-----##--#-----##--#-----##--#-----##-
--###-#-#---###-#-#---###-#-#---###-#-#---###-#-#---###-#-#---###-#-#---###-#-#---###-#-#---###-#-#-
##----#---##----#---##----#---##----#---##----#---##----#---##----#---##----#---##----#---##----#---
--------#---------#---------#---------#---------#---------#---------#---------#---------#---------#-
