--#--#------#--#------#--#------#--#------#--#------#--#------#--#------#--#------#--#------#--#----
#---------#---------#---------#-------E-#---------#---------#---------#---------#---------#---------
--#-#----#--#-#----#--#-#----#--#-#----#--#-#----#--#-#----#--#-#----#--#-#----#--#-#----#--#-#----#
-----#-#-#-----#-#-#-----#-#-#-----#-#-#-----#-#-#-----#-#-#-----#-#-#-----#-#-#-----#-#-#-----#-#-#
-#---------#---------#---------#---------#---------#---------#---------#---------#---------#--------
----##---#----##---#----##---#----##---#----##---#----##---#----##---#----##---#----##---#----##---#
#------#--#------#--#------#--#------#--#------#--#------#--#------#--#------#--#------#--#------#--
----##--##----##--##----##--##----##--##----##--##----##--##----##--##----##--##----##--##----##--##
#--#-#--###--#-#--###--#-#--###--#-#--###--#-#--###--#-#--###--#-#--###--#-#--###--#-#--###--#-#--##
----#----#----#----#----#----#----#----#----#----#----#----#----#----#----#----#----#----#----#----#
--#--#------#--#------#--#------#--#------#--#------#--#------#--#------#--#------#--#------#--#----
#---------#---------#---------#---------#---------#---------#---------#---------#---------#---------
--#-#----#--#-#----#--#-#----#--#-#----#--#-#----#--#-#----#--#-#----#--#-#----#--#-#----#--#-#----#
-----#-#-#-----#-#-#-----#-#-#-----#-#-#-----#-#-#-----#-#-#-----#-#-#-----#-#-#-----#-#-#-----#-#-#
-#---------#---------#---------#---------#---------#---------#---------#---------#---------#--------
----##---#----##---#----##---#----##---#----##---#----##---#----##---#----##---#----##---#----##---#
#------#--#------#--#------#--#------#--#------#--#------#--#------#--#------#--#------#--#------#--
----##--##----##--##----##--##----##--##----##--##----##--##----##--##----##--##----##--##----##--##
#--#-#--###--#-#--###--#-#--###--#-#--###--#-#--###--#-#--###--#-#--###--#-#--###--#-#--###--#-#--##
----#----#----#----#----#----#----#----#----#----#----#----#----#----#----#----#----#----#----#----#
--#--#------#--#------#--#------#--#------#--#------#--#------#--#------#--#------#--#------#--#----
#---------#---------#---------#---------#---------#---------#---------#---------#---------#---------
--#-#----#--#-#----#--#-#----#--#-#----#--#-#----#--#-#----#--#-#----#--#-#----#--#-#----#--#-#----#
-----#-#-#-----#-#-#-----#-#-#-----#-#-#-----#-#-#-----#-#-#-----#-#-#-----#-#-#-----#-#-#-----#-#-#
-#---------#---------#---------#---------#---------#---------#---------#---------#---------#--------
----##---#----##---#----##---#----##---#----##---#----##---#----##---#----##---#----##---#----##---#
#------#--#------#--#------#--#------#--#------#--#------#--#------#--#------#--#------#--#------#--
----##--##----##--##----##--##----##--##----##--##----##--##----##--##----##--##----##--##----##--##
#--#-#--###--#-#--###--#-#--###--#-#--###--#-#--###--#-#--###--#-#--###--#-#--###--#-#--###--#-#--##
----#----#----#----#----#----#----#----#----#----#----#----#----#----#----#----#----#----#----#----#
--#--#------#--#------#--#------#--#------#--#------#--#------#--#------#--#------#--#------#--#----
#---------#---------#---------#---------#---------#---------#---------#---------#---------#---------
--#-#----#--#-#----#--#-#----#--#-#----#--#-#----#--#-#----#--#-#----#--#-#----#--#-#----#--#-#----#
-----#-#-#-----#-#-#-----#-#-#-----#-#-#-----#-#-#-----#-#-#-----#-#-#-----#-#-#-----#-#-#-----#-#-#
-#---------#---------#---------#---------#---------#---------#---------#---------#---------#--------
----##---#----##---#----##---#----##---#----##---#----##---#----##---#----##---#----##---#----##---#
#------#--#------#--#------#--#------#--#------#--#------#--#------#--#------#--#------#--#------#--
----##--##----##--##----##--##----##--##----##--##----##--##----##--##----##--##----##--##----##--##
#--#-#--###--#-#--###--#-#--###--#-#--###--#-#--###--#-#--###--#-#--###--#-#--###--#-#--###--#-#--##
----#----#----#----#----#-S--#----#----#----#----#----#----#----#----#----#----#----#----#----#----#
--#--#------#--#------#--#------#--#------#--#------#--#------#--#------#--#------#--#------#--#----
#---------#---------#---------#---------#---------#---------#---------#---------#---------#---------
--#-#----#--#-#----#--#-#----#--#-#----#--#-#----#--#-#----#--#-#----#--#-#----#--#-#----#--#-#----#
-----#-#-#-----#-#-#-----#-#-#-----#-#-#-----#-#-#-----#-#-#-----#-#-#-----#-#-#-----#-#-#-----#-#-#
-#---------#---------#---------#---------#---------#---------#---------#---------#---------#--------
----##---#----##---#----##---#----##---#----##---#----##---#----##---#----##---#----##---#----##---#
#------#--#------#--#------#--#------#--#------#--#------#--#------#--#------#--#------#--#------#--
----##--##----##--##----##--##----##--##----##--##----##--##----##--##----##--##----##--##----##--##
#--#-#--###--#-#--###--#-#--###--#-#--###--#-#--###--#-#--###--#-#--###--#-#--###--#-#--###--#-#--##
----#----#----#----#----#----#----#----#----#----#----#----#----#----#----#----#----#----#----#----#
--#--#------#--#------#--#------#--#------#--#------#--#------#--#------#--#------#--#------#--#----
#---------#---------#---------#---------#---------#---------#---------#---------#---------#---------
--#-#----#--#-#----#--#-#----#--#-#----#--#-#----#--#-#----#--#-#----#--#-#----#--#-#----#--#-#----#
-----#-#-#-----#-#-#-----#-#-#-----#-#-#-----#-#-#-----#-#-#-----#-#-#-----#-#-#-----#-#-#-----#-#-#
-#---------#---------#---------#---------#---------#---------#---------#---------#---------#--------
----##---#----##---#----##---#----##---#----##---#----##---#----##---#----##---#----##---#----##---#
#------#--#------#--#------#--#------#--#------#--#------#--#------#--#------#--#------#--#------#--
----##--##----##--##----##--##----##--##----##--##----##--##----##--##----##--##----##--##----##--##
#--#-#--###--#-#--###--#-#--###--#-#--###--#-#--###--#-#--###--#-#--###--#-#--###--#-#--###--#-#--##
----#----#----#----#----#----#----#----#----#----#----#----#----#----#----#----#----#----#----#----#
--#--#------#--#------#--#------#--#------#--#------#--#------#--#------#--#------#--#------#--#----
#---------#---------#---------#---------#---------#---------#---------#---------#---------#---------
--#-#----#--#-#----#--#-#----#--#-#----#--#-#----#--#-#----#--#-#----#--#-#----#--#-#----#--#-#----#
-----#-#-#-----#-#-#-----#-#-#-----#-#-#-----#-#-#-----#-#-#-----#-#-#-----#-#-#-----#-#-#-----#-#-#
-#---------#---------#---------#---------#---------#---------#---------#---------#---------#--------
----##---#----##---#----##---#----##---#----##---#----##---#----##---#----##---#----##---#----##---#
#------#--#------#--#------#--#------#--#------#--#------#--#------#--#------#--#------#--#------#--
----##--##----##--##----##--##----##--##----##--##----##--##----##--##----##--##----##--##----##--##
#--#-#--###--#-#--###--#-#--###--#-#--###--#-#--###--#-#--###--#-#--###--#-#--###--#-#--###--#-#--##
----#----#----#----#----#----#----#----#----#----#----#----#----#----#----#----#----#----#----#----#
--#--#------#--#------#--#------#--#------#--#------#--#------#--#------#--#------#--#------#--#----
#---------#---------#---------#---------#---------#---------#---------#---------#---------#---------
--#-#----#--#-#----#--#-#----#--#-#----#--#-#----#--#-#----#--#-#----#--#-#----#--#-#----#--#-#----#
-----#-#-#-----#-#-#-----#-#-#-----#-#-#-----#-#-#-----#-#-#-----#-#-#-----#-#-#-----#-#-#-----#-#-#
-#---------#---------#---------#---------#---------#---------#---------#---------#---------#--------
----##---#----##---#----##---#----##---#----##---#----##---#----##---#----##---#----##---#----##---#
#------#--#------#--#------#--#------#--#------#--#------#--#------#--#------#--#------#--#------#--
----##--##----##--##----##--##----##--##----##--##----##--##----##--##----##--##----##--##----##--##
#--#-#--###--#-#--###--#-#--###--#-#--###--#-#--###--#-#--###--#-#--###--#-#--###--#-#--###--#-#--##
----#----#----#----#----#----#----#----#----#----#----#----#----#----#----#----#----#----#----#----#
--#--#------#--#------#--#------#--#------#--#------#--#------#--#------#--#------#--#------#--#----
#---------#---------#---------#---------#---------#---------#---------#---------#---------#---------
--#-#----#--#-#----#--#-#----#--#-#----#--#-#----#--#-#----#--#-#----#--#-#----#--#-#----#--#-#----#
-----#-#-#-----#-#-#-----#-#-#-----#-#-#-----#-#-#-----#-#-#-----#-#-#-----#-#-#-----#-#-#-----#-#-#
-#---------#---------#---------#---------#---------#---------#---------#---------#---------#--------
----##---#----##---#----##---#----##---#----##---#----##---#----##---#----##---#----##---#----##---#
#------#--#------#--#------#--#------#--#------#--#------#--#------#--#------#--#------#--#------#--
----##--##----##--##----##--##----##--##----##--##----##--##----##--##----##--##----##--##----##--##
#--#-#--###--#-#--###--#-#--###--#-#--###--#-#--###--#-#--###--#-#--###--#-#--###--#-#--###--#-#--##
----#----#----#----#----#----#----#----#----#----#----#----#----#----#----#----#----#----#----#----#
--#--#------#--#------#--#------#--#------#--#------#--#------#--#------#--#------#--#------#--#----
#---------#---------#---------#---------#---------#---------#---------#---------#---------#---------
--#-#----#--#-#----#--#-#----#--#-#----#--#-#----#--#-#----#--#-#----#--#-#----#--#-#----#--#-#----#
-----#-#-#-----#-#-#-----#-#-#-----#-#-#-----#-#-#-----#-#-#-----#-#-#-----#-#-#-----#-#-#-----#-#-#
-#---------#---------#---------#---------#---------#---------#---------#---------#---------#--------
----##---#----##---#----##---#----##---#----##---#----##---#----##---#----##---#----##---#----##---#
#------#--#------#--#------#--#------#--#------#--#------#--#------#--#------#--#------#--#------#--
----##--##----##--##----##--##----##--##----##--##----##--##----##--##----##--##----##--##----##--##
#--#-#--###--#-#--###--#-#--###--#-#--###--#-#--###--#-#--###--#-#--###--#-#--###--#-#--###--#-#--##
----#----#----#----#----#----#----#----#----#----#----#----#----#----#----#----#----#----#----#----#
