--#-#----#--#-#----#--#-#----#--#-#----#--#-#----#--#-#----#--#-#----#--#-#----#--#-#----#--#-#----#
-#-#-#-#---#-#-#-#---#-#-#-#---#-#-#-#---#-#-#-#---#-#-#-#---#-#-#-#---#-#-#-#---#-#-#-#---#-#-#-#--
--------#---------#---------#---------#---------#---------#---------#---------#---------#---------#-
-#-#--##---#-#--##---#-#--##---#-#--##---#-#--##---#-#--##---#-#--##---#-#--##---#-#--##---#-#--##--
#-#--#----#-#--#----#-#--#----#-#--#----#-#--#----#-#--#----#-#--#----#-#--#----#-#--#----#-#--#----
---#---------#---------#---------#---------#---------#---------#---------#---------#---------#------
##------#-##------#-##------#-##------#-##------#-##------#-##------#-##------#-##------#-##------#-
----#----#----#----#----#----#----#----#----#----#----#----#----#----#----#----#----#----#----#----#
--###---#---###---#---###---#---###---#---###---#---###---#---###---#---###---#---###---#---###---#-
-----#--#------#--#------#--#------#--#------#--#------#--#------#--#------#--#------#--#------#--#-
--#-#----#--#-#----#--#-#----#--#-#----#--#-#----#--#-#----#--#-#----#--#-#----#--#-#----#--#-#----#
-#-#-#-#---#-#-#-#---#-#-#-#---#-#-#-#---#-#-#-#---#-#-#-#---#-#-#-#---#-#-#-#---#-#-#-#---#-#-#-#--
--------#---------#---------#---------#---------#---------#---------#---------#---------#---------#-
-#-#--##---#-#--##---#-#--##---#-#--##---#-#--##---#-#--##---#-#--##---#-#--##---#-#--##---#-#--##--
#-#--#----#-#--#----#-#--#----#-#--#----#-#--#----#-#--#----#-#--#----#-#--#----#-#--#----#-#--#----
---#---------#---------#---------#---------#---------#---------#---------#---------#---------#------
##------#-##------#-##------#-##------#-##------#-##------#-##------#-##------#-##------#-##------#-
----#----#----#----#----#----#----#----#----#----#----#----#----#----#----#----#----#----#----#----#
--###---#---###---#---###---#---###---#---###---#---###---#---###---#---###---#---###---#---###---#-
-----#--#------#--#------#--#------#--#------#--#------#--#------#--#------#--#------#--#------#--#-
--#-#----#--#-#----#--#-#----#--#-#----#--#-#----#--#-#----#--#-#----#--#-#----#--#-#----#--#-#----#
-#-#-#-#---#-#-#-#---#-#-#-#---#-#-#-#---#-#-#-#---#-#-#-#---#-#-#-#---#-#-#-#---#-#-#-#---#-#-#-#--
--------#---------#---------#---------#---------#---------#---------#---------#---------#---------#-
-#-#--##---#-#--##---#-#--##---#-#--##---#-#--##---#-#--##---#-#--##---#-#--##---#-#--##---#-#--##--
#-#--#----#-#--#----#-#--#----#-#--#----#-#--#----#-#--#----#-#--#----#-#--#----#-#--#----#-#--#----
---#---------#---------#---------#---------#---------#---------#---------#---------#---------#------
##------#-##------#-##------#-##------#-##------#-##------#-##------#-##------#-##------#-##------#-
----#----#----#----#----#----#----#----#----#----#----#----#----#----#----#----#----#----#----#----#
--###---#---###---#---###---#---###---#---###---#---###---#---###---#---###---#---###---#---###---#-
-----#--#------#--#------#--#------#--#------#--#------#--#------#--#------#--#------#--#------#--#-
--#-#----#--#-#----#--#-#----#--#-#----#--#-#----#--#-#----#--#-#----#--#-#----#--#-#----#--#-#----#
-#-#-#-#---#-#-#-#---#-#-#-#---#-#-#-#---#-#-#-#---#-#-#-#---#-#-#-#---#-#-#-#---#-#-#-#---#-#-#-#--
--------#---------#---------#---------#---------#---------#---------#---------#---------#---------#-
-#-#--##---#-#--##---#-#--##---#-#--##---#-#--##---#-#--##---#-#--##---#-#--##---#-#--##---#-#--##--
#-#--#----#-#--#----#-#--#----#-#--#----#-#--#----#-#--#----#-#--#----#-#--#----#-#--#----#-#--#----
---#---------#---------#---------#---------#---------#---------#---------#---------#---------#------
##------#-##------#-##------#-##------#-##------#-##------#-##------#-##------#-##------#-##------#-
----#----#----#----#----#----#----#----#----#----#----#----#----#----#----#----#----#----#----#----#
--###---#---###---#---###---#---###---#---###---#---###---#---###---#---###---#---###---#---###---#-
-----#--#------#--#------#--#------#--#------#--#------#--#------#--#------#--#------#--#------#--#-
--#-#----#--#-#----#--#-#----#--#-#----#--#-#----#--#-#----#--#-#----#--#-#----#--#-#----#--#-#----#
-#-#-#-#---#-#-#-#---#-#-#-#---#-#-#-#---#-#-#-#---#-#-#-#---#-#-#-#---#-#-#-#---#-#-#-#---#-#-#-#--
--------#---------#---------#---------#---------#---------#---------#---------#---------#---------#-
-#-#--##---#-#--##---#-#--##---#-#--##---#-#--##---#-#--##---#-#--##---#-#--##---#-#--##---#-#--##--
#-#--#----#-#--#----#-#--#----#-#--#----#-#--#----#-#--#----#-#--#----#-#--#----#-#--#----#-#--#----
---#---------#---------#---------#---------#---------#---------#---------#---------#---------#------
##------#-##------#-##------#-##------#-##------#-##------#-##------#-##------#-##------#-##------#-
----#----#----#----#----#----#----#----#----#----#----#----#----#----#----#----#----#----#----#----#
--###---#---###---#---###---#---###---#---###---#---###---#---###---#---###---#---###---#---###---#-
-----#--#------#--#------#--#------#--#------#--#------#--#------#--#------#--#------#--#------#--#-
--#-#----#--#-#----#--#-#----#--#-#----#--#-#----#--#-#----#--#-#----#--#-#----#--#-#----#--#-#----#
-#-#-#-#---#-#-#-#---#-#-#-#---#-#-#-#---#-#-#-#---#-#-#-#---#-#-#-#---#-#-#-#---#-#-#-#---#-#-#-#--
--------#---------#---------#---------#---------#---------#---------#---------#---------#---------#-
-#-#--##---#-#--##---#-#--##---#-#--##---#-#--##---#-#--##---#-#--##---#-#--##---#-#--##---#-#--##--
#-#--#----#-#--#----#-#--#----#-#--#----#-#--#----#-#--#----#-#--#----#-#--#----#-#--#----#-#--#----
---#---------#---------#---------#---------#---------#---------#---------#---------#---------#------
##------#-##------#-##------#-##------#-##------#-##------#-##------#-##------#-##------#-##------#-
----#----#----#----#----#----#----#----#----#----#----#----#----#----#----#----#----#----#----#----#
--###---#---###---#---###---#---###---#---###---#---###---#---###---#---###---#---###---#---###---#-
-----#--#------#--#------#--#------#--#------#--#------#--#------#--#------#--#------#--#------#--#-
--#-#----#--#-#----#--#-#----#--#-#----#--#-#----#--#-#----#--#-#----#--#-#----#--#-#----#--#-#----#
-#-#-#-#---#-#-#-#---#-#-#-#---#-#-#-#---#-#-#-#---#-#-#-#---#-#-#-#---#-#-#-#---#-#-#-#---#-#-#-#--
--------#---------#---------#---------#---------#---------#---------#---------#---------#---------#-
-#-#--##---#-#--##---#-#--##---#-#--##---#-#--##---#-#--##---#-#--##---#-#--##---#-#--##---#-#--##--
#-#--#----#-#--#----#-#--#----#-#--#----#-#--#----#-#--#----#-#--#----#-#--#----#-#--#----#-#--#----
---#---------#---------#---------#---------#---------#---------#---------#---------#---------#------
##------#-##------#-##------#-##------#-##------#-##------#-##------#-##------#-##------#-##------#-
----#----#----#----#----#----#----#----#----#----#----#----#----#----#----#----#----#----#----#----#
--###---#---###---#---###---#---###---#---###---#---###---#---###---#---###---#---###---#---###---#-
-----#--#------#--#------#--#------#--#------#--#------#--#------#--#------#--#------#--#------#--#-
--#-#----#--#-#----#--#-#----#--#-#----#--#-#----#--#-#----#--#-#----#--#-#----#--#-#----#--#-#----#
-#-#-#-#---#-#-#-#---#-#-#-#---#-#-#-#---#-#-#-#---#-#-#-#---#-#-#-#---#-#-#-#---#-#-#-#---#-#-#-#--
--------#---------#---------#---------#---------#---------#---------#---------#---------#---------#-
-#-#--##---#-#--##---#-#--##---#-#--##---#-#--##---#-#--##---#-#--##---#-#--##---#-#--##---#-#--##--
#-#--#----#-#--#----#-#--#----#-#--#----#-#-S#----#-#--#----#-#--#----#-#--#----#-#--#----#-#--#----
---#---------#---------#---------#---------#---------#---------#---------#---------#---------#------
##------#-##------#-##------#-##------#-##------#-##------#-##------#-##------#-##------#-##------#-
----#----#----#----#----#----#----#----#----#----#----#----#----#----#----#----#----#----#----#----#
--###---#---###---#---###---#---###---#---###---#---###---#---###---#---###---#---###---#---###---#-
-----#--#------#--#------#--#------#--#------#--#------#--#------#--#------#--#------#--#------#--#-
--#-#----#--#-#----#--#-#----#--#-#----#--#-#----#--#-#----#--#-#----#--#-#----#--#-#----#--#-#----#
-#-#-#-#---#-#-#-#---#-#-#-#---#-#-#-#---#-#-#-#---#-#-#-#---#-#-#-#---#-#-#-#---#-#-#-#---#-#-#-#--
--------#---------#---------#---------#---------#---------#---------#---------#---------#---------#-
-#-#--##---#-#--##---#-#--##---#-#--##---#-#--##---#-#--##---#-#--##---#-#--##---#-#--##---#-#--##--
#-#--#----#-#--#----#-#--#----#-#--#----#-#--#----#-#--#----#-#--#----#-#--#----#-#--#----#-#--#----
---#---------#---------#---------#---------#---------#---------#---------#---------#---------#------
##------#-##------#-##------#-##------#-##------#-##------#-##------#-##------#-##------#-##------#-
----#----#----#----#----#----#----#----#----#----#----#----#----#----#----#----#----#----#----#----#
--###---#---###---#---###---#---###---#---###---#---###---#---###---#---###---#---###---#---###---#-
-----#--#------#--#------#--#------#--#------#--#------#--#------#--#------#--#------#--#------#--#-
--#-#----#--#-#----#--#-#----#--#-#----#--#-#----#--#-#----#--#-#----#--#-#----#--#-#----#--#-#----#
-#-#-#-#---#-#-#-#---#-#-#-#---#-#-#-#---#-#-#-#---#-#-#-#---#-#-#-#---#-#-#-#---#-#-#-#---#-#-#-#--
------E-#---------#---------#---------#---------#---------#---------#---------#---------#---------#-
-#-#--##---#-#--##---#-#--##---#-#--##---#-#--##---#-#--##---#-#--##---#-#--##---#-#--##---#-#--##--
#-#--#----#-#--#----#-#--#----#-#--#----#-#--#----#-#--#----#-#--#----#-#--#----#-#--#----#-#--#----
---#---------#---------#---------#---------#---------#---------#---------#---------#---------#------
##------#-##------#-##------#-##------#-##------#-##------#-##------#-##------#-##------#-##------#-
----#----#----#----#----#----#----#----#----#----#----#----#----#----#----#----#----#----#----#----#
--###---#---###---#---###---#---###---#---###---#---###---#---###---#---###---#---###---#---###---#-
-----#--#------#--#------#--#------#--#------#--#------#--#------#--#------#--#------#--#------#--#-
