#--------##--------##--------##--------##--------##--------##--------##--------##--------##--------#
-#-#--#-#--#-#--#-#--#-#--#-#--#-#--#-#--#-#--#-#--#-#--#-#--#-#--#-#--#-#--#-#--#-#--#-#--#-#--#-#-
#----#----#----#----#----#----#----#----#----#----#----#----#----#----#----#----#----#----#----#----
--#------#--#------#--#------#--#------#--#------#--#------#--#------#--#------#--#------#--#------#
-#----##---#----##---#----##---#----##---#----##---#----##---#----##---#----##---#----##---#----##--
#-----#-#-#-----#-#-#-----#-#-#-----#-#-#-----#-#-#-----#-#-#-----#-#-#-----#-#-#-----#-#-#-----#-#-
##--#---####--#---####--#---####--#---####--#---####--#---####--#---####--#---####--#---####--#---##
--###-------###-------###-------###-------###-------###-------###-------###-------###-------###-----
--#---#-----#---#-----#---#-----#---#-----#---#-----#---#-----#---#-----#---#-----#---#-----#---#---
-----#---------#---------#---------#---------#---------#---------#---------#---------#---------#----
#--------##--------##--------##--------##--------##--------##--------##--------##--------##--------#
-#-#--#-#--#-#--#-#--#-#--#-#--#-#--#-#--#-#--#-#--#-#--#-#--#-#--#-#--#-#--#-#--#-#--#-#--#-#--#-#-
#----#----#----#----#----#----#----#----#----#----#----#----#----#----#----#----#----#----#----#----
--#------#--#------#--#------#--#------#--#------#--#------#--#------#--#------#--#------#--#------#
-#----##---#----##---#----##---#----##---#----##---#----##---#----##---#----##---#----##---#----##--
#-----#-#-#-----#-#-#-----#-#-#-----#-#-#-----#-#-#-----#-#-#-----#-#-#-----#-#-#-----#-#-#-----#-#-
##--#---####--#---####--#---####--#---####--#---####--#---####--#---####--#---####--#---####--#---##
--###-------###-------###-------###-------###-------###-------###-------###-------###-------###-----
--#---#-----#---#-----#---#-----#---#-----#---#-----#---#-----#---#-----#---#-----#---#-----#---#---
-----#---------#---------#---------#---------#---------#---------#---------#---------#---------#----
#--------##--------##--------##--------##--------##--------##--------##--------##--------##--------#
-#-#--#-#--#-#--#-#--#-#--#-#--#-#--#-#--#-#--#-#--#-#--#-#--#-#--#-#--#-#--#-#--#-#--#-#--#-#--#-#-
#----#----#----#----#----#----#----#----#----#----#----#----#----#----#----#----#----#----#----#----
--#------#--#------#--#------#--#------#--#------#--#------#--#------#--#------#--#------#--#------#
-#----##---#----##---#----##---#----##---#----##---#----##---#----##---#----##---#----##---#----##--
#-----#-#-#-----#-#-#-----#-#-#-----#-#-#-----#-#-#-----#-#-#-----#-#-#-----#-#-#-----#-#-#-----#-#-
##--#---####--#---####--#---####--#---####--#---####--#---####--#---####--#---####--#---####--#---##
--###-------###-------###-------###-------###-------###-------###-------###-------###-------###-----
--#---#-----#---#-----#---#-----#---#-----#---#-----#---#-----#---#-----#---#-----#---#-----#---#---
-----#---------#---------#---------#---------#---------#---------#---------#---------#---------#----
#--------##--------##--------##--------##--------##--------##--------##--------##--------##--------#
-#-#--#-#--#-#--#-#--#-#--#-#--#-#--#-#--#-#--#-#--#-#--#-#--#-#--#-#--#-#--#-#--#-#--#-#--#-#--#-#-
#----#----#----#----#----#----#----#----#----#----#----#----#----#----#----#----#----#----#----#----
--#------#--#------#--#------#--#------#--#------#--#------#--#------#--#------#--#------#--#------#
-#----##---#----##-S-#----##---#----##---#----##---#----##---#----##---#----##---#----##---#----##--
#-----#-#-#-----#-#-#-----#-#-#-----#-#-#-----#-#-#-----#-#-#-----#-#-#-----#-#-#-----#-#-#-----#-#-
##--#---####--#---####--#---####--#---####--#---####--#---####--#---####--#---####--#---####--#---##
--###-------###-------###-------###-------###-------###-------###-------###-------###-------###-----
--#---#-----#---#-----#---#-----#---#-----#---#-----#---#-----#---#-----#---#-----#---#-----#---#---
-----#---------#---------#---------#---------#---------#---------#---------#---------#---------#----
#--------##--------##--------##--------##--------##--------##--------##--------##--------##--------#
-#-#--#-#--#-#--#-#--#-#--#-#--#-#--#-#--#-#--#-#--#-#--#-#--#-#--#-#--#-#--#-#--#-#--#-#--#-#--#-#-
#----#----#----#----#----#----#----#----#----#----#----#----#----#----#----#----#----#----#----#----
--#------#--#------#--#------#--#------#--#--E---#--#------#--#------#--#------#--#------#--#------#
-#----##---#----##---#----##---#----##---#----##---#----##---#----##---#----##---#----##---#----##--
#-----#-#-#-----#-#-#-----#-#-#-----#-#-#-----#-#-#-----#-#-#-----#-#-#-----#-#-#-----#-#-#-----#-#-
##--#---####--#---####--#---####--#---####--#---####--#---####--#---####--#---####--#---####--#---##
--###-------###-------###-------###-------###-------###-------###-------###-------###-------###-----
--#---#-----#---#-----#---#-----#---#-----#---#-----#---#-----#---#-----#---#-----#---#-----#---#---
-----#---------#---------#---------#---------#---------#---------#---------#---------#---------#----
#--------##--------##--------##--------##--------##--------##--------##--------##--------##--------#
-#-#--#-#--#-#--#-#--#-#--#-#--#-#--#-#--#-#--#-#--#-#--#-#--#-#--#-#--#-#--#-#--#-#--#-#--#-#--#-#-
#----#----#----#----#----#----#----#----#----#----#----#----#----#----#----#----#----#----#----#----
--#------#--#------#--#------#--#------#--#------#--#------#--#------#--#------#--#------#--#------#
-#----##---#----##---#----##---#----##---#----##---#----##---#----##---#----##---#----##---#----##--
#-----#-#-#-----#-#-#-----#-#-#-----#-#-#-----#-#-#-----#-#-#-----#-#-#-----#-#-#-----#-#-#-----#-#-
##--#---####--#---####--#---####--#---####--#---####--#---####--#---####--#---####--#---####--#---##
--###-------###-------###-------###-------###-------###-------###-------###-------###-------###-----
--#---#-----#---#-----#---#-----#---#-----#---#-----#---#-----#---#-----#---#-----#---#-----#---#---
-----#---------#---------#---------#---------#---------#---------#---------#---------#---------#----
#--------##--------##--------##--------##--------##--------##--------##--------##--------##--------#
-#-#--#-#--#-#--#-#--#-#--#-#--#-#--#-#--#-#--#-#--#-#--#-#--#-#--#-#--#-#--#-#--#-#--#-#--#-#--#-#-
#----#----#----#----#----#----#----#----#----#----#----#----#----#----#----#----#----#----#----#----
--#------#--#------#--#------#--#------#--#------#--#------#--#------#--#------#--#------#--#------#
-#----##---#----##---#----##---#----##---#----##---#----##---#----##---#----##---#----##---#----##--
#-----#-#-#-----#-#-#-----#-#-#-----#-#-#-----#-#-#-----#-#-#-----#-#-#-----#-#-#-----#-#-#-----#-#-
##--#---####--#---####--#---####--#---####--#---####--#---####--#---####--#---####--#---####--#---##
--###-------###-------###-------###-------###-------###-------###-------###-------###-------###-----
--#---#-----#---#-----#---#-----#---#-----#---#-----#---#-----#---#-----#---#-----#---#-----#---#---
-----#---------#---------#---------#---------#---------#---------#---------#---------#---------#----
#--------##--------##--------##--------##--------##--------##--------##--------##--------##--------#
-#-#--#-#--#-#--#-#--#-#--#-#--#-#--#-#--#-#--#-#--#-#--#-#--#-#--#-#--#-#--#-#--#-#--#-#--#-#--#-#-
#----#----#----#----#----#----#----#----#----#----#----#----#----#----#----#----#----#----#----#----
--#------#--#------#--#------#--#------#--#------#--#------#--#------#--#------#--#------#--#------#
-#----##---#----##---#----##---#----##---#----##---#----##---#----##---#----##---#----##---#----##--
#-----#-#-#-----#-#-#-----#-#-#-----#-#-#-----#-#-#-----#-#-#-----#-#-#-----#-#-#-----#-#-#-----#-#-
##--#---####--#---####--#---####--#---####--#---####--#---####--#---####--#---####--#---####--#---##
--###-------###-------###-------###-------###-------###-------###-------###-------###-------###-----
--#---#-----#---#-----#---#-----#---#-----#---#-----#---#-----#---#-----#---#-----#---#-----#---#---
-----#---------#---------#---------#---------#---------#---------#---------#---------#---------#----
#--------##--------##--------##--------##--------##--------##--------##--------##--------##--------#
-#-#--#-#--#-#--#-#--#-#--#-#--#-#--#-#--#-#--#-#--#-#--#-#--#-#--#-#--#-#--#-#--#-#--#-#--#-#--#-#-
#----#----#----#----#----#----#----#----#----#----#----#----#----#----#----#----#----#----#----#----
--#------#--#------#--#------#--#------#--#------#--#------#--#------#--#------#--#------#--#------#
-#----##---#----##---#----##---#----##---#----##---#----##---#----##---#----##---#----##---#----##--
#-----#-#-#-----#-#-#-----#-#-#-----#-#-#-----#-#-#-----#-#-#-----#-#-#-----#-#-#-----#-#-#-----#-#-
##--#---####--#---####--#---####--#---####--#---####--#---####--#---####--#---####--#---####--#---##
--###-------###-------###-------###-------###-------###-------###-------###-------###-------###-----
--#---#-----#---#-----#---#-----#---#-----#---#-----#---#-----#---#-----#---#-----#---#-----#---#---
-----#---------#---------#---------#---------#---------#---------#---------#---------#---------#----
#--------##--------##--------##--------##--------##--------##--------##--------##--------##--------#
-#-#--#-#--#-#--#-#--#-#--#-#--#-#--#-#--#-#--#-#--#-#--#-#--#-#--#-#--#-#--#-#--#-#--#-#--#-#--#-#-
#----#----#----#----#----#----#----#----#----#----#----#----#----#----#----#----#----#----#----#----
--#------#--#------#--#------#--#------#--#------#--#------#--#------#--#------#--#------#--#------#
-#----##---#----##---#----##---#----##---#----##---#----##---#----##---#----##---#----##---#----##--
#-----#-#-#-----#-#-#-----#-#-#-----#-#-#-----#-#-#-----#-#-#-----#-#-#-----#-#-#-----#-#-#-----#-#-
##--#---####--#---####--#---####--#---####--#---####--#---####--#---####--#---####--#---####--#---##
--###-------###-------###-------###-------###-------###-------###-------###-------###-------###-----
--#---#-----#---#-----#---#-----#---#-----#---#-----#---#-----#---#-----#---#-----#---#-----#---#---
-----#---------#---------#---------#---------#---------#---------#---------#---------#---------#----
