------#---------#---------#---------#---------#---------#---------#---------#---------#---------#---
#--------##--------##--------##--------##--------##--------##--------##--------##--------##--------#
-#------##-#------##-#------##-#------##-#------##-#------##-#------##-#------##-#------##-#------##
-----#---------#---------#---------#---------#---------#---------#---------#---------#---------#----
-#--#------#--#------#--#------#--#------#--#------#--#------#--#------#--#------#--#------#--#-----
##-----#-###-----#-###-----#-###-----#-###-----#-###-----#-###-----#-###-----#-###-----#-###-----#-#
#--------##--------##--------##--------##--------##--------##--------##--------##--------##--------#
--#-##--#---#-##--#---#-##--#---#-##--#---#-##--#---#-##--#---#-##--#---#-##--#---#-##--#---#-##--#-
-----#-#-------#-#-------#-#-------#-#-------#-#-------#-#-------#-#-------#-#-------#-#-------#-#--
--#-##--#---#-##--#---#-##--#---#-##--#---#-##--#---#-##--#---#-##--#---#-##--#---#-##--#---#-##--#-
------#---------#---------#---------#---------#---------#---------#---------#---------#---------#---
#--------##--------##--------##--------##--------##--------##--------##--------##--------##--------#
-#------##-#------##-#------##-#------##-#------##-#------##-#------##-#------##-#------##-#------##
-----#---------#---------#---------#---------#---------#---------#---------#---------#---------#----
-#--#------#--#------#--#------#--#------#--#------#--#------#--#------#--#------#--#------#--#-----
##-----#-###-----#-###-----#-###-----#-###-----#-###-----#-###-----#-###-----#-###-----#-###-----#-#
#--------##--------##--------##--------##--------##--------##--------##--------##--------##--------#
--#-##--#---#-##--#---#-##--#---#-##--#---#-##--#---#-##--#---#-##--#---#-##--#---#-##--#---#-##--#-
-----#-#-------#-#-------#-#-------#-#-------#-#-------#-#-------#-#-------#-#-------#-#-------#-#--
--#-##--#---#-##--#---#-##--#---#-##--#---#-##--#---#-##--#---#-##--#---#-##--#---#-##--#---#-##--#-
------#---------#---------#---------#---------#---------#---------#---------#---------#---------#---
#--------##--------##--------##--------##--------##--------##--------##--------##--------##--------#
-#------##-#------##-#------##-#------##-#------##-#------##-#------##-#------##-#------##-#------##
-----#---------#---------#---------#---------#---------#---------#---------#---------#---------#----
-#--#------#--#------#--#------#--#------#--#------#--#------#--#------#--#------#--#------#--#-----
##-----#-###-----#-###-----#-###-----#-###-----#-###-----#-###-----#-###-----#-###-----#-###-----#-#
#--------##--------##--------##--------##--------##--------##--------##--------##--------##--------#
--#-##--#---#-##--#---#-##--#---#-##--#---#-##--#---#-##--#---#-##--#---#-##--#---#-##--#---#-##--#-
-----#-#-------#-#-------#-#-------#-#-------#-#-------#-#-------#-#---E---#-#-------#-#-------#-#--
--#-##--#---#-##--#---#-##--#---#-##--#---#-##--#---#-##--#---#-##--#---#-##--#---#-##--#---#-##--#-
------#---------#---------#---------#---------#---------#---------#---------#---------#---------#---
#--------##--------##--------##--------##--------##--------##--------##--------##--------##--------#
-#------##-#------##-#------##-#------##-#------##-#------##-#------##-#------##-#------##-#------##
-----#---------#---------#---------#---------#---------#---------#---------#---------#---------#----
-#--#------#--#------#--#------#--#------#--#------#--#------#--#------#--#------#--#------#--#-----
##-----#-###-----#-###-----#-###-----#-###-----#-###-----#-###-----#-###-----#-###-----#-###-----#-#
#--------##--------##--------##--------##--------##--------##--------##--------##--------##--------#
--#-##--#---#-##--#---#-##--#---#-##--#---#-##--#---#-##--#---#-##--#---#-##--#---#-##--#---#-##--#-
-----#-#-------#-#-------#-#-------#-#-------#-#-------#-#-------#-#-------#-#-------#-#-------#-#--
--#-##--#---#-##--#---#-##--#---#-##--#---#-##--#---#-##--#---#-##--#---#-##--#---#-##--#---#-##--#-
------#---------#---------#---------#---------#---------#---------#---------#---------#---------#---
#--------##--------##--------##--------##--------##--------##--------##--------##--------##--------#
-#------##-#------##-#------##-#------##-#------##-#------##-#------##-#------##-#------##-#------##
-----#---------#---------#---------#---------#---------#---------#---------#---------#---------#----
-#--#------#--#------#--#------#--#------#--#------#--#------#--#------#--#------#--#------#--#-----
##-----#-###-----#-###-----#-###-----#-###-----#-###-----#-###-----#-###-----#-###-----#-###-----#-#
#--------##--------##--------##--------##--------##--------##--------##--------##--------##--------#
--#-##--#---#-##--#---#-##--#---#-##--#---#-##--#---#-##--#---#-##--#---#-##--#---#-##--#---#-##--#-
-----#-#-------#-#-------#-#-------#-#-------#-#-------#-#-------#-#-------#-#-------#-#-------#-#--
--#-##--#---#-##--#---#-##--#---#-##--#---#-##--#---#-##--#---#-##--#---#-##--#---#-##--#---#-##--#-
------#---------#---------#---------#---------#---------#---------#---------#---------#---------#---
#--------##--------##--------##--------##--------##--------##--------##--------##--------##--------#
-#------##-#------##-#------##-#------##-#------##-#------##-#------##-#------##-#------##-#------##
-----#---------#---------#---------#---------#---------#---------#---------#---------#---------#----
-#--#------#--#------#--#------#--#------#--#------#--#------#--#------#--#------#--#------#--#-----
##-----#-###-----#-###-----#-###-----#-###-----#-###-----#-###-----#-###-----#-###-----#-###-----#-#
#--------##--------##--------##--------##--------##--------##--------##--------##--------##--------#
--#-##--#---#-##--#---#-##--#---#-##--#---#-##--#---#-##--#---#-##--#---#-##--#---#-##--#---#-##--#-
-----#-#-------#-#-------#-#-------#-#-------#-#-------#-#-------#-#-------#-#------S#-#-------#-#--
--#-##--#---#-##--#---#-##--#---#-##--#---#-##--#---#-##--#---#-##--#---#-##--#---#-##--#---#-##--#-
------#---------#---------#---------#---------#---------#---------#---------#---------#---------#---
#--------##--------##--------##--------##--------##--------##--------##--------##--------##--------#
-#------##-#------##-#------##-#------##-#------##-#------##-#------##-#------##-#------##-#------##
-----#---------#---------#---------#---------#---------#---------#---------#---------#---------#----
-#--#------#--#------#--#------#--#------#--#------#--#------#--#------#--#------#--#------#--#-----
##-----#-###-----#-###-----#-###-----#-###-----#-###-----#-###-----#-###-----#-###-----#-###-----#-#
#--------##--------##--------##--------##--------##--------##--------##--------##--------##--------#
--#-##--#---#-##--#---#-##--#---#-##--#---#-##--#---#-##--#---#-##--#---#-##--#---#-##--#---#-##--#-
-----#-#-------#-#-------#-#-------#-#-------#-#-------#-#-------#-#-------#-#-------#-#-------#-#--
--#-##--#---#-##--#---#-##--#---#-##--#---#-##--#---#-##--#---#-##--#---#-##--#---#-##--#---#-##--#-
------#---------#---------#---------#---------#---------#---------#---------#---------#---------#---
#--------##--------##--------##--------##--------##--------##--------##--------##--------##--------#
-#------##-#------##-#------##-#------##-#------##-#------##-#------##-#------##-#------##-#------##
-----#---------#---------#---------#---------#---------#---------#---------#---------#---------#----
-#--#------#--#------#--#------#--#------#--#------#--#------#--#------#--#------#--#------#--#-----
##-----#-###-----#-###-----#-###-----#-###-----#-###-----#-###-----#-###-----#-###-----#-###-----#-#
#--------##--------##--------##--------##--------##--------##--------##--------##--------##--------#
--#-##--#---#-##--#---#-##--#---#-##--#---#-##--#---#-##--#---#-##--#---#-##--#---#-##--#---#-##--#-
-----#-#-------#-#-------#-#-------#-#-------#-#-------#-#-------#-#-------#-#-------#-#-------#-#--
--#-##--#---#-##--#---#-##--#---#-##--#---#-##--#---#-##--#---#-##--#---#-##--#---#-##--#---#-##--#-
------#---------#---------#---------#---------#---------#---------#---------#---------#---------#---
#--------##--------##--------##--------##--------##--------##--------##--------##--------##--------#
-#------##-#------##-#------##-#------##-#------##-#------##-#------##-#------##-#------##-#------##
-----#---------#---------#---------#---------#---------#---------#---------#---------#---------#----
-#--#------#--#------#--#------#--#------#--#------#--#------#--#------#--#------#--#------#--#-----
##-----#-###-----#-###-----#-###-----#-###-----#-###-----#-###-----#-###-----#-###-----#-###-----#-#
#--------##--------##--------##--------##--------##--------##--------##--------##--------##--------#
--#-##--#---#-##--#---#-##--#---#-##--#---#-##--#---#-##--#---#-##--#---#-##--#---#-##--#---#-##--#-
-----#-#-------#-#-------#-#-------#-#-------#-#-------#-#-------#-#-------#-#-------#-#-------#-#--
--#-##--#---#-##--#---#-##--#---#-##--#---#-##--#---#-##--#---#-##--#---#-##--#---#-##--#---#-##--#-
------#---------#---------#---------#---------#---------#---------#---------#---------#---------#---
#--------##--------##--------##--------##--------##--------##--------##--------##--------##--------#
-#------##-#------##-#------##-#------##-#------##-#------##-#------##-#------##-#------##-#------##
-----#---------#---------#---------#---------#---------#---------#---------#---------#---------#----
-#--#------#--#------#--#------#--#------#--#------#--#------#--#------#--#------#--#------#--#-----
##-----#-###-----#-###-----#-###-----#-###-----#-###-----#-###-----#-###-----#-###-----#-###-----#-#
#--------##--------##--------##--------##--------##--------##--------##--------##--------##--------#
--#-##--#---#-##--#---#-##--#---#-##--#---#-##--#---#-##--#---#-##--#---#-##--#---#-##--#---#-##--#-
-----#-#-------#-#-------#-#-------#-#-------#-#-------#-#-------#-#-------#-#-------#-#-------#-#--
--#-##--#---#-##--#---#-##--#---#-##--#---#-##--#---#-##--#---#-##--#---#-##--#---#-##--#---#-##--#-
