-----#---------#---------#---------#---------#---------#---------#---------#---------#---------#----
##--#-----##--#-----##--#-----##--#-----##--#-----##--#-----##--#-----##--#-----##--#-----##--#-----
------##-#------##-#------##-#------##-#------##-#------##-#------##-#------##-#------##-#------##-#
---#---------#---------#---------#---------#---------#---------#---------#---------#---------#------
--------#---------#---------#---------#---------#---------#---------#---------#---------#---------#-
##-##---#-##-##---#-##-##---#-##-##---#-##-##---#-##-##---#-##-##---#-##-##---#-##-##---#-##-##---#-
#-------#-#-------#-#-------#-#-------#-#-------#-#-------#-#-------#-#-------#-#-------#-#-------#-
------###-------###-------###-------###-------###-------###-------###-------###-------###-------###-
------#---------#---------#---------#---------#---------#---------#---------#---------#---------#---
##------#-##------#-##------#-##------#-##------#-##------#-##------#-##------#-##------#-##------#-
-----#---------#---------#---------#---------#---------#---------#---------#---------#---------#----
##--#-----##--#-----##--#-----##--#-----##--#-----##--#-----##--#-----##--#-----##--#-----##--#-----
------##-#------##-#------##-#------##-#------##-#------##-#------##-#------##-#------##-#------##-#
---#---------#---------#---------#---------#---------#---------#---------#---------#---------#------
--------#---------#---------#---------#---------#---------#---------#---------#---------#---------#-
##-##---#-##-##---#-##-##---#-##-##---#-##-##---#-##-##---#-##-##---#-##-##---#-##-##---#-##-##---#-
#-------#-#-------#-#-------#-#-------#-#-------#-#-------#-#-------#-#-------#-#-------#-#-------#-
------###-------###-------###-------###-------###-------###-------###-------###-------###-------###-
------#---------#---------#---------#---------#---------#---------#---------#---------#---------#---
##------#-##------#-##------#-##------#-##------#-##------#-##------#-##------#-##------#-##------#-
-----#---------#---------#---------#---------#---------#---------#---------#---------#---------#----
##--#-----##--#-----##--#-----##--#-----##--#-----##--#-----##--#-----##--#-----##--#-----##--#-----
------##-#------##-#------##-#------##-#------##-#------##-#------##-#------##-#------##-#------##-#
---#---------#---------#---------#---------#---------#---------#---------#---------#---------#------
--------#---------#---------#---------#---------#---------#---------#---------#---------#---------#-
##-##---#-##-##---#-##-##---#-##-##---#-##-##---#-##-##---#-##-##---#-##-##---#-##-##---#-##-##---#-
#-------#-#-------#-#-------#-#-------#-#-------#-#-------#-#-------#-#-------#-#-------#-#-------#-
------###-------###-------###-------###-------###-------###-------###-------###-------###-------###-
------#---------#---------#---------#---------#---------#---------#---------#---------#---------#---
##------#-##------#-##------#-##------#-##------#-##------#-##------#-##------#-##------#-##------#-
-----#---------#---------#---------#---------#---------#---------#---------#---------#---------#----
##--#-----##--#-----##--#-----##--#-----##--#-----##--#-----##--#-----##--#-----##--#-----##--#-----
------##-#------##-#------##-#------##-#------##-#------##-#------##-#------##-#------##-#------##-#
---#---------#---------#---------#---------#---------#---------#---------#---------#---------#------
--------#---------#---------#---------#---------#---------#---------#---------#---------#---------#-
##-##---#-##-##---#-##-##---#-##-##---#-##-##---#-##-##---#-##-##---#-##-##---#-##-##---#-##-##---#-
#-------#-#-------#-#-------#-#-------#-#-------#-#-------#-#-------#-#-------#-#-------#-#-------#-
------###-------###-------###-------###-------###-------###-------###-------###-------###-------###-
------#---------#---------#---------#---------#---------#---------#---------#---------#---------#---
##------#-##------#-##------#-##------#-##------#-##------#-##------#-##------#-##------#-##------#-
-----#---------#---------#---------#---------#---------#---------#---------#---------#---------#----
##--#-----##--#-----##--#-----##--#-----##--#-----##--#-----##--#-----##--#-----##--#-----##--#-----
------##-#------##-#------##-#------##-#------##-#------##-#------##-#------##-#------##-#------##-#
---#---------#---------#---------#---------#---------#---------#---------#---------#---------#------
--------#---------#---------#---------#---------#---------#---------#---------#---------#---------#-
##-##---#-##-##---#-##-##---#-##-##---#-##-##---#-##-##---#-##-##---#-##-##---#-##-##---#-##-##---#-
#-------#-#-------#-#-------#-#-------#-#-------#-#-------#-#-------#-#-------#-#-------#-#-------#-
------###-------###-------###-------###-------###-------###-------###-------###-------###-------###-
------#---------#---------#---------#---------#---------#---------#---------#---------#---------#---
##------#-##------#-##------#-##------#-##------#-##------#-##------#-##------#-##------#-##------#-
-----#---------#---------#---------#---------#---------#---------#---------#---------#---------#----
##--#-----##--#-----##--#-----##--#-----##--#-----##--#-----##--#-----##--#-----##--#-----##--#-----
------##-#------##-#------##-#------##-#------##-#------##-#------##-#------##-#------##-#------##-#
---#---------#---------#---------#---------#---------#---------#---------#---------#---------#------
--------#---------#---------#---------#---------#---------#---------#---------#---------#---------#-
##-##---#-##-##---#-##-##---#-##-##---#-##-##---#-##-##---#-##-##---#-##-##---#-##-##---#-##-##---#-
#-------#-#-------#-#-------#-#-------#-#-------#-#-------#-#-------#-#-------#-#-------#-#-------#-
------###-------###-------###-------###-------###-------###-------###-------###-------###-------###-
------#---------#---------#---------#---------#---------#---------#---------#---------#---------#---
##------#-##------#-##------#-##------#-##------#-##------#-##------#-##------#-##------#-##------#-
-----#---------#---------#---------#---------#---------#---------#---------#---------#---------#----
##--#-----##--#-----##--#-----##--#-----##--#-----##--#-----##--#-----##--#-----##--#-----##--#-----
------##-#------##-#------##-#------##-#------##-#------##-#------##-#------##-#------##-#------##-#
---#---------#---------#---------#---------#---------#---------#---------#---------#---------#------
--------#---------#---------#---------#---------#---------#---------#---------#---------#---------#-
##-##---#-##-##---#-##-##---#-##-##---#-##-##---#-##-##---#-##-##---#-##-##---#-##-##---#-##-##---#-
#-------#-#-------#-#-------#-#-------#-#-------#-#-------#-#-------#-#-------#-#-------#-#-------#-
------###-------###-------###-------###-------###-------###-------###-------###-------###-------###-
------#---------#---------#---------#---------#---------#---------#---------#---------#---------#---
##------#-##------#-##------#-##------#-##------#-##------#-##------#-##------#-##------#-##------#-
-----#---------#---------#---------#---------#---------#---------#---------#---------#---------#----
##--#-----##--#-----##--#-----##--#-----##--#-----##--#-----##--#-----##--#-----##--#-----##--#-----
------##-#------##-#------##-#------##-#------##-#------##-#------##-#------##-#------##-#------##-#
---#---------#---------#---------#---------#---------#---------#---------#---------#---------#------
--------#---------#---------#---------#---------#---------#---------#---------#---------#---------#-
##-##---#-##-##---#-##-##---#-##-##---#-##-##---#-##-##---#-##-##---#-##-##---#-##-##---#-##-##---#-
#-------#-#-------#-#-------#-#-------#-#-------#-#-------#-#-------#-#-------#-#-------#-#-------#-
------###-------###-------###-------###-------###-------###-------###-------###-------###-------###-
------#---------#---------#---------#---------#---------#---------#---------#---------#---------#---
##------#-##------#-##------#-##------#-##------#-##------#-##------#-##------#-##------#-##------#-
-----#---------#---------#---------#---------#---------#---------#---------#---------#---------#----
##--#-----##--#-----##--#-----##--#-----##--#-----##--#-----##--#-----##--#-----##--#-----##--#-----
------##-#------##-#------##-#------##-#------##-#------##-#------##-#------##-#------##-#------##-#
---#---------#---------#---------#---------#---------#---------#---------#---------#---------#------
--------#---------#---------#---------#---------#---------#---------#---------#---------#---------#-
##-##---#-##-##---#-##-##---#-##-##---#-##-##---#-##-##---#-##-##---#-##-##---#-##-##---#-##-##---#-
#-------#-#-------#-#-------#-#-------#-#-------#-#-------#-#-------#-#-------#-#-------#-#-------#-
------###-------###-------###-------###-------###-------###-------###-------###-------###-------###-
------#---------#---------#---------#---------#---------#---------#---------#---------#---------#---
##------#-##----E-#-##------#-##------#-##------#-##------#-##------#-##------#-##------#-##------#-
-----#---------#---------#---------#---------#---------#---------#---------#---------#---------#----
##--#-----##--#-----##--#-----##--#-----##--#-----##--#-----##--#-----##--#-----##--#-----##--#-----
------##-#--S---##-#------##-#------##-#------##-#------##-#------##-#------##-#------##-#------##-#
---#---------#---------#---------#---------#---------#---------#---------#---------#---------#------
--------#---------#---------#---------#---------#---------#---------#---------#---------#---------#-
##-##---#-##-##---#-##-##---#-##-##---#-##-##---#-##-##---#-##-##---#-##-##---#-##-##---#-##-##---#-
#-------#-#-------#-#-------#-#-------#-#-------#-#-------#-#-------#-#-------#-#-------#-#-------#-
------###-------###-------###-------###-------###-------###-------###-------###-------###-------###-
------#---------#---------#---------#---------#---------#---------#---------#---------#---------#---
##------#-##------#-##------#-##------#-##------#-##------#-##------#-##------#-##------#-##------#-
