-#-###--##-#-###--##-#-###--##-#-###--##-#-###--##-#-###--##-#-###--##-#-###--##-#-###--##-#-###--##
---#---#-----#---#-----#---#-----#---#-----#---#-----#---#-----#---#-----#---#-----#---#-----#---#--
##--#-----##--#-----##--#-----##--#-----##--#-----##--#-----##--#-----##--#-----##--#-----##--#-----
------#-#-------#-#-------#-#-------#-#-------#-#-------#-#-------#-#-------#-#-------#-#-------#-#-
--#-#-#-##--#-#-#-##--#-#-#-##--#-#-#-##--#-#-#-##--#-#-#-##--#-#-#-##--#-#-#-##--#-#-#-##--#-#-#-##
#--#------#--#------#--#------#--#------#--#------#--#------#--#------#--#------#--#------#--#------
-------#---------#---------#---------#S--------#---------#---------#---------#---------#---------#--
----##--#-----##--#-----##--#-----##--#-----##--#-----##--#-----##--#-----##--#-----##--#-----##--#-
----------------------------------------------------------------------------------------------------
--------##--------##--------##--------##--------##--------##--------##--------##--------##--------##
-#-###--##-#-###--##-#-###--##-#-###--##-#-###--##-#-###--##-#-###--##-#-###--##-#-###--##-#-###--##
---#---#-----#---#-----#---#-----#---#-----#---#-----#---#-----#---#-----#---#-----#---#-----#---#--
##--#-----##--#-----##--#-----##--#-----##--#-----##--#-----##--#-----##--#-----##--#-----##--#-----
------#-#-------#-#-------#-#-------#-#-------#-#-------#-#-------#-#-------#-#-------#-#-------#-#-
--#-#-#-##--#-#-#-##--#-#-#-##--#-#-#-##--#-#-#-##--#-#-#-##--#-#-#-##--#-#-#-##--#-#-#-##--#-#-#-##
#--#------#--#------#--#------#--#------#--#------#--#------#--#------#--#------#--#------#--#------
-------#---------#---------#---------#---------#---------#---------#---------#---------#---------#--
----##--#-----##--#-----##--#-----##--#-----##--#-----##--#-----##--#-----##--#-----##--#-----##--#-
----------------------------------------------------------------------------------------------------
--------##--------##--------##--------##--------##--------##--------##--------##--------##--------##
-#-###--##-#-###--##-#-###--##-#-###--##-#-###--##-#-###--##-#-###--##-#-###--##-#-###--##-#-###--##
---#---#-----#---#-----#---#-----#---#-----#---#-----#---#-----#---#-----#---#-----#---#-----#---#--
##--#-----##--#-----##--#-----##--#-----##--#-----##--#-----##--#-----##--#-----##--#-----##--#-----
------#-#-------#-#-------#-#-------#-#-------#-#-------#-#-------#-#-------#-#-------#-#-------#-#-
--#-#-#-##--#-#-#-##--#-#-#-##--#-#-#-##--#-#-#-##--#-#-#-##--#-#-#-##--#-#-#-##--#-#-#-##--#-#-#-##
#--#------#--#------#--#------#--#------#--#------#--#------#--#------#--#------#--#------#--#------
-------#---------#---------#---------#---------#---------#---------#---------#---------#---------#--
----##--#-----##--#-----##--#-----##--#-----##--#-----##--#-----##--#-----##--#-----##--#-----##--#-
----------------------------------------------------------------------------------------------------
--------##--------##--------##--------##--------##--------##--------##--------##--------##--------##
-#-###--##-#-###--##-#-###--##-#-###--##-#-###--##-#-###--##-#-###--##-#-###--##-#-###--##-#-###--##
---#---#-----#---#-----#---#-----#---#-----#---#-----#---#-----#---#-----#---#-----#---#-----#---#--
##--#-----##--#-----##--#-----##--#-----##--#-----##--#-----##--#-----##--#-----##--#-----##--#-----
------#-#-------#-#-------#-#-------#-#-------#-#-------#-#-------#-#-------#-#-------#-#-------#-#-
--#-#-#-##--#-#-#-##--#-#-#-##--#-#-#-##--#-#-#-##--#-#-#-##--#-#-#-##--#-#-#-##--#-#-#-##--#-#-#-##
#--#------#--#------#--#------#--#------#--#------#--#------#--#------#--#------#--#------#--#------
-------#---------#---------#---------#---------#---------#---------#---------#---------#---------#--
----##--#-----##--#-----##--#-----##--#-----##--#-----##--#-----##--#-----##--#-----##--#-----##--#-
----------------------------E-----------------------------------------------------------------------
--------##--------##--------##--------##--------##--------##--------##--------##--------##--------##
-#-###--##-#-###--##-#-###--##-#-###--##-#-###--##-#-###--##-#-###--##-#-###--##-#-###--##-#-###--##
---#---#-----#---#-----#---#-----#---#-----#---#-----#---#-----#---#-----#---#-----#---#-----#---#--
##--#-----##--#-----##--#-----##--#-----##--#-----##--#-----##--#-----##--#-----##--#-----##--#-----
------#-#-------#-#-------#-#-------#-#-------#-#-------#-#-------#-#-------#-#-------#-#-------#-#-
--#-#-#-##--#-#-#-##--#-#-#-##--#-#-#-##--#-#-#-##--#-#-#-##--#-#-#-##--#-#-#-##--#-#-#-##--#-#-#-##
#--#------#--#------#--#------#--#------#--#------#--#------#--#------#--#------#--#------#--#------
-------#---------#---------#---------#---------#---------#---------#---------#---------#---------#--
----##--#-----##--#-----##--#-----##--#-----##--#-----##--#-----##--#-----##--#-----##--#-----##--#-
----------------------------------------------------------------------------------------------------
--------##--------##--------##--------##--------##--------##--------##--------##--------##--------##
-#-###--##-#-###--##-#-###--##-#-###--##-#-###--##-#-###--##-#-###--##-#-###--##-#-###--##-#-###--##
---#---#-----#---#-----#---#-----#---#-----#---#-----#---#-----#---#-----#---#-----#---#-----#---#--
##--#-----##--#-----##--#-----##--#-----##--#-----##--#-----##--#-----##--#-----##--#-----##--#-----
------#-#-------#-#-------#-#-------#-#-------#-#-------#-#-------#-#-------#-#-------#-#-------#-#-
--#-#-#-##--#-#-#-##--#-#-#-##--#-#-#-##--#-#-#-##--#-#-#-##--#-#-#-##--#-#-#-##--#-#-#-##--#-#-#-##
#--#------#--#------#--#------#--#------#--#------#--#------#--#------#--#------#--#------#--#------
-------#---------#---------#---------#---------#---------#---------#---------#---------#---------#--
----##--#-----##--#-----##--#-----##--#-----##--#-----##--#-----##--#-----##--#-----##--#-----##--#-
----------------------------------------------------------------------------------------------------
--------##--------##--------##--------##--------##--------##--------##--------##--------##--------##
-#-###--##-#-###--##-#-###--##-#-###--##-#-###--##-#-###--##-#-###--##-#-###--##-#-###--##-#-###--##
---#---#-----#---#-----#---#-----#---#-----#---#-----#---#-----#---#-----#---#-----#---#-----#---#--
##--#-----##--#-----##--#-----##--#-----##--#-----##--#-----##--#-----##--#-----##--#-----##--#-----
------#-#-------#-#-------#-#-------#-#-------#-#-------#-#-------#-#-------#-#-------#-#-------#-#-
--#-#-#-##--#-#-#-##--#-#-#-##--#-#-#-##--#-#-#-##--#-#-#-##--#-#-#-##--#-#-#-##--#-#-#-##--#-#-#-##
#--#------#--#------#--#------#--#------#--#------#--#------#--#------#--#------#--#------#--#------
-------#---------#---------#---------#---------#---------#---------#---------#---------#---------#--
----##--#-----##--#-----##--#-----##--#-----##--#-----##--#-----##--#-----##--#-----##--#-----##--#-
----------------------------------------------------------------------------------------------------
--------##--------##--------##--------##--------##--------##--------##--------##--------##--------##
-#-###--##-#-###--##-#-###--##-#-###--##-#-###--##-#-###--##-#-###--##-#-###--##-#-###--##-#-###--##
---#---#-----#---#-----#---#-----#---#-----#---#-----#---#-----#---#-----#---#-----#---#-----#---#--
##--#-----##--#-----##--#-----##--#-----##--#-----##--#-----##--#-----##--#-----##--#-----##--#-----
------#-#-------#-#-------#-#-------#-#-------#-#-------#-#-------#-#-------#-#-------#-#-------#-#-
--#-#-#-##--#-#-#-##--#-#-#-##--#-#-#-##--#-#-#-##--#-#-#-##--#-#-#-##--#-#-#-##--#-#-#-##--#-#-#-##
#--#------#--#------#--#------#--#------#--#------#--#------#--#------#--#------#--#------#--#------
-------#---------#---------#---------#---------#---------#---------#---------#---------#---------#--
----##--#-----##--#-----##--#-----##--#-----##--#-----##--#-----##--#-----##--#-----##--#-----##--#-
----------------------------------------------------------------------------------------------------
--------##--------##--------##--------##--------##--------##--------##--------##--------##--------##
-#-###--##-#-###--##-#-###--##-#-###--##-#-###--##-#-###--##-#-###--##-#-###--##-#-###--##-#-###--##
---#---#-----#---#-----#---#-----#---#-----#---#-----#---#-----#---#-----#---#-----#---#-----#---#--
##--#-----##--#-----##--#-----##--#-----##--#-----##--#-----##--#-----##--#-----##--#-----##--#-----
------#-#-------#-#-------#-#-------#-#-------#-#-------#-#-------#-#-------#-#-------#-#-------#-#-
--#-#-#-##--#-#-#-##--#-#-#-##--#-#-#-##--#-#-#-##--#-#-#-##--#-#-#-##--#-#-#-##--#-#-#-##--#-#-#-##
#--#------#--#------#--#------#--#------#--#------#--#------#--#------#--#------#--#------#--#------
-------#---------#---------#---------#---------#---------#---------#---------#---------#---------#--
----##--#-----##--#-----##--#-----##--#-----##--#-----##--#-----##--#-----##--#-----##--#-----##--#-
----------------------------------------------------------------------------------------------------
--------##--------##--------##--------##--------##--------##--------##--------##--------##--------##
-#-###--##-#-###--##-#-###--##-#-###--##-#-###--##-#-###--##-#-###--##-#-###--##-#-###--##-#-###--##
---#---#-----#---#-----#---#-----#---#-----#---#-----#---#-----#---#-----#---#-----#---#-----#---#--
##--#-----##--#-----##--#-----##--#-----##--#-----##--#-----##--#-----##--#-----##--#-----##--#-----
------#-#-------#-#-------#-#-------#-#-------#-#-------#-#-------#-#-------#-#-------#-#-------#-#-
--#-#-#-##--#-#-#-##--#-#-#-##--#-#-#-##--#-#-#-##--#-#-#-##--#-#-#-##--#-#-#-##--#-#-#-##--#-#-#-##
#--#------#--#------#--#------#--#------#--#------#--#------#--#------#--#------#--#------#--#------
-------#---------#---------#---------#---------#---------#---------#---------#---------#---------#--
----##--#-----##--#-----##--#-----##--#-----##--#-----##--#-----##--#-----##--#-----##--#-----##--#-
----------------------------------------------------------------------------------------------------
--------##--------##--------##--------##--------##--------##--------##--------##--------##--------##
