-----##--------##--------##--------##--------##--------##--------##--------##--------##--------##---
#-#---##--#-#---##--#-#---##--#-#---##--#-#---##--#-#---##--#-#---##--#-#---##--#-#---##--#-#---##--
-##----##--##----##--##----##--##----##--##----##--##----##--##----##--##----##--##----##--##----##-
--#--##-----#--##-----#--##-----#--##-----#--##-----#--##-----#--##-----#--##-----#--##-----#--##---
-#--#------#--#------#--#------#--#------#--#------#--#------#--#------#--#------#--#------#--#-----
--##-----#--##-----#--##-----#--##-----#--##-----#--##-----#--##-----#--##-----#--##-----#--##-----#
-#-#-----#-#-#-----#-#-#-----#-#-#-----#-#-#-----#-#-#-----#-#-#-----#-#-#-----#-#-#-----#-#-#-----#
--#---------#---------#---------#---------#---------#---------#---------#---------#---------#-------
---------#---------#---------#---------#---------#---------#---------#---------#---------#---------#
---#-----#---#-----#---#-----#---#-----#---#-----#---#-----#---#-----#---#-----#---#-----#---#-----#
-----##--------##--------##--------##--------##--------##--------##--------##--------##--------##---
#-#---##--#-#---##--#-#---##--#-#---##--#-#---##--#-#---##--#-#---##--#-#---##--#-#---##--#-#---##--
-##----##--##----##--##----##--##----##--##----##--##----##--##----##--##----##--##----##--##----##-
--#--##-----#--##-----#--##-----#--##-----#--##-----#--##-----#--##-----#--##-----#--##-----#--##---
-#--#------#--#------#--#------#--#------#--#------#--#------#--#------#--#------#--#------#--#-----
--##-----#--##-----#--##-----#--##-----#--##-----#--##-----#--##-----#--##-----#--##-----#--##-----#
-#-#-----#-#-#-----#-#-#-----#-#-#-----#-#-#-----#-#-#-----#-#-#-----#-#-#-----#-#-#-----#-#-#-----#
--#---------#---------#---------#---------#---------#---------#---------#---------#---------#-------
---------#---------#---------#---------#---------#---------#---------#---------#---------#---------#
---#-----#---#-----#---#-----#---#-----#---#-----#---#-----#---#-----#---#-----#---#-----#---#-----#
-----##--------##--------##--------##--------##--------##--------##--------##--------##--------##---
#-#---##--#-#---##--#-#---##--#-#---##--#-#---##--#-#---##--#-#---##--#-#---##--#-#---##--#-#---##--
-##----##--##----##--##----##--##----##--##----##--##----##--##----##--##----##--##----##--##----##-
--#--##-----#--##-----#--##-----#--##-----#--##-----#--##-----#--##-----#--##-----#--##-----#--##---
-#--#------#--#------#--#------#--#------#--#------#--#------#--#------#--#------#--#------#--#-----
--##-----#--##-----#--##-----#--##-----#--##-----#--##-----#--##-----#--##-----#--##-----#--##-----#
-#-#-----#-#-#-----#-#-#-----#-#-#-----#-#-#-----#-#-#-----#-#-#-----#-#-#-----#-#-#-----#-#-#-----#
--#---------#---------#---------#---------#---------#---------#---------#---------#---------#-------
---------#---------#---------#---------#---------#---------#---------#---------#---------#---------#
---#-----#---#-----#---#-----#---#-----#---#-----#---#-----#---#-----#---#-----#---#-----#---#-----#
-----##--------##--------##--------##--------##--------##--------##--------##--------##--------##---
#-#---##--#-#---##--#-#---##--#-#---##--#-#---##--#-#---##--#-#---##--#-#---##--#-#---##--#-#---##--
-##----##--##----##--##----##--##----##--##----##--##----##--##----##--##----##--##----##--##----##-
--#--##-----#--##-----#--##-----#--##-----#--##-----#--##-----#--##-----#--##-----#--##-----#--##---
-#--#------#--#------#--#------#--#------#--#------#--#------#--#------#--#------#--#------#--#-----
--##-----#--##-----#--##-----#--##-----#--##-----#--##-----#--##-----#--##-----#--##-----#--##-----#
-#-#-----#-#-#-----#-#-#-----#-#-#-----#-#-#-----#-#-#-----#-#-#-----#-#-#-----#-#-#-----#-#-#-----#
--#---------#---------#---------#---------#---------#---------#---------#---------#---------#-------
---------#---------#---------#---------#---------#---------#---------#---------#---------#---------#
---#-----#---#-----#---#-----#---#-----#---#-----#---#-----#---#-----#---#-----#---#-----#---#-----#
-----##--------##--------##--------##--------##--------##--------##--------##--------##--------##---
#-#---##--#-#---##--#-#---##--#-#---##--#-#---##--#-#---##--#-#---##--#-#---##--#-#---##--#-#---##--
-##----##--##----##--##----##--##----##--##----##--##----##--##----##--##----##--##----##--##----##-
--#--##-----#--##-----#--##-----#--##-----#--##-----#--##-----#--##-----#--##-----#--##-----#--##---
-#--#------#--#------#--#------#--#------#--#------#--#------#--#------#--#------#--#------#--#-----
--##-----#--##-----#--##-----#--##-----#--##-----#--##-----#--##-----#--##-----#--##-----#--##-----#
-#-#-----#-#-#-----#-#-#-----#-#-#-----#-#-#-----#-#-#-----#-#-#-----#-#-#-----#-#-#-----#-#-#-----#
--#---------#---------#---------#---------#---------#---------#---------#---------#---------#-------
---------#---------#---------#---------#---------#---------#---------#---------#---------#---------#
---#-----#---#-----#---#-----#---#-----#---#-----#---#-----#---#-----#---#-----#---#-----#---#-----#
-----##--------##--------##--------##--------##--------##--------##--------##--------##--------##---
#-#---##--#-#---##--#-#---##--#-#---##--#-#---##--#-#---##--#-#---##--#-#---##--#-#---##--#-#---##--
-##----##--##----##--##----##--##----##--##----##--##----##--##----##--##----##--##----##--##----##-
--#--##-----#--##-----#--##-----#--##-----#--##-----#--##-----#--##-----#--##-----#--##-----#--##---
-#--#------#--#------#--#------#--#------#--#------#--#------#--#------#--#------#--#------#--#-----
--##-----#--##-----#--##-----#--##-----#--##-----#--##-----#--##-----#--##-----#--##-----#--##-----#
-#-#-----#-#-#-----#-#-#-----#-#-#-----#-#-#-----#-#-#-----#-#-#-----#-#-#-----#-#-#-----#-#-#-----#
--#---------#---------#---------#---------#---------#---------#---------#---------#---------#-------
---------#---------#---------#---------#---------#---------#---------#---------#---------#---------#
---#-----#---#-----#---#-----#---#-----#---#-----#---#-----#---#-----#---#-----#---#-----#---#-----#
-----##--------##--------##--------##--------##--------##--------##--------##--------##--------##---
#-#---##--#-#---##--#-#---##--#-#---##--#-#---##--#-#---##--#-#---##--#-#---##--#-#---##--#-#---##--
-##----##--##----##--##----##--##----##--##----##--##----##--##----##--##----##--##----##--##----##-
--#--##-----#--##-----#--##-----#--##-----#--##-----#--##-----#--##-----#--##-----#--##-----#--##---
-#--#------#--#------#--#------#--#------#--#------#--#------#--#------#--#------#--#------#--#-----
--##--S--#--##-----#--##-----#--##-----#--##-----#--##-----#--##-----#--##-----#--##-----#--##-----#
-#-#-----#-#-#-----#-#-#-----#-#-#-----#-#-#-----#-#-#-----#-#-#-----#-#-#-----#-#-#-----#-#-#-----#
--#---------#---------#---------#---------#---------#---------#---------#---------#---------#-------
---------#---------#---------#---------#---------#---------#---------#---------#---------#---------#
---#-----#---#-----#---#-----#---#-----#---#-----#---#-----#---#-----#---#-----#---#-----#---#-----#
-----##--------##--------##--------##--------##--------##--------##--------##--------##--------##---
#-#---##--#-#---##--#-#---##--#-#---##--#-#---##--#-#---##--#-#---##--#-#---##--#-#---##--#-#---##--
-##----##--##----##--##----##--##----##--##----##--##----##--##----##--##----##--##----##--##----##-
--#--##-----#--##-----#--##-----#--##-----#--##-----#--##-----#--##-----#--##-----#--##-----#--##---
-#--#------#--#------#--#------#--#------#--#------#--#------#--#------#--#------#--#------#--#-----
--##-----#--##-----#--##-----#--##-----#--##-----#--##-----#--##-----#--##-----#--##-----#--##-----#
-#-#-----#-#-#-----#-#-#-----#-#-#-----#-#-#-----#-#-#-----#-#-#-----#-#-#-----#-#-#-----#-#-#-----#
--#---------#---------#---------#---------#---------#---------#---------#---------#---------#-------
---------#---------#---------#---------#---------#---------#---------#---------#---------#---------#
---#-----#---#-----#---#-----#---#-----#---#-----#---#-----#---#-----#---#-----#---#-----#---#-----#
-----##--------##--------##--------##--------##--------##--------##--------##--------##--------##---
#-#---##--#-#---##--#-#---##--#-#---##--#-#---##--#-#---##--#-#---##--#-#---##--#-#---##--#-#---##--
-##----##--##----##--##----##--##----##--##----##--##----##--##----##--##----##--##----##--##----##-
--#--##-----#--##-----#--##-----#--##-----#--##-----#--##-----#--##-----#--##-----#--##-----#--##---
-#--#-----E#--#------#--#------#--#------#--#------#--#------#--#------#--#------#--#------#--#-----
--##-----#--##-----#--##-----#--##-----#--##-----#--##-----#--##-----#--##-----#--##-----#--##-----#
-#-#-----#-#-#-----#-#-#-----#-#-#-----#-#-#-----#-#-#-----#-#-#-----#-#-#-----#-#-#-----#-#-#-----#
--#---------#---------#---------#---------#---------#---------#---------#---------#---------#-------
---------#---------#---------#---------#---------#---------#---------#---------#---------#---------#
---#-----#---#-----#---#-----#---#-----#---#-----#---#-----#---#-----#---#-----#---#-----#---#-----#
-----##--------##--------##--------##--------##--------##--------##--------##--------##--------##---
#-#---##--#-#---##--#-#---##--#-#---##--#-#---##--#-#---##--#-#---##--#-#---##--#-#---##--#-#---##--
-##----##--##----##--##----##--##----##--##----##--##----##--##----##--##----##--##----##--##----##-
--#--##-----#--##-----#--##-----#--##-----#--##-----#--##-----#--##-----#--##-----#--##-----#--##---
-#--#------#--#------#--#------#--#------#--#------#--#------#--#------#--#------#--#------#--#-----
--##-----#--##-----#--##-----#--##-----#--##-----#--##-----#--##-----#--##-----#--##-----#--##-----#
-#-#-----#-#-#-----#-#-#-----#-#-#-----#-#-#-----#-#-#-----#-#-#-----#-#-#-----#-#-#-----#-#-#-----#
--#---------#---------#---------#---------#---------#---------#---------#---------#---------#-------
---------#---------#---------#---------#---------#---------#---------#---------#---------#---------#
---#-----#---#-----#---#-----#---#-----#---#-----#---#-----#---#-----#---#-----#---#-----#---#-----#
