#------#--#------#--#------#--#------#--#------#--#------#--#------#--#------#--#------#--#------#--
#---#----##---#----##---#----##---#----##---#----##---#----##---#----##---#----##---#----##---#----#
-#--#--#---#--#--#---#--#--#---#--#--#---#--#--#---#--#--#---#--#--#---#--#--#---#--#--#---#--#--#--
#-------#-#-------#-#-------#-#-------#-#-------#-#-------#-#-------#-#-------#-#-------#-#-------#-
--#---#--#--#---#--#--#---#--#--#---#--#--#---#--#--#---#--#--#---#--#--#---#--#--#---#--#--#---#--#
#---##-####---##-####---##-####---##-####---##-####---##-####---##-####---##-####---##-####---##-###
----#----#----#----#----#----#----#----#----#----#----#----#----#----#----#----#----#----#----#----#
----------------------------------------------------------------------------------------------------
-#--#------#--#------#--#------#--#------#--#------#--#------#--#------#--#------#--#------#--#-----
#--##-#---#--##-#---#--##-#---#--##-#---#--##-#---#--##-#---#--##-#---#--##-#---#--##-#---#--##-#---
#------#--#------#--#------#--#------#--#------#--#------#--#------#--#------#--#------#--#------#--
#---#----##---#----##---#----##---#----##---#----##---#----##---#----##---#----##---#----##---#----#
-#--#--#---#--#--#---#--#--#---#--#--#---#--#--#---#--#--#---#--#--#---#--#--#---#--#--#---#--#--#--
#-------#-#-------#-#-------#-#-------#-#-------#-#-------#-#-------#-#-------#-#-------#-#-------#-
--#---#--#--#---#--#--#---#--#--#---#--#--#---#--#--#---#--#--#---#--#--#---#--#--#---#--#--#---#--#
#---##-####---##-####---##-####---##-####---##-####---##-####---##-####---##-####---##-####---##-###
----#----#----#----#----#----#----#----#----#----#----#----#----#----#----#----#----#----#----#----#
----------------------------------------------------------------------------------------------------
-#--#------#--#------#--#------#--#------#--#------#--#------#--#------#--#------#--#------#--#-----
#--##-#---#--##-#---#--##-#---#--##-#---#--##-#---#--##-#---#--##-#---#--##-#---#--##-#---#--##-#---
#------#-E#------#--#------#--#------#--#------#--#------#--#------#--#------#--#------#--#------#--
#---#----##---#----##---#----##---#----##---#----##---#----##---#----##---#----##---#----##---#----#
-#--#--#---#--#--#---#--#--#---#--#--#---#--#--#---#--#--#---#--#--#---#--#--#---#--#--#---#--#--#--
#-------#-#-------#-#-------#-#-------#-#-------#-#-------#-#-------#-#-------#-#-------#-#-------#-
--#---#--#--#---#--#--#---#--#--#---#--#--#---#--#--#---#--#--#---#--#--#---#--#--#---#--#--#---#--#
#---##-####---##-####---##-####---##-####---##-####---##-####---##-####---##-####---##-####---##-###
----#----#----#----#----#----#----#----#----#----#----#----#----#----#----#----#----#----#----#----#
----------------------------------------------------------------------------------------------------
-#--#------#--#------#--#------#--#------#--#------#--#------#--#------#--#------#--#------#--#-----
#--##-#---#--##-#---#--##-#---#--##-#---#--##-#---#--##-#---#--##-#---#--##-#---#--##-#---#--##-#---
#------#--#------#--#------#--#------#--#------#--#------#--#------#--#------#--#------#--#------#--
#---#----##---#----##---#----##---#----##---#----##---#----##---#----##---#----##---#----##---#----#
-#--#--#---#--#--#---#--#--#---#--#--#---#--#--#---#--#--#---#--#--#---#--#--#---#--#--#---#--#--#--
#-------#-#-------#-#-------#-#-------#-#-------#-#-------#-#-------#-#-------#-#-------#-#-------#-
--#---#--#--#---#--#--#---#--#--#---#--#--#---#--#--#---#--#--#---#--#--#---#--#--#---#--#--#---#--#
#---##-####---##-####---##-####---##-####---##-####---##-####---##-####---##-####---##-####---##-###
----#----#----#----#----#----#----#----#----#----#----#----#----#----#----#----#----#----#----#----#
----------------------------------------------------------------------------------------------------
-#--#------#--#------#--#------#--#------#--#------#--#------#--#------#--#------#--#------#--#-----
#--##-#---#--##-#---#--##-#---#--##-#---#--##-#---#--##-#---#--##-#---#--##-#---#--##-#---#--##-#---
#------#--#------#--#------#--#------#--#------#--#------#--#------#--#------#--#------#--#------#--
#---#----##---#----##---#----##---#----##---#----##---#----##---#----##---#----##---#----##---#----#
-#--#--#---#--#--#---#--#--#---#--#--#---#--#--#---#--#--#---#--#--#---#--#--#---#--#--#---#--#--#--
#-------#-#-------#-#-------#-#-------#-#-------#-#-------#-#-------#-#-------#-#-------#-#-------#-
--#---#--#--#---#--#--#---#--#--#---#--#--#---#--#--#---#--#--#---#--#--#---#--#--#---#--#--#---#--#
#---##-####---##-####---##-####---##-####---##-####---##-####---##-####---##-####---##-####---##-###
----#----#----#----#----#----#----#----#----#----#----#----#----#----#----#----#----#----#----#----#
----------------------------------------------------------------------------------------------------
-#--#------#--#------#--#------#--#------#--#------#--#------#--#------#--#------#--#------#--#-----
#--##-#---#--##-#---#--##-#---#--##-#---#--##-#---#--##-#---#--##-#---#--##-#---#--##-#---#--##-#---
#------#--#------#--#------#--#------#--#------#--#------#--#------#--#------#--#------#--#------#--
#---#----##---#----##---#----##---#----##---#----##---#----##---#----##---#----##---#----##---#----#
-#--#--#---#--#--#---#--#--#---#--#--#---#--#--#---#--#--#---#--#--#---#--#--#---#--#--#---#--#--#--
#-------#-#-------#-#-------#-#-------#-#-------#-#-------#-#-------#-#-------#-#-------#-#-------#-
--#---#--#--#---#--#--#---#--#--#---#--#--#---#--#--#---#--#--#---#--#--#---#--#--#---#--#--#---#--#
#---##-####---##-####---##-####---##-####---##-####---##-####---##-####---##-####---##-####---##-###
----#----#----#----#----#----#----#----#----#----#----#----#----#----#----#----#----#----#----#----#
----------------------------------------------------------------------------------------------------
-#--#------#--#------#--#------#--#------#--#------#--#------#--#------#--#------#--#------#--#-----
#--##-#---#--##-#---#--##-#---#--##-#---#--##-#---#--##-#---#--##-#---#--##-#---#--##-#---#--##-#---
#------#--#------#--#------#--#------#--#------#--#------#--#------#--#------#--#------#--#------#--
#---#----##---#----##---#----##---#----##---#----##---#----##---#----##---#----##---#----##---#----#
-#--#--#---#--#--#---#--#--#---#--#--#---#--#--#---#--#--#---#--#--#---#--#--#---#--#--#---#--#--#--
#-------#-#-------#-#-------#-#-------#-#-------#-#-------#-#-------#-#-------#-#-------#-#-------#-
--#---#--#--#---#--#--#---#--#--#---#--#--#---#--#--#---#--#--#---#--#--#---#--#--#---#--#--#---#--#
#---##-####---##-####---##-####---##-####---##-####---##-####---##-####---##-####---##-####---##-###
----#----#----#----#----#----#----#----#----#----#----#----#----#----#----#----#----#----#----#----#
----------------------------------------------------------------------------------------------------
-#--#------#--#------#--#------#--#------#--#------#--#------#--#------#--#------#--#------#--#-----
#--##-#---#--##-#---#--##-#---#--##-#---#--##-#---#--##-#---#--##-#---#--##-#---#--##-#---#--##-#---
#------#--#------#--#------#--#------#--#------#--#------#--#------#--#------#--#------#--#------#--
#---#----##---#----##---#----##---#----##---#----##---#----##---#----##---#----##---#----##---#----#
-#--#--#---#--#--#---#--#--#---#--#--#---#--#--#---#--#--#---#--#--#---#--#--#---#--#--#---#--#--#--
#-------#-#-------#-#-------#-#-------#-#-------#-#-------#-#-------#-#-------#-#-------#-#-------#-
--#---#--#--#---#--#--#---#--#--#---#--#--#---#--#--#---#--#--#---#--#--#---#--#--#---#--#--#---#--#
#---##-####---##-####---##-####---##-####---##-####---##-####---##-####---##-####---##-####---##-###
----#----#----#----#----#----#----#----#----#----#----#----#----#----#----#----#----#----#----#----#
----------------------------------------------------------------------------------------------------
-#--#------#--#------#--#------#--#------#--#------#--#------#--#------#--#------#--#------#--#-----
#--##-#---#--##-#---#--##-#---#--##-#---#--##-#---#--##-#---#--##-#---#--##-#---#--##-#---#--##-#---
#------#--#------#--#------#--#------#--#------#--#------#--#------#--#------#--#------#--#------#--
#---#----##---#----##---#----##---#----##---#----##---#----##---#----##---#----##---#----##---#----#
-#--#--#---#--#--#---#--#--#---#--#--#---#--#--#---#--#--#---#--#--#---#--#--#---#--#--#---#--#--#--
#-------#-#-------#-#-------#-#-------#-#-------#-#-------#-#-------#-#-------#-#-------#-#-------#-
--#---#--#--#---#--#--#---#--#--#---#--#--#---#--#--#---#--#--#---#--#--#---#--#--#---#--#--#---#--#
#---##-####---##-####---##-####---##-####---##-####---##-####---##-####---##-####---##-####---##-###
----#----#----#----#----#----#----#----#----#----#----#----#----#----#----#----#----#----#----#----#
----------------------------------------------------------------------------------------------------
-#--#------#--#------#--#------#--#------#--#------#--#------#--#------#--#------#--#------#--#-----
#--##-#---#--##-#---#--##-#---#--##-#---#--##-#---#--##-#---#--##-#---#--##-#---#--##-#---#--##-#---
#------#--#------#--#------#--#------#--#------#--#-S----#--#------#--#------#--#------#--#------#--
#---#----##---#----##---#----##---#----##---#----##---#----##---#----##---#----##---#----##---#----#
-#--#--#---#--#--#---#--#--#---#--#--#---#--#--#---#--#--#---#--#--#---#--#--#---#--#--#---#--#--#--
#-------#-#-------#-#-------#-#-------#-#-------#-#-------#-#-------#-#-------#-#-------#-#-------#-
--#---#--#--#---#--#--#---#--#--#---#--#--#---#--#--#---#--#--#---#--#--#---#--#--#---#--#--#---#--#
#---##-####---##-####---##-####---##-####---##-####---##-####---##-####---##-####---##-####---##-###
----#----#----#----#----#----#----#----#----#----#----#----#----#----#----#----#----#----#----#----#
----------------------------------------------------------------------------------------------------
-#--#------#--#------#--#------#--#------#--#------#--#------#--#------#--#------#--#------#--#-----
#--##-#---#--##-#---#--##-#---#--##-#---#--##-#---#--##-#---#--##-#---#--##-#---#--##-#---#--##-#---
