----##--##----##--##----##--##----##--##----##--##----##--##----##--##----##--##----##--##----##--##
-#-----#-#-#-----#-#-#-----#-#-#-----#-#-#-----#-#-#-----#-#-#-----#-#-#-----#-#-#-----#-#-#-----#-#
#-------#-#-------#-#-------#-#-------#-#-------#-#-------#-#-------#-#-------#-#-------#-#-------#-
--#-#-#-----#-#-#-----#-#-#-----#-#-#-----#-#-#-----#-#-#-----#-#-#-----#-#-#-----#-#-#-----#-#-#---
#--#---#--#--#---#--#--#---#--#--#---#--#--#---#--#--#---#--#--#---#--#--#---#--#--#---#--#--#---#--
##-------###-------###-------###-------###-------###-------###-------###-------###-------###-------#
--#----##---#----##---#----##---#----##---#----##---#----##---#----##---#----##---#----##---#----##-
----------------------------------------------------------------------------------------------------
-----###-#-----###-#-----###-#-----###-#-----###-#-----###-#-----###-#-----###-#-----###-#-----###-#
-----#---------#---------#---------#---------#---------#---------#---------#---------#---------#----
----##--##----##--##----##--##----##--##----##--##----##--##----##--##----##--##----##--##----##--##
-#-----#-#-#-----#-#-#-----#-#-#-----#-#-#-----#-#-#-----#-#-#-----#-#-#-----#-#-#-----#-#-#-----#-#
#-------#-#-------#-#-------#-#-------#-#-------#-#-------#-#-------#-#-------#-#-------#-#-------#-
--#-#-#-----#-#-#-----#-#-#-----#-#-#-----#-#-#-----#-#-#-----#-#-#-----#-#-#-----#-#-#-----#-#-#---
#--#---#--#--#---#--#--#---#--#--#---#--#--#---#--#--#---#--#--#---#--#--#---#--#--#---#--#--#---#--
##-------###-------###-------###-------###-------###-------###-------###-------###-------###-------#
--#----##---#----##---#----##---#----##---#----##---#----##---#----##---#----##---#----##---#----##-
----------------------------------------------------------------------------------------------------
-----###-#-----###-#-----###-#-----###-#-----###-#-----###-#-----###-#-----###-#-----###-#-----###-#
-----#---------#---------#---------#---------#---------#---------#---------#---------#---------#----
----##--##----##--##----##--##----##--##----##--##----##--##----##--##----##--##----##--##----##--##
-#-----#-#-#-----#-#-#-----#-#-#-----#-#-#-----#-#-#-----#-#-#-----#-#-#-----#-#-#-----#-#-#-----#-#
#-------#-#-------#-#-------#-#-------#-#-------#-#-------#-#-------#-#-------#-#-------#-#-------#-
--#-#-#-----#-#-#-----#-#-#-----#-#-#-----#-#-#-----#-#-#-----#-#-#-----#-#-#-----#-#-#-----#-#-#---
#--#---#--#--#---#--#--#---#--#--#---#--#--#---#--#--#---#--#--#---#--#--#---#--#--#---#--#--#---#--
##-------###-------###-------###-------###-------###-------###-------###-------###-------###-------#
--#----##---#----##---#----##---#----##---#----##---#----##---#----##---#----##---#----##---#----##-
----------------------------------------------------------------------------------------------------
-----###-#-----###-#-----###-#-----###-#-----###-#-----###-#-----###-#-----###-#-----###-#-----###-#
-----#---------#---------#---------#---------#---------#---------#---------#---------#---------#----
----##--##----##--##----##--##----##--##----##--##----##--##----##--##----##--##----##--##----##--##
-#-----#-#-#-----#-#-#-----#-#-#-----#-#-#-----#-#-#-----#-#-#-----#-#-#-----#-#-#-----#-#-#-----#-#
#-------#-#-------#-#-------#-#-------#-#-------#-#-------#-#-------#-#-------#-#-------#-#-------#-
--#-#-#-----#-#-#-----#-#-#-----#-#-#-----#-#-#-----#-#-#-----#-#-#-----#-#-#-----#-#-#-----#-#-#---
#--#---#--#--#---#--#--#---#--#--#---#--#--#---#--#--#---#--#--#---#--#--#---#--#--#---#--#--#---#--
##-------###-------###-------###-------###-------###-------###-------###-------###-------###-------#
--#----##---#----##---#----##---#----##---#----##---#----##---#----##---#----##---#----##---#----##-
----------------------------------------------------------------------------------------------------
-----###-#-----###-#-----###-#-----###-#-----###-#-----###-#-----###-#-----###-#-----###-#-----###-#
-----#---------#---------#---------#---------#---------#---------#---------#---------#---------#----
----##--##----##--##----##--##----##--##----##--##----##--##----##--##----##--##----##--##----##--##
-#-----#-#-#-----#-#-#-----#-#-#-----#-#-#-----#-#-#-----#-#-#-----#-#-#-----#-#-#-----#-#-#-----#-#
#-------#-#-------#-#-------#-#-------#-#-------#-#-------#-#-------#-#-------#-#-------#-#-------#-
--#-#-#-----#-#-#-----#-#-#-----#-#-#-----#-#-#-----#-#-#-----#-#-#-----#-#-#-----#-#-#-----#-#-#---
#--#---#--#--#---#--#--#---#--#--#---#--#--#---#--#--#---#--#--#---#--#--#---#--#--#---#--#--#---#--
##-------###-------###-------###-------###-------###-------###-------###-------###-------###-------#
--#----##---#----##---#----##---#----##---#----##---#----##---#----##---#----##---#----##---#----##-
----------------------------------------------------------------------------------------------------
-----###-#-----###-#-----###-#-----###-#-----###-#-----###-#-----###-#-----###-#-----###-#-----###-#
-----#---------#---------#---------#---------#---------#---------#---------#---------#---------#----
----##--##----##--##----##--##----##--##----##--##----##--##----##--##----##--##----##--##----##--##
-#-----#-#-#-----#-#-#-----#-#-#-----#-#-#-----#-#-#-----#-#-#-----#-#-#-----#-#-#-----#-#-#-----#-#
#-------#-#-------#-#-------#-#-------#-#-------#-#-------#-#-------#-#-------#-#-------#-#-------#-
--#-#-#-----#-#-#-----#-#-#-----#-#-#-----#-#-#-----#-#-#-----#-#-#-----#-#-#-----#-#-#-----#-#-#---
#--#---#--#--#---#--#--#---#--#--#---#--#--#---#--#--#---#--#--#---#--#--#---#--#--#---#--#--#---#--
##-------###-------###-------###-------###-------###-------###-------###-------###-------###-------#
--#----##---#----##---#----##---#----##---#----##---#----##---#----##---#----##---#----##---#----##-
----------------------------------------------------------------------------------------------------
-----###-#-----###-#-----###-#-----###-#-----###-#-----###-#-----###-#-----###-#-----###-#-----###-#
-----#---------#---------#---------#---------#---------#---------#---------#---------#---------#----
----##--##----##S-##----##--##----##--##----##--##----##--##----##--##----##--##----##--##----##--##
-#-----#-#-#-----#-#-#-----#-#-#-----#-#-#-----#-#-#-----#-#-#-----#-#-#-----#-#-#-----#-#-#-----#-#
#-------#-#-------#-#-------#-#-------#-#-------#-#-------#-#-------#-#-------#-#-------#-#-------#-
--#-#-#-----#-#-#-----#-#-#-----#-#-#-----#-#-#-----#-#-#-----#-#-#-----#-#-#-----#-#-#-----#-#-#---
#--#---#--#--#---#--#--#---#--#--#---#--#--#---#--#--#---#--#--#---#--#--#---#--#--#---#--#--#---#--
##-------###-------###-------###-------###-------###-------###-------###-------###-------###-------#
--#----##---#----##---#----##---#----##---#----##---#----##---#----##---#----##---#----##---#----##-
----------------------------------------------------------------------------------------------------
-----###-#-----###-#-----###-#-----###-#-----###-#-----###-#-----###-#-----###-#-----###-#-----###-#
-----#---------#---------#---------#---------#---------#---------#---------#---------#---------#----
----##--##----##--##----##--##----##--##----##--##----##--##----##--##----##--##----##--##----##--##
-#-----#-#-#-----#-#-#-----#-#-#-----#-#-#-----#-#-#-----#-#-#-----#-#-#-----#-#-#-----#-#-#-----#-#
#-------#-#-------#-#-------#-#-------#-#-------#-#-------#-#-------#-#-------#-#-------#-#-------#-
--#-#-#-----#-#-#-----#-#-#-----#-#-#-----#-#-#-----#-#-#-----#-#-#-----#-#-#-----#-#-#-----#-#-#---
#--#---#--#--#---#--#--#---#--#--#---#--#--#---#--#--#---#--#--#---#--#--#---#--#--#---#--#--#---#--
##-------###-------###-------###-------###-------###-------###-------###-------###-------###-------#
--#----##---#----##---#----##---#----##---#----##---#----##---#----##---#----##---#----##---#----##-
----------------------------------------------------------------------------------------------------
-----###-#-----###-#-----###-#-----###-#-----###-#-----###-#-----###-#-----###-#-----###-#-----###-#
-----#---------#---------#---------#---------#---------#---------#---------#---------#---------#----
----##--##----##--##----##--##----##--##----##--##----##--##----##--##----##--##----##--##----##--##
-#-----#-#-#-----#-#-#-----#-#-#-----#-#-#-----#-#-#-----#-#-#-----#-#-#-----#-#-#-----#-#-#-----#-#
#-------#-#-------#-#-------#-#-------#-#-------#-#-------#-#-------#-#-------#-#-------#-#-------#-
--#-#-#-----#-#-#-----#-#-#-----#-#-#-----#-#-#-----#-#-#-----#-#-#-----#-#-#-----#-#-#-----#-#-#---
#--#---#--#--#---#--#--#---#--#--#---#--#--#---#--#--#---#--#--#---#--#--#---#--#--#---#--#--#---#--
##-------###-------###-------###-------###-------###-------###-------###-------###-------###-------#
--#----##---#----##---#----##---#----##---#----##---#----##---#----##---#----##---#----##---#----##-
----------------------------------------------------------------------------------------------------
-----###-#-----###-#-----###-#-----###-#-----###-#-----###-#-----###-#-----###-#---E-###-#-----###-#
-----#---------#---------#---------#---------#---------#---------#---------#---------#---------#----
----##--##----##--##----##--##----##--##----##--##----##--##----##--##----##--##----##--##----##--##
-#-----#-#-#-----#-#-#-----#-#-#-----#-#-#-----#-#-#-----#-#-#-----#-#-#-----#-#-#-----#-#-#-----#-#
#-------#-#-------#-#-------#-#-------#-#-------#-#-------#-#-------#-#-------#-#-------#-#-------#-
--#-#-#-----#-#-#-----#-#-#-----#-#-#-----#-#-#-----#-#-#-----#-#-#-----#-#-#-----#-#-#-----#-#-#---
#--#---#--#--#---#--#--#---#--#--#---#--#--#---#--#--#---#--#--#---#--#--#---#--#--#---#--#--#---#--
##-------###-------###-------###-------###-------###-------###-------###-------###-------###-------#
--#----##---#----##---#----##---#----##---#----##---#----##---#----##---#----##---#----##---#----##-
----------------------------------------------------------------------------------------------------
-----###-#-----###-#-----###-#-----###-#-----###-#-----###-#-----###-#-----###-#-----###-#-----###-#
-----#---------#---------#---------#---------#---------#---------#---------#---------#---------#----
