---------#---------#---------#---------#---------#---------#---------#---------#---------#---------#
----#--#------#--#------#--#------#--#------#--#------#--#------#--#------#--#------#--#------#--#--
----------------------------------------------------------------------------------------------------
--#--#-#-#--#--#-#-#--#--#-#-#--#--#-#-#--#--#-#-#--#--#-#-#--#--#-#-#--#--#-#-#--#--#-#-#--#--#-#-#
-----#-#-------#-#-------#-#-------#-#-------#-#-------#-#-------#-#-------#-#-------#-#-------#-#--
-----####------####------####------####------####------####------####------####------####------####-
-#--##-###-#--##-###-#--##-###-#--##-###-#--##-###-#--##-###-#--##-###-#--##-###E#--##-###-#--##-###
-----#--##-----#--##-----#--##-----#--##-----#--##-----#--##-----#--##-----#--##-----#--##-----#--##
----------------------------------------------------------------------------------------------------
-#-#--#-#--#-#--#-#--#-#--#-#--#-#--#-#--#-#--#-#--#-#--#-#--#-#--#-#--#-#--#-#--#-#--#-#--#-#--#-#-
---------#---------#---------#---------#---------#---------#---------#---------#---------#---------#
----#--#------#--#------#--#------#--#------#--#------#--#------#--#------#--#------#--#------#--#--
----------------------------------------------------------------------------------------------------
--#--#-#-#--#--#-#-#--#--#-#-#--#--#-#-#--#--#-#-#--#--#-#-#--#--#-#-#--#--#-#-#--#--#-#-#--#--#-#-#
-----#-#-------#-#-------#-#-------#-#-------#-#-------#-#-------#-#-------#-#-------#-#-------#-#--
-----####------####------####------####------####------####------####------####------####------####-
-#--##-###-#--##-###-#--##-###-#--##-###-#--##-###-#--##-###-#--##-###-#--##-###-#--##-###-#--##-###
-----#--##-----#--##-----#--##-----#--##-----#--##-----#--##-----#--##-----#--##-----#--##-----#--##
----------------------------------------------------------------------------------------------------
-#-#--#-#--#-#--#-#--#-#--#-#--#-#--#-#--#-#--#-#--#-#--#-#--#-#--#-#--#-#--#-#--#-#--#-#--#-#--#-#-
---------#---------#---------#---------#---------#---------#---------#---------#---------#---------#
----#--#------#--#------#--#------#--#------#--#------#--#------#--#------#--#------#--#------#--#--
----------------------------------------------------------------------------------------------------
--#--#-#-#--#--#-#-#--#--#-#-#--#--#-#-#--#--#-#-#--#--#-#-#--#--#-#-#--#--#-#-#--#--#-#-#--#--#-#-#
-----#-#-------#-#-------#-#-------#-#-------#-#-------#-#-------#-#-------#-#-------#-#-------#-#--
-----####------####------####------####------####------####------####------####------####------####-
-#--##-###-#--##-###-#--##-###-#--##-###-#--##-###-#--##-###-#--##-###-#--##-###-#--##-###-#--##-###
-----#--##-----#--##-----#--##-----#--##-----#--##-----#--##-----#--##-----#--##-----#--##-----#--##
----------------------------------------------------------------------------------------------------
-#-#--#-#--#S#--#-#--#-#--#-#--#-#--#-#--#-#--#-#--#-#--#-#--#-#--#-#--#-#--#-#--#-#--#-#--#-#--#-#-
---------#---------#---------#---------#---------#---------#---------#---------#---------#---------#
----#--#------#--#------#--#------#--#------#--#------#--#------#--#------#--#------#--#------#--#--
----------------------------------------------------------------------------------------------------
--#--#-#-#--#--#-#-#--#--#-#-#--#--#-#-#--#--#-#-#--#--#-#-#--#--#-#-#--#--#-#-#--#--#-#-#--#--#-#-#
-----#-#-------#-#-------#-#-------#-#-------#-#-------#-#-------#-#-------#-#-------#-#-------#-#--
-----####------####------####------####------####------####------####------####------####------####-
-#--##-###-#--##-###-#--##-###-#--##-###-#--##-###-#--##-###-#--##-###-#--##-###-#--##-###-#--##-###
-----#--##-----#--##-----#--##-----#--##-----#--##-----#--##-----#--##-----#--##-----#--##-----#--##
----------------------------------------------------------------------------------------------------
-#-#--#-#--#-#--#-#--#-#--#-#--#-#--#-#--#-#--#-#--#-#--#-#--#-#--#-#--#-#--#-#--#-#--#-#--#-#--#-#-
---------#---------#---------#---------#---------#---------#---------#---------#---------#---------#
----#--#------#--#------#--#------#--#------#--#------#--#------#--#------#--#------#--#------#--#--
----------------------------------------------------------------------------------------------------
--#--#-#-#--#--#-#-#--#--#-#-#--#--#-#-#--#--#-#-#--#--#-#-#--#--#-#-#--#--#-#-#--#--#-#-#--#--#-#-#
-----#-#-------#-#-------#-#-------#-#-------#-#-------#-#-------#-#-------#-#-------#-#-------#-#--
-----####------####------####------####------####------####------####------####------####------####-
-#--##-###-#--##-###-#--##-###-#--##-###-#--##-###-#--##-###-#--##-###-#--##-###-#--##-###-#--##-###
-----#--##-----#--##-----#--##-----#--##-----#--##-----#--##-----#--##-----#--##-----#--##-----#--##
----------------------------------------------------------------------------------------------------
-#-#--#-#--#-#--#-#--#-#--#-#--#-#--#-#--#-#--#-#--#-#--#-#--#-#--#-#--#-#--#-#--#-#--#-#--#-#--#-#-
---------#---------#---------#---------#---------#---------#---------#---------#---------#---------#
----#--#------#--#------#--#------#--#------#--#------#--#------#--#------#--#------#--#------#--#--
----------------------------------------------------------------------------------------------------
--#--#-#-#--#--#-#-#--#--#-#-#--#--#-#-#--#--#-#-#--#--#-#-#--#--#-#-#--#--#-#-#--#--#-#-#--#--#-#-#
-----#-#-------#-#-------#-#-------#-#-------#-#-------#-#-------#-#-------#-#-------#-#-------#-#--
-----####------####------####------####------####------####------####------####------####------####-
-#--##-###-#--##-###-#--##-###-#--##-###-#--##-###-#--##-###-#--##-###-#--##-###-#--##-###-#--##-###
-----#--##-----#--##-----#--##-----#--##-----#--##-----#--##-----#--##-----#--##-----#--##-----#--##
----------------------------------------------------------------------------------------------------
-#-#--#-#--#-#--#-#--#-#--#-#--#-#--#-#--#-#--#-#--#-#--#-#--#-#--#-#--#-#--#-#--#-#--#-#--#-#--#-#-
---------#---------#---------#---------#---------#---------#---------#---------#---------#---------#
----#--#------#--#------#--#------#--#------#--#------#--#------#--#------#--#------#--#------#--#--
----------------------------------------------------------------------------------------------------
--#--#-#-#--#--#-#-#--#--#-#-#--#--#-#-#--#--#-#-#--#--#-#-#--#--#-#-#--#--#-#-#--#--#-#-#--#--#-#-#
-----#-#-------#-#-------#-#-------#-#-------#-#-------#-#-------#-#-------#-#-------#-#-------#-#--
-----####------####------####------####------####------####------####------####------####------####-
-#--##-###-#--##-###-#--##-###-#--##-###-#--##-###-#--##-###-#--##-###-#--##-###-#--##-###-#--##-###
-----#--##-----#--##-----#--##-----#--##-----#--##-----#--##-----#--##-----#--##-----#--##-----#--##
----------------------------------------------------------------------------------------------------
-#-#--#-#--#-#--#-#--#-#--#-#--#-#--#-#--#-#--#-#--#-#--#-#--#-#--#-#--#-#--#-#--#-#--#-#--#-#--#-#-
---------#---------#---------#---------#---------#---------#---------#---------#---------#---------#
----#--#------#--#------#--#------#--#------#--#------#--#------#--#------#--#------#--#------#--#--
----------------------------------------------------------------------------------------------------
--#--#-#-#--#--#-#-#--#--#-#-#--#--#-#-#--#--#-#-#--#--#-#-#--#--#-#-#--#--#-#-#--#--#-#-#--#--#-#-#
-----#-#-------#-#-------#-#-------#-#-------#-#-------#-#-------#-#-------#-#-------#-#-------#-#--
-----####------####------####------####------####------####------####------####------####------####-
-#--##-###-#--##-###-#--##-###-#--##-###-#--##-###-#--##-###-#--##-###-#--##-###-#--##-###-#--##-###
-----#--##-----#--##-----#--##-----#--##-----#--##-----#--##-----#--##-----#--##-----#--##-----#--##
----------------------------------------------------------------------------------------------------
-#-#--#-#--#-#--#-#--#-#--#-#--#-#--#-#--#-#--#-#--#-#--#-#--#-#--#-#--#-#--#-#--#-#--#-#--#-#--#-#-
---------#---------#---------#---------#---------#---------#---------#---------#---------#---------#
----#--#------#--#------#--#------#--#------#--#------#--#------#--#------#--#------#--#------#--#--
----------------------------------------------------------------------------------------------------
--#--#-#-#--#--#-#-#--#--#-#-#--#--#-#-#--#--#-#-#--#--#-#-#--#--#-#-#--#--#-#-#--#--#-#-#--#--#-#-#
-----#-#-------#-#-------#-#-------#-#-------#-#-------#-#-------#-#-------#-#-------#-#-------#-#--
-----####------####------####------####------####------####------####------####------####------####-
-#--##-###-#--##-###-#--##-###-#--##-###-#--##-###-#--##-###-#--##-###-#--##-###-#--##-###-#--##-###
-----#--##-----#--##-----#--##-----#--##-----#--##-----#--##-----#--##-----#--##-----#--##-----#--##
----------------------------------------------------------------------------------------------------
-#-#--#-#--#-#--#-#--#-#--#-#--#-#--#-#--#-#--#-#--#-#--#-#--#-#--#-#--#-#--#-#--#-#--#-#--#-#--#-#-
---------#---------#---------#---------#---------#---------#---------#---------#---------#---------#
----#--#------#--#------#--#------#--#------#--#------#--#------#--#------#--#------#--#------#--#--
----------------------------------------------------------------------------------------------------
--#--#-#-#--#--#-#-#--#--#-#-#--#--#-#-#--#--#-#-#--#--#-#-#--#--#-#-#--#--#-#-#--#--#-#-#--#--#-#-#
-----#-#-------#-#-------#-#-------#-#-------#-#-------#-#-------#-#-------#-#-------#-#-------#-#--
-----####------####------####------####------####------####------####------####------####------####-
-#--##-###-#--##-###-#--##-###-#--##-###-#--##-###-#--##-###-#--##-###-#--##-###-#--##-###-#--##-###
-----#--##-----#--##-----#--##-----#--##-----#--##-----#--##-----#--##-----#--##-----#--##-----#--##
----------------------------------------------------------------------------------------------------
-#-#--#-#--#-#--#-#--#-#--#-#--#-#--#-#--#-#--#-#--#-#--#-#--#-#--#-#--#-#--#-#--#-#--#-#--#-#--#-#-
