---#-#-###---#-#-###---#-#-###---#-#-###---#-#-###---#-#-###---#-#-###---#-#-###---#-#-###---#-#-###
##-#----#-##-#----#-##-#----#-##-#----#-##-#----#-##-#----#-##-#----#-##-#----#-##-#----#-##-#----#-
#--#------#--#------#--#------#--#------#--#------#--#------#--#------#--#------#--#------#--#------
-###---#---###---#---###---#---###---#---###---#---###---#---###---#---###---#---###---#---###---#--
-#----#----#----#----#----#----#----#----#----#----#----#----#----#----#----#----#----#----#----#---
-----#---------#---------#---------#---------#---------#---------#---------#---------#---------#----
---#-----#---#-----#---#-----#---#-----#---#-----#---#-----#---#-----#---#-----#---#-----#---#-----#
---#--#--#---#--#--#---#--#--#---#--#--#---#--#--#---#--#--#---#--#--#E--#--#--#---#--#--#---#--#--#
-#-#-#---#-#-#-#---#-#-#-#---#-#-#-#---#-#-#-#---#-#-#-#---#-#-#-#---#-#-#-#---#-#-#-#---#-#-#-#---#
#---------#---------#---------#---------#---------#---------#---------#---------#---------#---------
---#-#-###---#-#-###---#-#-###---#-#-###---#-#-###---#-#-###---#-#-###---#-#-###---#-#-###---#-#-###
##-#----#-##-#----#-##-#----#-##-#----#-##-#----#-##-#----#-##-#----#-##-#----#-##-#----#-##-#----#-
#--#------#--#------#--#------#--#------#--#------#--#------#--#------#--#------#--#------#--#------
-###---#---###---#---###---#---###---#---###---#---###---#---###---#---###---#---###---#---###---#--
-#----#----#----#----#----#----#----#----#----#----#----#----#----#----#----#----#----#----#----#---
-----#---------#---------#---------#---------#---------#---------#---------#---------#---------#----
---#-----#---#-----#---#-----#---#-----#---#-----#---#-----#---#-----#---#-----#---#-----#---#-----#
---#--#--#---#--#--#---#--#--#---#--#--#---#--#--#---#--#--#---#--#--#---#--#--#---#--#--#---#--#--#
-#-#-#---#-#-#-#---#-#-#-#---#-#-#-#---#-#-#-#---#-#-#-#---#-#-#-#---#-#-#-#---#-#-#-#---#-#-#-#---#
#---------#---------#---------#---------#---------#---------#---------#---------#---------#---------
---#-#-###---#-#-###---#-#-###---#-#-###---#-#-###---#-#-###---#-#-###---#-#-###---#-#-###---#-#-###
##-#----#-##-#----#-##-#----#-##-#----#-##-#----#-##-#----#-##-#----#-##-#----#-##-#----#-##-#----#-
#--#------#--#------#--#------#--#------#--#------#--#------#--#------#--#------#--#------#--#------
-###---#---###---#---###---#---###---#---###---#---###---#---###---#---###---#---###---#---###---#--
-#----#----#----#----#----#----#----#----#----#----#----#----#----#----#----#----#----#----#----#---
-----#---------#---------#---------#---------#---------#---------#---------#---------#---------#----
---#-----#---#-----#---#-----#---#-----#---#-----#---#-----#---#-----#---#-----#---#-----#---#-----#
---#--#--#---#--#--#---#--#--#---#--#--#---#--#--#---#--#--#---#--#--#---#--#--#---#--#--#---#--#--#
-#-#-#---#-#-#-#---#-#-#-#---#-#-#-#---#-#-#-#---#-#-#-#---#-#-#-#---#-#-#-#---#-#-#-#---#-#-#-#---#
#---------#---------#---------#---------#---------#---------#---------#---------#---------#---------
---#-#-###---#-#-###---#-#-###---#-#-###---#-#-###---#-#-###---#-#-###---#-#-###---#-#-###---#-#-###
##-#----#-##-#----#-##-#----#-##-#----#-##-#----#-##-#----#-##-#----#-##-#----#-##-#----#-##-#----#-
#--#------#--#------#--#------#--#------#--#------#--#------#--#------#--#------#--#------#--#------
-###---#---###---#---###---#---###---#---###---#---###---#---###---#---###---#---###---#---###---#--
-#----#----#----#----#----#----#----#----#----#----#----#----#----#----#----#----#----#----#----#---
-----#---------#---------#---------#---------#---------#---------#---------#---------#---------#----
---#-----#---#-----#---#-----#---#-----#---#-----#---#-----#---#-----#---#-----#---#-----#---#-----#
---#--#--#---#--#--#---#--#--#---#--#--#---#--#--#---#--#--#---#--#--#---#--#--#---#--#--#---#--#--#
-#-#-#---#-#-#-#---#-#-#-#---#-#-#-#---#-#-#-#---#-#-#-#---#-#-#-#---#-#-#-#---#-#-#-#---#-#-#-#---#
#---------#---------#---------#---------#---------#---------#---------#---------#---------#---------
---#-#-###---#-#-###---#-#-###---#-#-###---#-#-###---#-#-###---#-#-###---#-#-###---#-#-###---#-#-###
##-#----#-##-#----#-##-#----#-##-#----#-##-#----#-##-#----#-##-#----#-##-#----#-##-#----#-##-#----#-
#--#------#--#------#--#------#--#------#--#------#--#------#--#------#--#------#--#------#--#------
-###---#---###---#---###---#---###---#---###---#---###---#---###---#---###---#---###---#---###---#--
-#----#----#----#----#----#----#----#----#----#----#----#----#----#----#----#----#----#----#----#---
-----#---------#---------#---------#---------#---------#---------#---------#---------#---------#----
---#-----#---#-----#---#-----#---#-----#---#-----#---#-----#---#-----#---#-----#---#-----#---#-----#
---#--#--#---#--#--#---#--#--#---#--#--#---#--#--#---#--#--#---#--#--#---#--#--#---#--#--#---#--#--#
-#-#-#---#-#-#-#---#-#-#-#---#-#-#-#---#-#-#-#---#-#-#-#---#-#-#-#---#-#-#-#---#-#-#-#---#-#-#-#---#
#---------#---------#---------#---------#---------#---------#---------#---------#---------#---------
---#-#-###---#-#-###---#-#-###---#-#-###---#-#-###---#-#-###---#-#-###---#-#-###---#-#-###---#-#-###
##-#----#-##-#----#-##-#----#-##-#----#-##-#----#-##-#----#-##-#----#-##-#----#-##-#----#-##-#----#-
#--#------#--#------#--#------#--#------#--#------#--#------#--#------#--#------#--#------#--#------
-###---#---###---#---###---#---###---#---###---#---###---#---###---#---###---#---###---#---###---#--
-#----#----#----#----#----#----#----#----#----#----#----#----#----#----#----#----#----#----#----#---
-----#-----S---#---------#---------#---------#---------#---------#---------#---------#---------#----
---#-----#---#-----#---#-----#---#-----#---#-----#---#-----#---#-----#---#-----#---#-----#---#-----#
---#--#--#---#--#--#---#--#--#---#--#--#---#--#--#---#--#--#---#--#--#---#--#--#---#--#--#---#--#--#
-#-#-#---#-#-#-#---#-#-#-#---#-#-#-#---#-#-#-#---#-#-#-#---#-#-#-#---#-#-#-#---#-#-#-#---#-#-#-#---#
#---------#---------#---------#---------#---------#---------#---------#---------#---------#---------
---#-#-###---#-#-###---#-#-###---#-#-###---#-#-###---#-#-###---#-#-###---#-#-###---#-#-###---#-#-###
##-#----#-##-#----#-##-#----#-##-#----#-##-#----#-##-#----#-##-#----#-##-#----#-##-#----#-##-#----#-
#--#------#--#------#--#------#--#------#--#------#--#------#--#------#--#------#--#------#--#------
-###---#---###---#---###---#---###---#---###---#---###---#---###---#---###---#---###---#---###---#--
-#----#----#----#----#----#----#----#----#----#----#----#----#----#----#----#----#----#----#----#---
-----#---------#---------#---------#---------#---------#---------#---------#---------#---------#----
---#-----#---#-----#---#-----#---#-----#---#-----#---#-----#---#-----#---#-----#---#-----#---#-----#
---#--#--#---#--#--#---#--#--#---#--#--#---#--#--#---#--#--#---#--#--#---#--#--#---#--#--#---#--#--#
-#-#-#---#-#-#-#---#-#-#-#---#-#-#-#---#-#-#-#---#-#-#-#---#-#-#-#---#-#-#-#---#-#-#-#---#-#-#-#---#
#---------#---------#---------#---------#---------#---------#---------#---------#---------#---------
---#-#-###---#-#-###---#-#-###---#-#-###---#-#-###---#-#-###---#-#-###---#-#-###---#-#-###---#-#-###
##-#----#-##-#----#-##-#----#-##-#----#-##-#----#-##-#----#-##-#----#-##-#----#-##-#----#-##-#----#-
#--#------#--#------#--#------#--#------#--#------#--#------#--#------#--#------#--#------#--#------
-###---#---###---#---###---#---###---#---###---#---###---#---###---#---###---#---###---#---###---#--
-#----#----#----#----#----#----#----#----#----#----#----#----#----#----#----#----#----#----#----#---
-----#---------#---------#---------#---------#---------#---------#---------#---------#---------#----
---#-----#---#-----#---#-----#---#-----#---#-----#---#-----#---#-----#---#-----#---#-----#---#-----#
---#--#--#---#--#--#---#--#--#---#--#--#---#--#--#---#--#--#---#--#--#---#--#--#---#--#--#---#--#--#
-#-#-#---#-#-#-#---#-#-#-#---#-#-#-#---#-#-#-#---#-#-#-#---#-#-#-#---#-#-#-#---#-#-#-#---#-#-#-#---#
#---------#---------#---------#---------#---------#---------#---------#---------#---------#---------
---#-#-###---#-#-###---#-#-###---#-#-###---#-#-###---#-#-###---#-#-###---#-#-###---#-#-###---#-#-###
##-#----#-##-#----#-##-#----#-##-#----#-##-#----#-##-#----#-##-#----#-##-#----#-##-#----#-##-#----#-
#--#------#--#------#--#------#--#------#--#------#--#------#--#------#--#------#--#------#--#------
-###---#---###---#---###---#---###---#---###---#---###---#---###---#---###---#---###---#---###---#--
-#----#----#----#----#----#----#----#----#----#----#----#----#----#----#----#----#----#----#----#---
-----#---------#---------#---------#---------#---------#---------#---------#---------#---------#----
---#-----#---#-----#---#-----#---#-----#---#-----#---#-----#---#-----#---#-----#---#-----#---#-----#
---#--#--#---#--#--#---#--#--#---#--#--#---#--#--#---#--#--#---#--#--#---#--#--#---#--#--#---#--#--#
-#-#-#---#-#-#-#---#-#-#-#---#-#-#-#---#-#-#-#---#-#-#-#---#-#-#-#---#-#-#-#---#-#-#-#---#-#-#-#---#
#---------#---------#---------#---------#---------#---------#---------#---------#---------#---------
---#-#-###---#-#-###---#-#-###---#-#-###---#-#-###---#-#-###---#-#-###---#-#-###---#-#-###---#-#-###
##-#----#-##-#----#-##-#----#-##-#----#-##-#----#-##-#----#-##-#----#-##-#----#-##-#----#-##-#----#-
#--#------#--#------#--#------#--#------#--#------#--#------#--#------#--#------#--#------#--#------
-###---#---###---#---###---#---###---#---###---#---###---#---###---#---###---#---###---#---###---#--
-#----#----#----#----#----#----#----#----#----#----#----#----#----#----#----#----#----#----#----#---
-----#---------#---------#---------#---------#---------#---------#---------#---------#---------#----
---#-----#---#-----#---#-----#---#-----#---#-----#---#-----#---#-----#---#-----#---#-----#---#-----#
---#--#--#---#--#--#---#--#--#---#--#--#---#--#--#---#--#--#---#--#--#---#--#--#---#--#--#---#--#--#
-#-#-#---#-#-#-#---#-#-#-#---#-#-#-#---#-#-#-#---#-#-#-#---#-#-#-#---#-#-#-#---#-#-#-#---#-#-#-#---#
#---------#---------#---------#---------#---------#---------#---------#---------#---------#---------
