#--#-#---##--#-#---##--#-#---##--#-#---##--#-#---##--#-#---##--#-#---##--#-#---##--#-#---##--#-#---#
###-------###-------###-------###-------###-------###-------###-------###-------###-------###-------
----#--#-#----#--#-#----#--#-#----#--#-#----#--#-#----#--#-#----#--#-#----#--#-#----#--#-#----#--#-#
-#-#-------#-#-------#-#-------#-#-------#-#-------#-#-------#-#-------#-#-------#-#-------#-#------
--#-----##--#-----##--#-----##--#-----##--#-----##--#-----##--#-----##--#-----##--#-----##--#-----##
----#--#------#--#------#--#------#--#------#--#------#--#------#--#------#--#------#--#------#--#--
-------##--------##--------##--------##--------##--------##--------##--------##--------##--------##-
-#--#------#--#------#--#------#--#------#--#------#--#------#--#------#--#------#--#------#--#-----
#------#--#------#--#------#--#------#--#------#--#------#--#------#--#------#--#------#--#------#--
-#--#------#--#------#--#------#--#------#--#------#--#------#--#------#--#------#--#------#--#-----
#--#-#---##--#-#---##--#-#---##--#-#---##--#-#---##--#-#---##--#-#---##--#-#---##--#-#---##--#-#---#
###-------###-------###-------###-------###-------###-------###-------###-------###-------###-------
----#--#-#----#--#-#----#--#-#----#--#-#----#--#-#----#--#-#----#--#-#----#--#-#----#--#-#----#--#-#
-#-#-------#-#-------#-#-------#-#-------#-#-------#-#-------#-#-------#-#-------#-#-------#-#------
--#-----##--#-----##--#-----##--#-----##--#-----##--#-----##--#-----##--#-----##--#-----##--#-----##
----#--#------#--#------#--#------#--#------#--#------#--#------#--#------#--#------#--#------#--#--
-------##--------##--------##--------##--------##--------##--------##--------##--------##--------##-
-#--#------#--#------#--#------#--#------#--#------#--#------#--#------#--#------#--#------#--#-----
#------#--#------#--#------#--#------#--#------#--#------#--#------#--#------#--#------#--#------#--
-#--#------#--#------#--#------#--#------#--#------#--#------#--#------#--#------#--#------#--#-----
#--#-#---##--#-#---##--#-#---##--#-#---##--#-#---##--#-#---##--#-#---##--#-#---##--#-#---##--#-#---#
###-------###-------###-------###-------###-------###-------###-------###-------###-------###-------
----#--#-#----#--#-#----#--#-#----#--#-#----#--#-#----#--#-#----#--#-#----#--#-#----#--#-#----#--#-#
-#-#-------#-#-------#-#-------#-#-------#-#-------#-#-------#-#-------#-#-------#-#-------#-#------
--#-----##--#-----##--#-----##--#-----##--#-----##--#-----##--#-----##--#-----##--#-----##--#-----##
----#--#------#--#------#--#------#--#------#--#------#--#------#--#------#--#------#--#------#--#--
-------##--------##--------##--------##--------##--------##--------##--------##--------##--------##-
-#--#------#--#------#--#------#--#------#--#------#--#------#--#------#--#------#--#------#--#-----
#------#--#------#--#------#--#------#--#------#--#------#--#------#--#------#--#------#--#------#--
-#--#------#--#------#--#------#--#------#--#------#--#------#--#------#--#------#--#------#--#-----
#--#-#---##--#-#---##--#-#---##--#-#---##--#-#---##--#-#---##--#-#---##--#-#---##--#-#---##--#-#---#
###-------###-------###-------###-------###-------###-------###-------###-------###-------###-------
----#--#-#----#--#-#----#--#-#----#--#-#----#--#-#----#--#-#----#--#-#----#--#-#----#--#-#----#--#-#
-#-#-------#-#-------#-#-------#-#-------#-#-------#-#-------#-#-------#-#-------#-#-------#-#------
--#-----##--#-----##--#-----##--#-----##--#-----##--#-----##--#-----##--#-----##--#-----##--#-----##
----#--#------#--#------#--#------#--#------#--#------#--#------#--#------#--#------#--#------#--#--
-------##--------##--------##--------##--------##--------##--------##--------##--------##--------##-
-#--#------#--#------#--#------#--#------#--#------#--#------#--#------#--#------#--#------#--#-----
#------#--#------#--#------#--#------#--#------#--#------#--#------#--#------#--#------#--#------#--
-#--#------#--#------#--#------#--#------#--#------#--#------#--#------#--#------#--#------#--#-----
#--#-#---##--#-#---##--#-#---##--#-#---##--#-#---##--#-#---##--#-#---##--#-#---##--#-#---##--#-#---#
###-------###-------###-------###-------###-------###-------###-------###-------###-------###-------
----#--#-#----#--#-#----#--#-#----#--#-#----#--#-#----#--#-#----#--#-#----#--#-#----#--#-#----#--#-#
-#-#-------#-#-------#-#-------#-#-------#-#-------#-#-------#-#-------#-#-------#-#-------#-#------
--#-----##--#-----##--#-----##--#-----##--#-----##--#-----##--#-----##--#-----##--#-----##--#-----##
----#--#------#--#------#--#------#--#------#--#------#--#------#--#------#--#------#--#------#--#--
-------##--------##--------##--------##--------##--------##--------##--------##--------##--------##-
-#--#------#--#------#--#------#--#------#--#------#--#------#--#------#--#------#--#------#--#-----
#------#--#------#--#------#--#------#--#------#--#------#--#------#--#------#--#------#--#------#--
-#--#------#--#------#--#------#--#------#--#------#--#------#--#------#--#------#--#------#--#-----
#--#-#---##--#-#---##--#-#---##--#-#---##--#-#---##--#-#---##--#-#---##--#-#---##--#-#---##--#-#---#
###-------###-------###-------###-------###-------###-------###-------###-------###-------###-------
----#--#-#----#--#-#----#--#-#----#--#-#----#--#-#----#--#-#----#--#-#----#--#-#----#--#-#----#--#-#
-#-#-------#-#-------#-#-------#-#-------#-#-------#-#-------#-#-------#-#-------#-#-------#-#------
--#-----##--#-----##--#-----##--#-----##--#-----##--#-----##--#-----##--#-----##--#-----##--#-----##
----#--#------#--#------#--#------#--#------#--#------#--#------#--#------#--#------#--#------#--#--
-------##--------##--------##--------##--------##--------##--------##--------##--------##--------##-
-#--#------#--#------#--#------#--#------#--#------#--#------#--#------#--#------#--#------#--#-----
#------#--#------#--#------#--#------#--#------#--#------#--#------#--#------#--#------#--#------#--
-#--#------#--#------#--#------#--#------#--#------#--#------#--#------#--#------#--#------#--#-----
#--#-#---##--#-#--S##--#-#---##--#-#---##--#-#---##--#-#---##--#-#---##--#-#---##--#-#---##--#-#---#
###-------###-------###-------###-------###-------###-------###-------###-------###-------###-------
----#--#-#----#--#-#----#--#-#----#--#-#----#--#-#----#--#-#----#--#-#----#--#-#----#--#-#----#--#-#
-#-#-------#-#-------#-#-------#-#-------#-#-------#-#-------#-#-------#-#-------#-#-------#-#------
--#-----##--#-----##--#-----##--#-----##--#-----##--#-----##--#-----##--#-----##--#-----##--#-----##
----#--#------#--#------#--#------#--#------#--#------#--#------#--#------#--#------#--#------#--#--
-------##--------##--------##--------##--------##--------##--------##--------##--------##--------##-
-#--#------#--#------#--#------#--#------#--#------#--#------#--#------#--#------#--#------#--#-----
#------#--#------#--#------#--#------#--#------#--#------#--#------#--#------#--#------#--#------#--
-#--#------#--#------#--#------#--#------#--#------#--#------#--#------#--#------#--#------#--#-----
#--#-#---##--#-#---##--#-#---##--#-#---##--#-#---##--#-#---##--#-#---##--#-#---##--#-#---##--#-#---#
###-------###-------###-------###-------###-------###-------###-------###-------###-------###-------
----#--#-#----#--#-#----#--#-#----#--#-#----#--#-#----#--#-#----#--#-#----#--#-#----#--#-#----#--#-#
-#-#-------#-#-------#-#-------#-#-------#-#-------#-#-------#-#-------#-#-------#-#-------#-#------
--#-----##--#-----##--#-----##--#-----##--#-----##--#-----##--#-----##--#-----##--#-----##--#-----##
----#--#------#--#------#--#------#--#------#--#------#--#------#--#------#--#------#--#------#--#--
-------##--------##--------##--------##--------##--------##--------##--------##--------##--------##-
-#--#------#--#------#--#------#--#------#--#------#--#------#--#------#--#------#--#------#--#-----
#------#--#------#--#------#--#------#--#------#--#------#--#------#--#------#--#------#--#------#--
-#--#------#--#------#--#------#--#------#--#------#--#------#--#------#--#------#--#------#--#-----
#--#-#---##--#-#---##--#-#---##--#-#---##--#-#---##--#-#---##--#-#---##--#-#---##--#-#---##--#-#---#
###-------###-------###-------###-------###-------###-------###-------###-------###-------###-------
----#--#-#----#--#-#----#--#-#----#--#-#----#--#-#----#--#-#----#--#-#----#--#-#----#--#-#----#--#-#
-#-#-------#-#-------#-#-------#-#-------#-#-------#-#-------#-#-------#-#-------#-#-------#-#------
--#-----##--#-----##--#-----##--#-----##--#-----##--#-----##--#-----##--#-----##--#-----##--#-----##
----#--#------#--#------#--#------#--#------#E-#------#--#------#--#------#--#------#--#------#--#--
-------##--------##--------##--------##--------##--------##--------##--------##--------##--------##-
-#--#------#--#------#--#------#--#------#--#------#--#------#--#------#--#------#--#------#--#-----
#------#--#------#--#------#--#------#--#------#--#------#--#------#--#------#--#------#--#------#--
-#--#------#--#------#--#------#--#------#--#------#--#------#--#------#--#------#--#------#--#-----
#--#-#---##--#-#---##--#-#---##--#-#---##--#-#---##--#-#---##--#-#---##--#-#---##--#-#---##--#-#---#
###-------###-------###-------###-------###-------###-------###-------###-------###-------###-------
----#--#-#----#--#-#----#--#-#----#--#-#----#--#-#----#--#-#----#--#-#----#--#-#----#--#-#----#--#-#
-#-#-------#-#-------#-#-------#-#-------#-#-------#-#-------#-#-------#-#-------#-#-------#-#------
--#-----##--#-----##--#-----##--#-----##--#-----##--#-----##--#-----##--#-----##--#-----##--#-----##
----#--#------#--#------#--#------#--#------#--#------#--#------#--#------#--#------#--#------#--#--
-------##--------##--------##--------##--------##--------##--------##--------##--------##--------##-
-#--#------#--#------#--#------#--#------#--#------#--#------#--#------#--#------#--#------#--#-----
#------#--#------#--#------#--#------#--#------#--#------#--#------#--#------#--#------#--#------#--
-#--#------#--#------#--#------#--#------#--#------#--#------#--#------#--#------#--#------#--#-----
