##-##---#-##-##---#-##-##---#-##-##---#-##-##---#-##-##---#-##-##---#-##-##---#-##-##---#-##-##---#-
#-##-----##-##-----##-##-----##-##-----##-##-----##-##-----##-##-----##-##-----##-##-----##-##-----#
-----#-#-------#-#-------#-#-------#-#-------#-#-------#-#-------#-#-------#-#-------#-#-------#-#--
------#--#------#--#------#--#------#--#------#--#------#--#------#--#------#--#------#--#------#--#
-------#---------#---------#---------#---------#---------#---------#---------#---------#---------#--
----#---#-----#---#-----#---#-----#---#-----#---#-----#---#-----#---#-----#---#-----#---#-----#---#-
---#---------#---------#---------#---------#---------#---------#---------#---------#---------#------
----#---------#---------#---------#---------#---------#---------#---------#---------#---------#-----
------#---------#---------#---------#---------#---------#---------#---------#---------#---------#---
--#---##----#---##----#---##----#---##----#---##----#---##----#---##----#---##----#---##----#---##--
##-##---#-##-##---#-##-##---#-##-##---#-##-##---#-##-##---#-##-##---#-##-##---#-##-##---#-##-##---#-
#-##-----##-##-----##-##-----##-##-----##-##-----##-##-----##-##-----##-##-----##-##-----##-##-----#
-----#-#-------#-#-------#-#-------#-#-------#-#-------#-#-------#-#-------#-#-------#-#-------#-#--
------#--#------#--#------#--#------#--#------#--#------#--#------#--#------#--#------#--#------#--#
-------#---------#---------#---------#---------#---------#---------#---------#---------#---------#--
----#---#-----#---#-----#---#-----#---#-----#---#-----#---#-----#---#-----#---#-----#---#-----#---#-
---#---------#---------#---------#---------#---------#---------#---------#---------#---------#------
----#---------#---------#---------#---------#---------#---------#---------#---------#---------#-----
------#---------#---------#---------#---------#---------#---------#---------#---------#---------#---
--#---##----#---##----#---##----#---##----#---##----#---##----#---##----#---##----#---##----#---##--
##-##---#-##-##---#-##-##---#-##-##---#-##-##---#-##-##---#-##-##---#-##-##---#-##-##---#-##-##---#-
#-##-----##-##-----##-##-----##-##-----##-##-----##-##-----##-##-----##-##-----##-##-----##-##-----#
-----#-#-------#-#-------#-#-------#-#-------#-#-------#-#-------#-#-------#-#-------#-#-------#-#--
------#--#------#--#------#--#------#--#------#--#------#--#------#--#------#--#------#--#------#--#
-------#---------#---------#---------#---------#---------#---------#---------#---------#---------#--
----#---#-----#---#-----#---#-----#---#-----#---#-----#---#-----#---#-----#---#-----#---#-----#---#-
---#---------#---------#---------#---------#---------#---------#---------#---------#---------#------
----#---------#---------#---------#---------#---------#---------#---------#---------#---------#-----
------#---------#---------#---------#---------#---------#---------#---------#---------#---------#---
--#---##----#---##----#---##----#---##----#---##----#---##----#---##----#---##----#---##----#---##--
##-##---#-##-##---#-##-##---#-##-##---#-##-##---#-##-##---#-##-##---#-##-##---#-##-##---#-##-##---#-
#-##-----##-##-----##-##-----##-##-----##-##-----##-##-----##-##-----##-##-----##-##-----##-##-----#
-----#-#-------#-#-------#-#-------#-#-------#-#-------#-#-------#-#-------#-#-------#-#-------#-#--
------#--#------#--#------#--#------#--#------#--#------#--#------#--#------#--#------#--#------#--#
-------#---------#---------#---------#---------#---------#---------#---------#---------#---------#--
----#---#-----#---#-----#---#-----#---#-----#---#-----#---#-----#---#-----#---#-----#---#-----#---#-
---#---------#---------#---------#---------#---------#---------#---------#---------#---------#------
----#---------#---------#---------#---------#---------#---------#---------#---------#---------#-----
------#---------#---------#---------#---------#---------#---------#---------#---------#---------#---
--#---##----#---##----#---##----#---##----#---##----#---##----#---##----#---##----#---##----#---##--
##-##---#-##-##---#-##-##---#-##-##---#-##-##---#-##-##---#-##-##---#-##-##---#-##-##---#-##-##---#-
#-##-----##-##-----##-##-----##-##-----##-##-----##-##-----##-##-----##-##-----##-##-----##-##-----#
-----#-#-------#-#-------#-#-------#-#-------#-#-------#-#-------#-#-------#-#-------#-#-------#-#--
------#--#------#--#------#--#------#--#------#--#------#--#------#--#------#--#------#--#------#--#
-------#---------#---------#---------#---------#---------#---------#---------#---------#---------#--
----#---#-----#---#-----#---#-----#---#-----#---#-----#---#-----#---#-----#---#-----#---#-----#---#-
---#---------#---------#---------#---------#---------#---------#---------#---------#---------#------
----#---------#---------#---------#---------#---------#---------#---------#---------#---------#-----
------#---------#---------#---------#---------#---------#---------#---------#---------#---------#---
--#---##----#---##----#---##----#---##----#---##----#---##----#---##----#---##----#---##----#---##--
##-##---#-##-##---#-##-##---#-##-##---#-##-##---#-##-##---#-##-##---#-##-##---#-##-##---#-##-##---#-
#-##-----##-##-----##-##-----##-##-----##-##-----##-##-----##-##-----##-##-----##-##-----##-##-----#
-----#-#-------#-#-------#-#-------#-#-------#-#-------#-#-------#-#-------#-#-------#-#-------#-#--
------#--#------#--#------#--#------#--#------#--#------#--#------#--#------#--#------#--#------#--#
-------#---------#S--------#---------#---------#---------#---------#---------#---------#---------#--
----#---#-----#---#-----#---#-----#---#-----#---#-----#---#-----#---#-----#---#-----#---#-----#---#-
---#---------#---------#---------#---------#---------#---------#---------#---------#---------#------
----#---------#---------#---------#---------#---------#---------#---------#---------#---------#-----
------#---------#---------#---------#---------#---------#---------#---------#---------#---------#---
--#---##----#---##----#---##----#---##----#---##----#---##----#---##----#---##----#---##----#---##--
##-##---#-##-##---#-##-##---#-##-##---#-##-##---#-##-##---#-##-##---#-##-##---#-##-##---#-##-##---#-
#-##-----##-##-----##-##-----##-##-----##-##-----##-##-----##-##-----##-##-----##-##-----##-##-----#
-----#-#-------#-#-------#-#-------#-#-------#-#-------#-#-------#-#-------#-#-------#-#-------#-#--
------#--#------#--#------#--#------#--#------#--#------#--#------#--#------#--#------#--#------#--#
-------#---------#---------#---------#---------#---------#---------#---------#---------#---------#--
----#---#-----#---#-----#---#-----#---#-----#---#-----#---#-----#---#-----#---#-----#---#-----#---#-
---#---------#---------#---------#---------#---------#---------#---------#---------#---------#------
----#---------#---------#---------#---------#---------#---------#---------#---------#---------#-----
------#---------#---------#---------#---------#---------#---------#---------#---------#---------#---
--#---##----#---##----#---##----#---##----#---##----#---##----#---##----#---##----#---##----#---##--
##-##---#-##-##---#-##-##---#-##-##---#-##-##---#-##-##---#-##-##---#-##-##---#-##-##---#-##-##---#-
#-##-----##-##-----##-##-----##-##-----##-##-----##-##-----##-##-----##-##-----##-##-----##-##-----#
-----#-#-------#-#-------#-#-------#-#-------#-#-------#-#-------#-#-------#-#-------#-#-------#-#--
------#--#------#--#------#--#------#--#------#--#------#--#------#--#------#--#------#--#------#--#
-------#---------#---------#---------#---------#---------#---------#---------#---------#---------#--
----#---#-----#---#-----#---#-----#---#----E#---#-----#---#-----#---#-----#---#-----#---#-----#---#-
---#---------#---------#---------#---------#---------#---------#---------#---------#---------#------
----#---------#---------#---------#---------#---------#---------#---------#---------#---------#-----
------#---------#---------#---------#---------#---------#---------#---------#---------#---------#---
--#---##----#---##----#---##----#---##----#---##----#---##----#---##----#---##----#---##----#---##--
##-##---#-##-##---#-##-##---#-##-##---#-##-##---#-##-##---#-##-##---#-##-##---#-##-##---#-##-##---#-
#-##-----##-##-----##-##-----##-##-----##-##-----##-##-----##-##-----##-##-----##-##-----##-##-----#
-----#-#-------#-#-------#-#-------#-#-------#-#-------#-#-------#-#-------#-#-------#-#-------#-#--
------#--#------#--#------#--#------#--#------#--#------#--#------#--#------#--#------#--#------#--#
-------#---------#---------#---------#---------#---------#---------#---------#---------#---------#--
----#---#-----#---#-----#---#-----#---#-----#---#-----#---#-----#---#-----#---#-----#---#-----#---#-
---#---------#---------#---------#---------#---------#---------#---------#---------#---------#------
----#---------#---------#---------#---------#---------#---------#---------#---------#---------#-----
------#---------#---------#---------#---------#---------#---------#---------#---------#---------#---
--#---##----#---##----#---##----#---##----#---##----#---##----#---##----#---##----#---##----#---##--
##-##---#-##-##---#-##-##---#-##-##---#-##-##---#-##-##---#-##-##---#-##-##---#-##-##---#-##-##---#-
#-##-----##-##-----##-##-----##-##-----##-##-----##-##-----##-##-----##-##-----##-##-----##-##-----#
-----#-#-------#-#-------#-#-------#-#-------#-#-------#-#-------#-#-------#-#-------#-#-------#-#--
------#--#------#--#------#--#------#--#------#--#------#--#------#--#------#--#------#--#------#--#
-------#---------#---------#---------#---------#---------#---------#---------#---------#---------#--
----#---#-----#---#-----#---#-----#---#-----#---#-----#---#-----#---#-----#---#-----#---#-----#---#-
---#---------#---------#---------#---------#---------#---------#---------#---------#---------#------
----#---------#---------#---------#---------#---------#---------#---------#---------#---------#-----
------#---------#---------#---------#---------#---------#---------#---------#---------#---------#---
--#---##----#---##----#---##----#---##----#---##----#---##----#---##----#---##----#---##----#---##--
