------##-#------##-#------##-#------##-#------##-#------##-#------##-#------##-#------##-#------##-#
####---#-#####---#-#####---#-#####---#-#####---#-#####---#-#####---#-#####---#-#####---#-#####---#-#
#---------#---------#---------#---------#---------#---------#------S--#---------#---------#---------
-----##--------##--------##--------##--------##--------##--------##--------##--------##--------##---
---##-#--#---##-#--#---##-#--#---##-#--#---##-#--#---##-#--#---##-#--#---##-#--#---##-#--#---##-#--#
---#-##-##---#-##-##---#-##-##---#-##-##---#-##-##---#-##-##---#-##-##---#-##-##---#-##-##---#-##-##
#-------#-#-------#-#-------#-#-------#-#-------#-#-------#-#-------#-#-------#-#-------#-#-------#-
----#---------#---------#---------#---------#---------#---------#---------#---------#---------#-----
-----#-#-#-----#-#-#-----#-#-#-----#-#-#-----#-#-#-----#-#-#-----#-#-#-----#-#-#-----#-#-#-----#-#-#
----------------------------------------------------------------------------------------------------
------##-#------##-#------##-#------##-#------##-#------##-#------##-#------##-#------##-#------##-#
####---#-#####---#-#####---#-#####---#-#####---#-#####---#-#####---#-#####---#-#####---#-#####---#-#
#---------#---------#---------#---------#---------#---------#---------#---------#---------#---------
-----##--------##--------##--------##--------##--------##--------##--------##--------##--------##---
---##-#--#---##-#--#---##-#--#---##-#--#---##-#--#---##-#--#---##-#--#---##-#--#---##-#--#---##-#--#
---#-##-##---#-##-##---#-##-##---#-##-##---#-##-##---#-##-##---#-##-##---#-##-##---#-##-##---#-##-##
#-------#-#-------#-#-------#-#-------#-#-------#-#-------#-#-------#-#-------#-#-------#-#-------#-
----#---------#---------#---------#---------#---------#---------#---------#---------#---------#-----
-----#-#-#-----#-#-#-----#-#-#-----#-#-#-----#-#-#-----#-#-#-----#-#-#-----#-#-#-----#-#-#-----#-#-#
----------------------------------------------------------------------------------------------------
------##-#------##-#------##-#------##-#------##-#------##-#------##-#------##-#------##-#------##-#
####---#-#####---#-#####---#-#####---#-#####---#-#####---#-#####---#-#####---#-#####---#-#####---#-#
#---------#---------#---------#---------#---------#---------#---------#---------#---------#---------
-----##--------##--------##--------##--------##--------##--------##--------##--------##--------##---
---##-#--#---##-#--#---##-#--#---##-#--#---##-#--#---##-#--#---##-#--#---##-#--#---##-#--#---##-#--#
---#-##-##---#-##-##---#-##-##---#-##-##---#-##-##---#-##-##---#-##-##---#-##-##---#-##-##---#-##-##
#-------#-#-------#-#-------#-#-------#-#-------#-#-------#-#-------#-#-------#-#-------#-#-------#-
----#---------#---------#---------#---------#---------#---------#---------#---------#---------#-----
-----#-#-#-----#-#-#-----#-#-#-----#-#-#-----#-#-#-----#-#-#-----#-#-#-----#-#-#-----#-#-#-----#-#-#
----------------------------------------------------------------------------------------------------
------##-#------##-#------##-#------##-#------##-#------##-#------##-#------##-#------##-#------##-#
####---#-#####---#-#####---#-#####---#-#####---#-#####---#-#####---#-#####---#-#####---#-#####---#-#
#---------#---------#---------#---------#---------#---------#---------#---------#---------#---------
-----##--------##--------##--------##--------##--------##--------##--------##--------##--------##---
---##-#--#---##-#--#---##-#--#---##-#--#---##-#--#---##-#--#---##-#--#---##-#--#---##-#--#---##-#--#
---#-##-##---#-##-##---#-##-##---#-##-##---#-##-##---#-##-##---#-##-##---#-##-##---#-##-##---#-##-##
#-------#-#-------#-#-------#-#-------#-#-------#-#-------#-#-------#-#-------#-#E------#-#-------#-
----#---------#---------#---------#---------#---------#---------#---------#---------#---------#-----
-----#-#-#-----#-#-#-----#-#-#-----#-#-#-----#-#-#-----#-#-#-----#-#-#-----#-#-#-----#-#-#-----#-#-#
----------------------------------------------------------------------------------------------------
------##-#------##-#------##-#------##-#------##-#------##-#------##-#------##-#------##-#------##-#
####---#-#####---#-#####---#-#####---#-#####---#-#####---#-#####---#-#####---#-#####---#-#####---#-#
#---------#---------#---------#---------#---------#---------#---------#---------#---------#---------
-----##--------##--------##--------##--------##--------##--------##--------##--------##--------##---
---##-#--#---##-#--#---##-#--#---##-#--#---##-#--#---##-#--#---##-#--#---##-#--#---##-#--#---##-#--#
---#-##-##---#-##-##---#-##-##---#-##-##---#-##-##---#-##-##---#-##-##---#-##-##---#-##-##---#-##-##
#-------#-#-------#-#-------#-#-------#-#-------#-#-------#-#-------#-#-------#-#-------#-#-------#-
----#---------#---------#---------#---------#---------#---------#---------#---------#---------#-----
-----#-#-#-----#-#-#-----#-#-#-----#-#-#-----#-#-#-----#-#-#-----#-#-#-----#-#-#-----#-#-#-----#-#-#
----------------------------------------------------------------------------------------------------
------##-#------##-#------##-#------##-#------##-#------##-#------##-#------##-#------##-#------##-#
####---#-#####---#-#####---#-#####---#-#####---#-#####---#-#####---#-#####---#-#####---#-#####---#-#
#---------#---------#---------#---------#---------#---------#---------#---------#---------#---------
-----##--------##--------##--------##--------##--------##--------##--------##--------##--------##---
---##-#--#---##-#--#---##-#--#---##-#--#---##-#--#---##-#--#---##-#--#---##-#--#---##-#--#---##-#--#
---#-##-##---#-##-##---#-##-##---#-##-##---#-##-##---#-##-##---#-##-##---#-##-##---#-##-##---#-##-##
#-------#-#-------#-#-------#-#-------#-#-------#-#-------#-#-------#-#-------#-#-------#-#-------#-
----#---------#---------#---------#---------#---------#---------#---------#---------#---------#-----
-----#-#-#-----#-#-#-----#-#-#-----#-#-#-----#-#-#-----#-#-#-----#-#-#-----#-#-#-----#-#-#-----#-#-#
----------------------------------------------------------------------------------------------------
------##-#------##-#------##-#------##-#------##-#------##-#------##-#------##-#------##-#------##-#
####---#-#####---#-#####---#-#####---#-#####---#-#####---#-#####---#-#####---#-#####---#-#####---#-#
#---------#---------#---------#---------#---------#---------#---------#---------#---------#---------
-----##--------##--------##--------##--------##--------##--------##--------##--------##--------##---
---##-#--#---##-#--#---##-#--#---##-#--#---##-#--#---##-#--#---##-#--#---##-#--#---##-#--#---##-#--#
---#-##-##---#-##-##---#-##-##---#-##-##---#-##-##---#-##-##---#-##-##---#-##-##---#-##-##---#-##-##
#-------#-#-------#-#-------#-#-------#-#-------#-#-------#-#-------#-#-------#-#-------#-#-------#-
----#---------#---------#---------#---------#---------#---------#---------#---------#---------#-----
-----#-#-#-----#-#-#-----#-#-#-----#-#-#-----#-#-#-----#-#-#-----#-#-#-----#-#-#-----#-#-#-----#-#-#
----------------------------------------------------------------------------------------------------
------##-#------##-#------##-#------##-#------##-#------##-#------##-#------##-#------##-#------##-#
####---#-#####---#-#####---#-#####---#-#####---#-#####---#-#####---#-#####---#-#####---#-#####---#-#
#---------#---------#---------#---------#---------#---------#---------#---------#---------#---------
-----##--------##--------##--------##--------##--------##--------##--------##--------##--------##---
---##-#--#---##-#--#---##-#--#---##-#--#---##-#--#---##-#--#---##-#--#---##-#--#---##-#--#---##-#--#
---#-##-##---#-##-##---#-##-##---#-##-##---#-##-##---#-##-##---#-##-##---#-##-##---#-##-##---#-##-##
#-------#-#-------#-#-------#-#-------#-#-------#-#-------#-#-------#-#-------#-#-------#-#-------#-
----#---------#---------#---------#---------#---------#---------#---------#---------#---------#-----
-----#-#-#-----#-#-#-----#-#-#-----#-#-#-----#-#-#-----#-#-#-----#-#-#-----#-#-#-----#-#-#-----#-#-#
----------------------------------------------------------------------------------------------------
------##-#------##-#------##-#------##-#------##-#------##-#------##-#------##-#------##-#------##-#
####---#-#####---#-#####---#-#####---#-#####---#-#####---#-#####---#-#####---#-#####---#-#####---#-#
#---------#---------#---------#---------#---------#---------#---------#---------#---------#---------
-----##--------##--------##--------##--------##--------##--------##--------##--------##--------##---
---##-#--#---##-#--#---##-#--#---##-#--#---##-#--#---##-#--#---##-#--#---##-#--#---##-#--#---##-#--#
---#-##-##---#-##-##---#-##-##---#-##-##---#-##-##---#-##-##---#-##-##---#-##-##---#-##-##---#-##-##
#-------#-#-------#-#-------#-#-------#-#-------#-#-------#-#-------#-#-------#-#-------#-#-------#-
----#---------#---------#---------#---------#---------#---------#---------#---------#---------#-----
-----#-#-#-----#-#-#-----#-#-#-----#-#-#-----#-#-#-----#-#-#-----#-#-#-----#-#-#-----#-#-#-----#-#-#
----------------------------------------------------------------------------------------------------
------##-#------##-#------##-#------##-#------##-#------##-#------##-#------##-#------##-#------##-#
####---#-#####---#-#####---#-#####---#-#####---#-#####---#-#####---#-#####---#-#####---#-#####---#-#
#---------#---------#---------#---------#---------#---------#---------#---------#---------#---------
-----##--------##--------##--------##--------##--------##--------##--------##--------##--------##---
---##-#--#---##-#--#---##-#--#---##-#--#---##-#--#---##-#--#---##-#--#---##-#--#---##-#--#---##-#--#
---#-##-##---#-##-##---#-##-##---#-##-##---#-##-##---#-##-##---#-##-##---#-##-##---#-##-##---#-##-##
#-------#-#-------#-#-------#-#-------#-#-------#-#-------#-#-------#-#-------#-#-------#-#-------#-
----#---------#---------#---------#---------#---------#---------#---------#---------#---------#-----
-----#-#-#-----#-#-#-----#-#-#-----#-#-#-----#-#-#-----#-#-#-----#-#-#-----#-#-#-----#-#-#-----#-#-#
----------------------------------------------------------------------------------------------------
