##-#--#---##-#--#---##-#--#---##-#--#---##-#--#---##-#--#---##-#--#---##-#--#---##-#--#---##-#--#---
---###-#-#---###-#-#---###-#-#---###-#-#---###-#-#---###-#-#---###-#-#---###-#-#---###-#-#---###-#-#
------#---------#---------#---------#---------#---------#---------#---------#---------#---------#---
-#-###-----#-###-----#-###-----#-###-----#-###-----#-###-----#-###-----#-###-----#-###-----#-###----
---#-#-#-----#-#-#-----#-#-#-----#-#-#-----#-#-#-----#-#-#-----#-#-#-----#-#-#-----#-#-#-----#-#-#--
#-----#---#-----#---#-----#---#-----#---#-----#---#-----#---#-----#---#-----#---#-----#---#-----#---
--#-----#---#-----#---#-----#---#-----#---#-----#---#-----#---#-----#---#-----#---#-----#---#-----#-
----------------------------------------------------------------------------------------------------
----------------------------------------------------------------------------------------------------
#-#-####--#-#-####--#-#-####--#-#-####--#-#-####--#-#-####--#-#-####--#-#-####--#-#-####--#-#-####--
##-#--#---##-#--#---##-#--#---##-#--#---##-#--#---##-#--#---##-#--#---##-#--#---##-#--#---##-#--#---
---###-#-#---###-#-#---###-#-#---###-#-#---###-#-#---###-#-#---###-#-#---###-#-#---###-#-#---###-#-#
------#---------#---------#---------#---------#---------#---------#---------#---------#---------#---
-#-###-----#-###-----#-###-----#-###-----#-###-----#-###-----#-###-----#-###-----#-###-----#-###----
---#-#-#-----#-#-#-----#-#-#-----#-#-#-----#-#-#-----#-#-#-----#-#-#-----#-#-#-----#-#-#-----#-#-#--
#-----#---#-----#---#-----#---#-----#---#-----#---#-----#---#-----#---#-----#---#-----#---#-----#---
--#-----#---#-----#---#-----#---#-----#---#-----#---#-----#---#-----#---#-----#---#-----#---#-----#-
----------------------------------------------------------------------------------------------------
----------------------------------------------------------------------------------------------------
#-#-####--#-#-####--#-#-####--#-#-####--#-#-####--#-#-####--#-#-####--#-#-####--#-#-####--#-#-####--
##-#--#---##-#--#---##-#--#---##-#--#---##-#--#---##-#--#---##-#--#---##-#--#---##-#--#---##-#--#---
---###-#-#---###-#-#---###-#-#---###-#-#---###-#-#---###-#-#---###-#-#---###-#-#---###-#-#---###-#-#
------#---------#---------#---------#---------#---------#---------#---------#---------#---------#---
-#-###-----#-###-----#-###-----#-###-----#-###-----#-###-----#-###-----#-###-----#-###-----#-###----
---#-#-#-----#-#-#-----#-#-#-----#-#-#-----#-#-#-----#-#-#-----#-#-#-----#-#-#-----#-#-#-----#-#-#--
#-----#---#-----#---#-----#---#-----#---#-----#---#-----#---#-----#---#-----#---#-----#---#-----#---
--#-----#---#-----#---#-----#---#-----#---#-----#---#-----#---#-----#---#-----#---#-----#---#-----#-
----------------------------------------------------------------------------------------------------
----------------------------------------------------------------------------------------------------
#-#-####--#-#-####--#-#-####--#-#-####--#-#-####--#-#-####--#-#-####--#-#-####--#-#-####--#-#-####--
##-#--#---##-#--#---##-#--#---##-#--#---##-#--#---##-#--#---##-#--#---##-#--#---##-#--#---##-#--#---
---###-#-#---###-#-#---###-#-#---###-#-#---###-#-#---###-#-#---###-#-#---###-#-#---###-#-#---###-#-#
------#---------#---------#---------#---------#---------#---------#---------#---------#---------#---
-#-###-----#-###-----#-###-----#-###-----#-###-----#-###-----#-###-----#-###-----#-###-----#-###----
---#-#-#-----#-#-#-----#-#-#-----#-#-#-----#-#-#-----#-#-#-----#-#-#-----#-#-#-----#-#-#-----#-#-#--
#-----#---#-----#---#-----#---#-----#---#-----#---#-----#---#-----#---#-----#---#-----#---#-----#---
--#-----#---#-----#---#-----#---#-----#---#-----#---#-----#---#-----#---#-----#---#-----#---#-----#-
----------------------------------------------------------------------------------------------------
----------------------------------------------------------------------------------------------------
#-#-####--#-#-####--#-#-####--#-#-####--#-#-####--#-#-####--#-#-####--#-#-####--#-#-####--#-#-####--
##-#--#---##-#--#---##-#--#---##-#--#---##-#--#---##-#--#---##-#--#---##-#--#---##-#--#---##-#--#---
---###-#-#E--###-#-#---###-#-#---###-#-#---###-#-#---###-#-#---###-#-#---###-#-#---###-#-#---###-#-#
------#---------#---------#---------#---------#---------#---------#---------#---------#---------#---
-#-###-----#-###-----#-###-----#-###-----#-###-----#-###-----#-###-----#-###-----#-###-----#-###----
---#-#-#-----#-#-#-----#-#-#-----#-#-#-----#-#-#-----#-#-#-----#-#-#-----#-#-#-----#-#-#-----#-#-#--
#-----#---#-----#---#-----#---#-----#---#-----#---#-----#---#-----#---#-----#---#-----#---#-----#---
--#-----#---#-----#---#-----#---#-----#---#-----#---#-----#---#-----#---#-----#---#-----#---#-----#-
----------------------------------------------------------------------------------------------------
----------------------------------------------------------------------------------------------------
#-#-####--#-#-####--#-#-####--#-#-####--#-#-####--#-#-####--#-#-####--#-#-####--#-#-####--#-#-####--
##-#--#---##-#--#---##-#--#---##-#--#---##-#--#---##-#--#---##-#--#---##-#--#---##-#--#---##-#--#---
---###-#-#---###-#-#---###-#-#---###-#-#---###-#-#---###-#-#---###-#-#---###-#-#---###-#-#---###-#-#
------#---------#---------#---------#---------#---------#---------#---------#---------#---------#---
-#-###-----#-###-----#-###-----#-###-----#-###-----#-###-----#-###-----#-###-----#-###-----#-###----
---#-#-#-----#-#-#-----#-#-#-----#-#-#-----#-#-#-----#-#-#-----#-#-#-----#-#-#-----#-#-#-----#-#-#--
#-----#---#-----#---#-----#---#-----#---#-----#---#-----#---#-----#---#-----#---#-----#---#-----#---
--#-----#---#-----#---#-----#---#-----#---#-----#---#-----#---#-----#---#-----#---#-----#---#-----#-
----------------------------------------------------------------------------------------------------
----------------------------------------------------------------------------------------------------
#-#-####--#-#-####--#-#-####--#-#-####--#-#-####--#-#-####--#-#-####--#-#-####--#-#-####--#-#-####--
##-#--#---##-#--#---##-#--#---##-#--#---##-#--#---##-#--#---##-#--#---##-#--#---##-#--#---##-#--#---
---###-#-#---###-#-#---###-#-#---###-#-#---###-#-#---###-#-#---###-#-#---###-#-#---###-#-#---###-#-#
------#---------#---------#---------#---------#---------#---------#---------#---------#---------#---
-#-###-----#-###-----#-###-----#-###-----#-###-----#-###-----#-###-----#-###-----#-###-----#-###----
---#-#-#-----#-#-#-----#-#-#-----#-#-#-----#-#-#-----#-#-#-----#-#-#-----#-#-#-----#-#-#-----#-#-#--
#-----#---#-----#---#-----#---#-----#---#-----#---#-----#---#-----#---#-----#---#-----#---#-----#---
--#-----#---#-----#---#-----#---#-----#---#-----#---#-----#---#-----#---#-----#---#-----#---#-----#-
----------------------------------------------------------------------------------------------------
----------------------------------------------------------------------------------------------------
#-#-####--#-#-####--#-#-####--#-#-####--#-#-####--#-#-####--#-#-####--#-#-####--#-#-####--#-#-####--
##-#--#---##-#--#---##-#--#---##-#--#---##-#--#---##-#--#---##-#--#---##-#--#---##-#--#---##-#--#---
---###-#-#---###-#-#---###-#-#---###-#-#---###-#-#---###-#-#---###-#-#---###-#-#---###-#-#---###-#-#
------#---------#---------#---------#---------#---------#---------#---------#---------#---------#---
-#-###-----#-###-----#-###-----#-###-----#-###-----#-###-----#-###-----#-###-----#-###-----#-###----
---#-#-#-----#-#-#-----#-#-#-----#-#-#-----#-#-#-----#-#-#-----#-#-#-----#-#-#-----#-#-#-----#-#-#--
#-----#---#-----#---#-----#---#-----#---#-----#---#-----#---#-----#---#-----#---#-----#---#-----#---
--#-----#---#-----#---#-----#---#-----#---#-----#---#-----#---#-----#---#-----#---#-----#---#-S---#-
----------------------------------------------------------------------------------------------------
----------------------------------------------------------------------------------------------------
#-#-####--#-#-####--#-#-####--#-#-####--#-#-####--#-#-####--#-#-####--#-#-####--#-#-####--#-#-####--
##-#--#---##-#--#---##-#--#---##-#--#---##-#--#---##-#--#---##-#--#---##-#--#---##-#--#---##-#--#---
---###-#-#---###-#-#---###-#-#---###-#-#---###-#-#---###-#-#---###-#-#---###-#-#---###-#-#---###-#-#
------#---------#---------#---------#---------#---------#---------#---------#---------#---------#---
-#-###-----#-###-----#-###-----#-###-----#-###-----#-###-----#-###-----#-###-----#-###-----#-###----
---#-#-#-----#-#-#-----#-#-#-----#-#-#-----#-#-#-----#-#-#-----#-#-#-----#-#-#-----#-#-#-----#-#-#--
#-----#---#-----#---#-----#---#-----#---#-----#---#-----#---#-----#---#-----#---#-----#---#-----#---
--#-----#---#-----#---#-----#---#-----#---#-----#---#-----#---#-----#---#-----#---#-----#---#-----#-
----------------------------------------------------------------------------------------------------
----------------------------------------------------------------------------------------------------
#-#-####--#-#-####--#-#-####--#-#-####--#-#-####--#-#-####--#-#-####--#-#-####--#-#-####--#-#-####--
##-#--#---##-#--#---##-#--#---##-#--#---##-#--#---##-#--#---##-#--#---##-#--#---##-#--#---##-#--#---
---###-#-#---###-#-#---###-#-#---###-#-#---###-#-#---###-#-#---###-#-#---###-#-#---###-#-#---###-#-#
------#---------#---------#---------#---------#---------#---------#---------#---------#---------#---
-#-###-----#-###-----#-###-----#-###-----#-###-----#-###-----#-###-----#-###-----#-###-----#-###----
---#-#-#-----#-#-#-----#-#-#-----#-#-#-----#-#-#-----#-#-#-----#-#-#-----#-#-#-----#-#-#-----#-#-#--
#-----#---#-----#---#-----#---#-----#---#-----#---#-----#---#-----#---#-----#---#-----#---#-----#---
--#-----#---#-----#---#-----#---#-----#---#-----#---#-----#---#-----#---#-----#---#-----#---#-----#-
----------------------------------------------------------------------------------------------------
----------------------------------------------------------------------------------------------------
#-#-####--#-#-####--#-#-####--#-#-####--#-#-####--#-#-####--#-#-####--#-#-####--#-#-####--#-#-####--
