#-#---#-###-#---#-###-#---#-###-#---#-###-#---#-###-#---#-###-#---#-###-#---#-###-#---#-###-#---#-##
---#-#-------#-#-------#-#-------#-#-------#-#-------#-#-------#-#-------#-#-------#-#-------#-#----
#--#-#----#--#-#----#--#-#----#--#-#----#--#-#----#--#-#----#--#-#----#--#-#----#--#-#----#--#-#----
--#--##-##--#--##-##--#--##-##--#--##-##--#--##-##--#--##-##--#--##-##--#--##-##--#--##-##--#--##-##
-------#---------#---------#---------#---------#---------#---------#---------#---------#---------#--
-#-#---#---#-#---#---#-#---#---#-#---#---#-#---#---#-#---#---#-#---#---#-#---#---#-#---#---#-#---#--
--##--------##--------##--------##--------##--------##--------##--------##--------##--------##------
-#--#------#--#------#--#------#--#------#--#------#--#------#--#------#--#------#--#------#--#-----
---------#---------#---------#---------#---------#---------#---------#---------#---------#---------#
-##------#-##------#-##------#-##------#-##------#-##------#-##------#-##------#-##------#-##------#
#-#---#-###-#---#-###-#---#-###-#---#-###-#---#-###-#---#-###-#---#-###-#---#-###-#---#-###-#---#-##
---#-#-------#-#-------#-#-------#-#-------#-#-------#-#-------#-#-------#-#-------#-#-------#-#----
#--#-#----#--#-#----#--#-#----#--#-#----#--#-#----#--#-#----#--#-#----#--#-#----#--#-#----#--#-#----
--#--##-##--#--##-##--#--##-##--#--##-##--#--##-##--#--##-##--#--##-##--#--##-##--#--##-##--#--##-##
-------#---------#---------#---------#---------#---------#---------#---------#---------#---------#--
-#-#---#---#-#---#---#-#---#---#-#---#---#-#---#---#-#---#---#-#---#---#-#---#---#-#---#---#-#---#--
--##--------##--------##--------##--------##--------##--------##--------##--------##--------##------
-#--#------#--#------#--#------#--#------#--#------#--#------#--#------#--#------#--#------#--#-----
---------#---------#---------#---------#---------#---------#---------#---------#---------#---------#
-##------#-##------#-##------#-##------#-##------#-##------#-##------#-##------#-##------#-##------#
#-#---#-###-#---#-###-#---#-###-#---#-###-#---#-###-#---#-###-#---#-###-#---#-###-#---#-###-#---#-##
---#-#-------#-#-------#-#-------#-#-------#-#-------#-#-------#-#-------#-#-------#-#-------#-#----
#--#-#----#--#-#----#--#-#----#--#-#----#--#-#----#--#-#----#--#-#----#--#-#----#--#-#----#--#-#----
--#--##-##--#--##-##--#--##-##--#--##-##--#--##-##--#--##-##--#--##-##--#--##-##--#--##-##--#--##-##
-------#---------#---------#---------#---------#---------#---------#---------#---------#---------#--
-#-#---#---#-#---#---#-#---#---#-#---#---#-#---#---#-#---#---#-#---#---#-#---#---#-#---#---#-#---#--
--##--------##--------##--------##--------##--------##--------##--------##--------##--------##------
-#--#------#--#------#--#------#--#------#--#------#--#------#--#------#--#------#--#------#--#-----
---------#---------#---------#---------#---------#---------#---------#---------#---------#---------#
-##------#-##------#-##------#-##------#-##------#-##------#-##------#-##------#-##------#-##------#
#-#---#-###-#---#-###-#---#-###-#---#-###-#---#-###-#---#-###-#---#-###-#---#-###-#---#-###-#---#-##
---#-#-------#-#-------#-#-------#-#-------#-#-------#-#-------#-#-------#-#-------#-#-------#-#----
#--#-#----#--#-#----#--#-#----#--#-#----#--#-#----#--#-#----#--#-#----#--#-#----#--#-#----#--#-#----
--#--##-##--#--##-##--#--##-##--#--##-##--#--##-##--#--##-##--#--##-##--#--##-##--#--##-##--#--##-##
-------#---------#---------#---------#---------#---------#---------#---------#---------#---------#--
-#-#---#---#-#---#---#-#---#---#-#---#---#-#---#---#-#---#---#-#---#---#-#---#---#-#---#---#-#---#--
--##--------##--------##--------##--------##--------##--------##--------##--------##--------##------
-#--#------#--#------#--#------#--#------#--#------#--#------#--#------#--#------#--#------#--#-----
---------#---------#---------#---------#---------#---------#---------#---------#---------#----S----#
-##------#-##------#-##------#-##-E----#-##------#-##------#-##------#-##------#-##------#-##------#
#-#---#-###-#---#-###-#---#-###-#---#-###-#---#-###-#---#-###-#---#-###-#---#-###-#---#-###-#---#-##
---#-#-------#-#-------#-#-------#-#-------#-#-------#-#-------#-#-------#-#-------#-#-------#-#----
#--#-#----#--#-#----#--#-#----#--#-#----#--#-#----#--#-#----#--#-#----#--#-#----#--#-#----#--#-#----
--#--##-##--#--##-##--#--##-##--#--##-##--#--##-##--#--##-##--#--##-##--#--##-##--#--##-##--#--##-##
-------#---------#---------#---------#---------#---------#---------#---------#---------#---------#--
-#-#---#---#-#---#---#-#---#---#-#---#---#-#---#---#-#---#---#-#---#---#-#---#---#-#---#---#-#---#--
--##--------##--------##--------##--------##--------##--------##--------##--------##--------##------
-#--#------#--#------#--#------#--#------#--#------#--#------#--#------#--#------#--#------#--#-----
---------#---------#---------#---------#---------#---------#---------#---------#---------#---------#
-##------#-##------#-##------#-##------#-##------#-##------#-##------#-##------#-##------#-##------#
#-#---#-###-#---#-###-#---#-###-#---#-###-#---#-###-#---#-###-#---#-###-#---#-###-#---#-###-#---#-##
---#-#-------#-#-------#-#-------#-#-------#-#-------#-#-------#-#-------#-#-------#-#-------#-#----
#--#-#----#--#-#----#--#-#----#--#-#----#--#-#----#--#-#----#--#-#----#--#-#----#--#-#----#--#-#----
--#--##-##--#--##-##--#--##-##--#--##-##--#--##-##--#--##-##--#--##-##--#--##-##--#--##-##--#--##-##
-------#---------#---------#---------#---------#---------#---------#---------#---------#---------#--
-#-#---#---#-#---#---#-#---#---#-#---#---#-#---#---#-#---#---#-#---#---#-#---#---#-#---#---#-#---#--
--##--------##--------##--------##--------##--------##--------##--------##--------##--------##------
-#--#------#--#------#--#------#--#------#--#------#--#------#--#------#--#------#--#------#--#-----
---------#---------#---------#---------#---------#---------#---------#---------#---------#---------#
-##------#-##------#-##------#-##------#-##------#-##------#-##------#-##------#-##------#-##------#
#-#---#-###-#---#-###-#---#-###-#---#-###-#---#-###-#---#-###-#---#-###-#---#-###-#---#-###-#---#-##
---#-#-------#-#-------#-#-------#-#-------#-#-------#-#-------#-#-------#-#-------#-#-------#-#----
#--#-#----#--#-#----#--#-#----#--#-#----#--#-#----#--#-#----#--#-#----#--#-#----#--#-#----#--#-#----
--#--##-##--#--##-##--#--##-##--#--##-##--#--##-##--#--##-##--#--##-##--#--##-##--#--##-##--#--##-##
-------#---------#---------#---------#---------#---------#---------#---------#---------#---------#--
-#-#---#---#-#---#---#-#---#---#-#---#---#-#---#---#-#---#---#-#---#---#-#---#---#-#---#---#-#---#--
--##--------##--------##--------##--------##--------##--------##--------##--------##--------##------
-#--#------#--#------#--#------#--#------#--#------#--#------#--#------#--#------#--#------#--#-----
---------#---------#---------#---------#---------#---------#---------#---------#---------#---------#
-##------#-##------#-##------#-##------#-##------#-##------#-##------#-##------#-##------#-##------#
#-#---#-###-#---#-###-#---#-###-#---#-###-#---#-###-#---#-###-#---#-###-#---#-###-#---#-###-#---#-##
---#-#-------#-#-------#-#-------#-#-------#-#-------#-#-------#-#-------#-#-------#-#-------#-#----
#--#-#----#--#-#----#--#-#----#--#-#----#--#-#----#--#-#----#--#-#----#--#-#----#--#-#----#--#-#----
--#--##-##--#--##-##--#--##-##--#--##-##--#--##-##--#--##-##--#--##-##--#--##-##--#--##-##--#--##-##
-------#---------#---------#---------#---------#---------#---------#---------#---------#---------#--
-#-#---#---#-#---#---#-#---#---#-#---#---#-#---#---#-#---#---#-#---#---#-#---#---#-#---#---#-#---#--
--##--------##--------##--------##--------##--------##--------##--------##--------##--------##------
-#--#------#--#------#--#------#--#------#--#------#--#------#--#------#--#------#--#------#--#-----
---------#---------#---------#---------#---------#---------#---------#---------#---------#---------#
-##------#-##------#-##------#-##------#-##------#-##------#-##------#-##------#-##------#-##------#
#-#---#-###-#---#-###-#---#-###-#---#-###-#---#-###-#---#-###-#---#-###-#---#-###-#---#-###-#---#-##
---#-#-------#-#-------#-#-------#-#-------#-#-------#-#-------#-#-------#-#-------#-#-------#-#----
#--#-#----#--#-#----#--#-#----#--#-#----#--#-#----#--#-#----#--#-#----#--#-#----#--#-#----#--#-#----
--#--##-##--#--##-##--#--##-##--#--##-##--#--##-##--#--##-##--#--##-##--#--##-##--#--##-##--#--##-##
-------#---------#---------#---------#---------#---------#---------#---------#---------#---------#--
-#-#---#---#-#---#---#-#---#---#-#---#---#-#---#---#-#---#---#-#---#---#-#---#---#-#---#---#-#---#--
--##--------##--------##--------##--------##--------##--------##--------##--------##--------##------
-#--#------#--#------#--#------#--#------#--#------#--#------#--#------#--#------#--#------#--#-----
---------#---------#---------#---------#---------#---------#---------#---------#---------#---------#
-##------#-##------#-##------#-##------#-##------#-##------#-##------#-##------#-##------#-##------#
#-#---#-###-#---#-###-#---#-###-#---#-###-#---#-###-#---#-###-#---#-###-#---#-###-#---#-###-#---#-##
---#-#-------#-#-------#-#-------#-#-------#-#-------#-#-------#-#-------#-#-------#-#-------#-#----
#--#-#----#--#-#----#--#-#----#--#-#----#--#-#----#--#-#----#--#-#----#--#-#----#--#-#----#--#-#----
--#--##-##--#--##-##--#--##-##--#--##-##--#--##-##--#--##-##--#--##-##--#--##-##--#--##-##--#--##-##
-------#---------#---------#---------#---------#---------#---------#---------#---------#---------#--
-#-#---#---#-#---#---#-#---#---#-#---#---#-#---#---#-#---#---#-#---#---#-#---#---#-#---#---#-#---#--
--##--------##--------##--------##--------##--------##--------##--------##--------##--------##------
-#--#------#--#------#--#------#--#------#--#------#--#------#--#------#--#------#--#------#--#-----
---------#---------#---------#---------#---------#---------#---------#---------#---------#---------#
-##------#-##------#-##------#-##------#-##------#-##------#-##------#-##------#-##------#-##------#
