-#----#-#--#----#-#--#----#-#--#----#-#--#----#-#--#----#-#--#----#-#--#----#-#--#----#-#--#----#-#-
--------#---------#---------#---------#---------#---------#---------#---------#---------#---------#-
-------##--------##--------##--------##--------##--------##--------##--------##--------##--------##-
#-------#-#-------#-#-------#-#-------#-#-------#-#-------#-#-------#-#-------#-#-------#-#-------#-
----#--###----#--###----#--###----#--###----#--###----#--###----#--###----#--###----#--###----#--###
-#--#--##--#--#--##--#--#--##--#--#--##--#--#--##--#--#--##--#--#--##--#--#--##--#--#--##--#--#--##-
---##--------##--------##--------##--------##--------##--------##--------##--------##--------##-----
-#--#--#---#--#--#---#--#--#---#--#--#---#--#--#---#--#-E#---#--#--#---#--#--#---#--#--#---#--#--#--
-#---------#---------#---------#---------#---------#---------#---------#---------#---------#--------
-##--------##--------##--------##--------##--------##--------##--------##--------##--------##-------
-#----#-#--#----#-#--#----#-#--#----#-#--#----#-#--#----#-#--#----#-#--#----#-#--#----#-#--#----#-#-
--------#---------#---------#---------#---------#---------#---------#---------#---------#---------#-
-------##--------##--------##--------##--------##--------##--------##--------##--------##--------##-
#-------#-#-------#-#-------#-#-------#-#-------#-#-------#-#-------#-#-------#-#-------#-#-S-----#-
----#--###----#--###----#--###----#--###----#--###----#--###----#--###----#--###----#--###----#--###
-#--#--##--#--#--##--#--#--##--#--#--##--#--#--##--#--#--##--#--#--##--#--#--##--#--#--##--#--#--##-
---##--------##--------##--------##--------##--------##--------##--------##--------##--------##-----
-#--#--#---#--#--#---#--#--#---#--#--#---#--#--#---#--#--#---#--#--#---#--#--#---#--#--#---#--#--#--
-#---------#---------#---------#---------#---------#---------#---------#---------#---------#--------
-##--------##--------##--------##--------##--------##--------##--------##--------##--------##-------
-#----#-#--#----#-#--#----#-#--#----#-#--#----#-#--#----#-#--#----#-#--#----#-#--#----#-#--#----#-#-
--------#---------#---------#---------#---------#---------#---------#---------#---------#---------#-
-------##--------##--------##--------##--------##--------##--------##--------##--------##--------##-
#-------#-#-------#-#-------#-#-------#-#-------#-#-------#-#-------#-#-------#-#-------#-#-------#-
----#--###----#--###----#--###----#--###----#--###----#--###----#--###----#--###----#--###----#--###
-#--#--##--#--#--##--#--#--##--#--#--##--#--#--##--#--#--##--#--#--##--#--#--##--#--#--##--#--#--##-
---##--------##--------##--------##--------##--------##--------##--------##--------##--------##-----
-#--#--#---#--#--#---#--#--#---#--#--#---#--#--#---#--#--#---#--#--#---#--#--#---#--#--#---#--#--#--
-#---------#---------#---------#---------#---------#---------#---------#---------#---------#--------
-##--------##--------##--------##--------##--------##--------##--------##--------##--------##-------
-#----#-#--#----#-#--#----#-#--#----#-#--#----#-#--#----#-#--#----#-#--#----#-#--#----#-#--#----#-#-
--------#---------#---------#---------#---------#---------#---------#---------#---------#---------#-
-------##--------##--------##--------##--------##--------##--------##--------##--------##--------##-
#-------#-#-------#-#-------#-#-------#-#-------#-#-------#-#-------#-#-------#-#-------#-#-------#-
----#--###----#--###----#--###----#--###----#--###----#--###----#--###----#--###----#--###----#--###
-#--#--##--#--#--##--#--#--##--#--#--##--#--#--##--#--#--##--#--#--##--#--#--##--#--#--##--#--#--##-
---##--------##--------##--------##--------##--------##--------##--------##--------##--------##-----
-#--#--#---#--#--#---#--#--#---#--#--#---#--#--#---#--#--#---#--#--#---#--#--#---#--#--#---#--#--#--
-#---------#---------#---------#---------#---------#---------#---------#---------#---------#--------
-##--------##--------##--------##--------##--------##--------##--------##--------##--------##-------
-#----#-#--#----#-#--#----#-#--#----#-#--#----#-#--#----#-#--#----#-#--#----#-#--#----#-#--#----#-#-
--------#---------#---------#---------#---------#---------#---------#---------#---------#---------#-
-------##--------##--------##--------##--------##--------##--------##--------##--------##--------##-
#-------#-#-------#-#-------#-#-------#-#-------#-#-------#-#-------#-#-------#-#-------#-#-------#-
----#--###----#--###----#--###----#--###----#--###----#--###----#--###----#--###----#--###----#--###
-#--#--##--#--#--##--#--#--##--#--#--##--#--#--##--#--#--##--#--#--##--#--#--##--#--#--##--#--#--##-
---##--------##--------##--------##--------##--------##--------##--------##--------##--------##-----
-#--#--#---#--#--#---#--#--#---#--#--#---#--#--#---#--#--#---#--#--#---#--#--#---#--#--#---#--#--#--
-#---------#---------#---------#---------#---------#---------#---------#---------#---------#--------
-##--------##--------##--------##--------##--------##--------##--------##--------##--------##-------
-#----#-#--#----#-#--#----#-#--#----#-#--#----#-#--#----#-#--#----#-#--#----#-#--#----#-#--#----#-#-
--------#---------#---------#---------#---------#---------#---------#---------#---------#---------#-
-------##--------##--------##--------##--------##--------##--------##--------##--------##--------##-
#-------#-#-------#-#-------#-#-------#-#-------#-#-------#-#-------#-#-------#-#-------#-#-------#-
----#--###----#--###----#--###----#--###----#--###----#--###----#--###----#--###----#--###----#--###
-#--#--##--#--#--##--#--#--##--#--#--##--#--#--##--#--#--##--#--#--##--#--#--##--#--#--##--#--#--##-
---##--------##--------##--------##--------##--------##--------##--------##--------##--------##-----
-#--#--#---#--#--#---#--#--#---#--#--#---#--#--#---#--#--#---#--#--#---#--#--#---#--#--#---#--#--#--
-#---------#---------#---------#---------#---------#---------#---------#---------#---------#--------
-##--------##--------##--------##--------##--------##--------##--------##--------##--------##-------
-#----#-#--#----#-#--#----#-#--#----#-#--#----#-#--#----#-#--#----#-#--#----#-#--#----#-#--#----#-#-
--------#---------#---------#---------#---------#---------#---------#---------#---------#---------#-
-------##--------##--------##--------##--------##--------##--------##--------##--------##--------##-
#-------#-#-------#-#-------#-#-------#-#-------#-#-------#-#-------#-#-------#-#-------#-#-------#-
----#--###----#--###----#--###----#--###----#--###----#--###----#--###----#--###----#--###----#--###
-#--#--##--#--#--##--#--#--##--#--#--##--#--#--##--#--#--##--#--#--##--#--#--##--#--#--##--#--#--##-
---##--------##--------##--------##--------##--------##--------##--------##--------##--------##-----
-#--#--#---#--#--#---#--#--#---#--#--#---#--#--#---#--#--#---#--#--#---#--#--#---#--#--#---#--#--#--
-#---------#---------#---------#---------#---------#---------#---------#---------#---------#--------
-##--------##--------##--------##--------##--------##--------##--------##--------##--------##-------
-#----#-#--#----#-#--#----#-#--#----#-#--#----#-#--#----#-#--#----#-#--#----#-#--#----#-#--#----#-#-
--------#---------#---------#---------#---------#---------#---------#---------#---------#---------#-
-------##--------##--------##--------##--------##--------##--------##--------##--------##--------##-
#-------#-#-------#-#-------#-#-------#-#-------#-#-------#-#-------#-#-------#-#-------#-#-------#-
----#--###----#--###----#--###----#--###----#--###----#--###----#--###----#--###----#--###----#--###
-#--#--##--#--#--##--#--#--##--#--#--##--#--#--##--#--#--##--#--#--##--#--#--##--#--#--##--#--#--##-
---##--------##--------##--------##--------##--------##--------##--------##--------##--------##-----
-#--#--#---#--#--#---#--#--#---#--#--#---#--#--#---#--#--#---#--#--#---#--#--#---#--#--#---#--#--#--
-#---------#---------#---------#---------#---------#---------#---------#---------#---------#--------
-##--------##--------##--------##--------##--------##--------##--------##--------##--------##-------
-#----#-#--#----#-#--#----#-#--#----#-#--#----#-#--#----#-#--#----#-#--#----#-#--#----#-#--#----#-#-
--------#---------#---------#---------#---------#---------#---------#---------#---------#---------#-
-------##--------##--------##--------##--------##--------##--------##--------##--------##--------##-
#-------#-#-------#-#-------#-#-------#-#-------#-#-------#-#-------#-#-------#-#-------#-#-------#-
----#--###----#--###----#--###----#--###----#--###----#--###----#--###----#--###----#--###----#--###
-#--#--##--#--#--##--#--#--##--#--#--##--#--#--##--#--#--##--#--#--##--#--#--##--#--#--##--#--#--##-
---##--------##--------##--------##--------##--------##--------##--------##--------##--------##-----
-#--#--#---#--#--#---#--#--#---#--#--#---#--#--#---#--#--#---#--#--#---#--#--#---#--#--#---#--#--#--
-#---------#---------#---------#---------#---------#---------#---------#---------#---------#--------
-##--------##--------##--------##--------##--------##--------##--------##--------##--------##-------
-#----#-#--#----#-#--#----#-#--#----#-#--#----#-#--#----#-#--#----#-#--#----#-#--#----#-#--#----#-#-
--------#---------#---------#---------#---------#---------#---------#---------#---------#---------#-
-------##--------##--------##--------##--------##--------##--------##--------##--------##--------##-
#-------#-#-------#-#-------#-#-------#-#-------#-#-------#-#-------#-#-------#-#-------#-#-------#-
----#--###----#--###----#--###----#--###----#--###----#--###----#--###----#--###----#--###----#--###
-#--#--##--#--#--##--#--#--##--#--#--##--#--#--##--#--#--##--#--#--##--#--#--##--#--#--##--#--#--##-
---##--------##--------##--------##--------##--------##--------##--------##--------##--------##-----
-#--#--#---#--#--#---#--#--#---#--#--#---#--#--#---#--#--#---#--#--#---#--#--#---#--#--#---#--#--#--
-#---------#---------#---------#---------#---------#---------#---------#---------#---------#--------
-##--------##--------##--------##--------##--------##--------##--------##--------##--------##-------
