----##-###----##-###----##-###----##-###----##-###----##-###----##-###----##-###----##-###----##-###
--####-#----####-#----####-#----####-#----####-#----####-#----####-#----####-#----####-#----####-#--
-#---#-----#---#-----#---#-----#---#-----#---#-----#---#-----#---#-----#---#-----#---#-----#---#----
-#-----#---#-----#---#-----#---#-----#---#-----#---#-----#---#-----#---#-----#---#-----#---#-----#--
--##--------##--------##--------##--------##--------##--------##--------##--------##--------##------
------#---------#---------#---------#---------#---------#---------#---------#---------#---------#---
#----#----#----#----#----#----#----#----#----#----#----#----#----#----#----#----#----#----#----#----
#----#--#-#----#--#-#----#--#-#----#--#-#----#--#-#----#--#-#----#--#-#----#--#-#----#--#-#----#--#-
----##-#------##-#------##-#------##-#------##-#------##-#------##-#------##-#------##-#------##-#--
##--#-----##--#-----##--#-----##--#-----##--#-----##--#-----##--#-----##--#-----##--#-----##--#-----
----##-###----##-###----##-###----##-###----##-###----##-###----##-###----##-###----##-###----##-###
--####-#----####-#--E-####-#----####-#----####-#----####-#S---####-#----####-#----####-#----####-#--
-#---#-----#---#-----#---#-----#---#-----#---#-----#---#-----#---#-----#---#-----#---#-----#---#----
-#-----#---#-----#---#-----#---#-----#---#-----#---#-----#---#-----#---#-----#---#-----#---#-----#--
--##--------##--------##--------##--------##--------##--------##--------##--------##--------##------
------#---------#---------#---------#---------#---------#---------#---------#---------#---------#---
#----#----#----#----#----#----#----#----#----#----#----#----#----#----#----#----#----#----#----#----
#----#--#-#----#--#-#----#--#-#----#--#-#----#--#-#----#--#-#----#--#-#----#--#-#----#--#-#----#--#-
----##-#------##-#------##-#------##-#------##-#------##-#------##-#------##-#------##-#------##-#--
##--#-----##--#-----##--#-----##--#-----##--#-----##--#-----##--#-----##--#-----##--#-----##--#-----
----##-###----##-###----##-###----##-###----##-###----##-###----##-###----##-###----##-###----##-###
--####-#----####-#----####-#----####-#----####-#----####-#----####-#----####-#----####-#----####-#--
-#---#-----#---#-----#---#-----#---#-----#---#-----#---#-----#---#-----#---#-----#---#-----#---#----
-#-----#---#-----#---#-----#---#-----#---#-----#---#-----#---#-----#---#-----#---#-----#---#-----#--
--##--------##--------##--------##--------##--------##--------##--------##--------##--------##------
------#---------#---------#---------#---------#---------#---------#---------#---------#---------#---
#----#----#----#----#----#----#----#----#----#----#----#----#----#----#----#----#----#----#----#----
#----#--#-#----#--#-#----#--#-#----#--#-#----#--#-#----#--#-#----#--#-#----#--#-#----#--#-#----#--#-
----##-#------##-#------##-#------##-#------##-#------##-#------##-#------##-#------##-#------##-#--
##--#-----##--#-----##--#-----##--#-----##--#-----##--#-----##--#-----##--#-----##--#-----##--#-----
----##-###----##-###----##-###----##-###----##-###----##-###----##-###----##-###----##-###----##-###
--####-#----####-#----####-#----####-#----####-#----####-#----####-#----####-#----####-#----####-#--
-#---#-----#---#-----#---#-----#---#-----#---#-----#---#-----#---#-----#---#-----#---#-----#---#----
-#-----#---#-----#---#-----#---#-----#---#-----#---#-----#---#-----#---#-----#---#-----#---#-----#--
--##--------##--------##--------##--------##--------##--------##--------##--------##--------##------
------#---------#---------#---------#---------#---------#---------#---------#---------#---------#---
#----#----#----#----#----#----#----#----#----#----#----#----#----#----#----#----#----#----#----#----
#----#--#-#----#--#-#----#--#-#----#--#-#----#--#-#----#--#-#----#--#-#----#--#-#----#--#-#----#--#-
----##-#------##-#------##-#------##-#------##-#------##-#------##-#------##-#------##-#------##-#--
##--#-----##--#-----##--#-----##--#-----##--#-----##--#-----##--#-----##--#-----##--#-----##--#-----
----##-###----##-###----##-###----##-###----##-###----##-###----##-###----##-###----##-###----##-###
--####-#----####-#----####-#----####-#----####-#----####-#----####-#----####-#----####-#----####-#--
-#---#-----#---#-----#---#-----#---#-----#---#-----#---#-----#---#-----#---#-----#---#-----#---#----
-#-----#---#-----#---#-----#---#-----#---#-----#---#-----#---#-----#---#-----#---#-----#---#-----#--
--##--------##--------##--------##--------##--------##--------##--------##--------##--------##------
------#---------#---------#---------#---------#---------#---------#---------#---------#---------#---
#----#----#----#----#----#----#----#----#----#----#----#----#----#----#----#----#----#----#----#----
#----#--#-#----#--#-#----#--#-#----#--#-#----#--#-#----#--#-#----#--#-#----#--#-#----#--#-#----#--#-
----##-#------##-#------##-#------##-#------##-#------##-#------##-#------##-#------##-#------##-#--
##--#-----##--#-----##--#-----##--#-----##--#-----##--#-----##--#-----##--#-----##--#-----##--#-----
----##-###----##-###----##-###----##-###----##-###----##-###----##-###----##-###----##-###----##-###
--####-#----####-#----####-#----####-#----####-#----####-#----####-#----####-#----####-#----####-#--
-#---#-----#---#-----#---#-----#---#-----#---#-----#---#-----#---#-----#---#-----#---#-----#---#----
-#-----#---#-----#---#-----#---#-----#---#-----#---#-----#---#-----#---#-----#---#-----#---#-----#--
--##--------##--------##--------##--------##--------##--------##--------##--------##--------##------
------#---------#---------#---------#---------#---------#---------#---------#---------#---------#---
#----#----#----#----#----#----#----#----#----#----#----#----#----#----#----#----#----#----#----#----
#----#--#-#----#--#-#----#--#-#----#--#-#----#--#-#----#--#-#----#--#-#----#--#-#----#--#-#----#--#-
----##-#------##-#------##-#------##-#------##-#------##-#------##-#------##-#------##-#------##-#--
##--#-----##--#-----##--#-----##--#-----##--#-----##--#-----##--#-----##--#-----##--#-----##--#-----
----##-###----##-###----##-###----##-###----##-###----##-###----##-###----##-###----##-###----##-###
--####-#----####-#----####-#----####-#----####-#----####-#----####-#----####-#----####-#----####-#--
-#---#-----#---#-----#---#-----#---#-----#---#-----#---#-----#---#-----#---#-----#---#-----#---#----
-#-----#---#-----#---#-----#---#-----#---#-----#---#-----#---#-----#---#-----#---#-----#---#-----#--
--##--------##--------##--------##--------##--------##--------##--------##--------##--------##------
------#---------#---------#---------#---------#---------#---------#---------#---------#---------#---
#----#----#----#----#----#----#----#----#----#----#----#----#----#----#----#----#----#----#----#----
#----#--#-#----#--#-#----#--#-#----#--#-#----#--#-#----#--#-#----#--#-#----#--#-#----#--#-#----#--#-
----##-#------##-#------##-#------##-#------##-#------##-#------##-#------##-#------##-#------##-#--
##--#-----##--#-----##--#-----##--#-----##--#-----##--#-----##--#-----##--#-----##--#-----##--#-----
----##-###----##-###----##-###----##-###----##-###----##-###----##-###----##-###----##-###----##-###
--####-#----####-#----####-#----####-#----####-#----####-#----####-#----####-#----####-#----####-#--
-#---#-----#---#-----#---#-----#---#-----#---#-----#---#-----#---#-----#---#-----#---#-----#---#----
-#-----#---#-----#---#-----#---#-----#---#-----#---#-----#---#-----#---#-----#---#-----#---#-----#--
--##--------##--------##--------##--------##--------##--------##--------##--------##--------##------
------#---------#---------#---------#---------#---------#---------#---------#---------#---------#---
#----#----#----#----#----#----#----#----#----#----#----#----#----#----#----#----#----#----#----#----
#----#--#-#----#--#-#----#--#-#----#--#-#----#--#-#----#--#-#----#--#-#----#--#-#----#--#-#----#--#-
----##-#------##-#------##-#------##-#------##-#------##-#------##-#------##-#------##-#------##-#--
##--#-----##--#-----##--#-----##--#-----##--#-----##--#-----##--#-----##--#-----##--#-----##--#-----
----##-###----##-###----##-###----##-###----##-###----##-###----##-###----##-###----##-###----##-###
--####-#----####-#----####-#----####-#----####-#----####-#----####-#----####-#----####-#----####-#--
-#---#-----#---#-----#---#-----#---#-----#---#-----#---#-----#---#-----#---#-----#---#-----#---#----
-#-----#---#-----#---#-----#---#-----#---#-----#---#-----#---#-----#---#-----#---#-----#---#-----#--
--##--------##--------##--------##--------##--------##--------##--------##--------##--------##------
------#---------#---------#---------#---------#---------#---------#---------#---------#---------#---
#----#----#----#----#----#----#----#----#----#----#----#----#----#----#----#----#----#----#----#----
#----#--#-#----#--#-#----#--#-#----#--#-#----#--#-#----#--#-#----#--#-#----#--#-#----#--#-#----#--#-
----##-#------##-#------##-#------##-#------##-#------##-#------##-#------##-#------##-#------##-#--
##--#-----##--#-----##--#-----##--#-----##--#-----##--#-----##--#-----##--#-----##--#-----##--#-----
----##-###----##-###----##-###----##-###----##-###----##-###----##-###----##-###----##-###----##-###
--####-#----####-#----####-#----####-#----####-#----####-#----####-#----####-#----####-#----####-#--
-#---#-----#---#-----#---#-----#---#-----#---#-----#---#-----#---#-----#---#-----#---#-----#---#----
-#-----#---#-----#---#-----#---#-----#---#-----#---#-----#---#-----#---#-----#---#-----#---#-----#--
--##--------##--------##--------##--------##--------##--------##--------##--------##--------##------
------#---------#---------#---------#---------#---------#---------#---------#---------#---------#---
#----#----#----#----#----#----#----#----#----#----#----#----#----#----#----#----#----#----#----#----
#----#--#-#----#--#-#----#--#-#----#--#-#----#--#-#----#--#-#----#--#-#----#--#-#----#--#-#----#--#-
----##-#------##-#------##-#------##-#------##-#------##-#------##-#------##-#------##-#------##-#--
##--#-----##--#-----##--#-----##--#-----##--#-----##--#-----##--#-----##--#-----##--#-----##--#-----
