--#---##----#---##----#---##----#---##----#---##----#---##----#---##----#---##----#---##----#---##--
-#----#-#--#----#-#--#----#-#--#----#-#--#----#-#--#----#-#--#----#-#--#----#-#--#----#-#--#----#-#-
---###-------###-------###-------###-------###-------###-------###-------###-------###-------###----
--#----##---#----##---#----##---#----##---#----##---#----##---#----##---#----##---#----##---#----##-
#----#---##----#---##----#---##----#---##----#---##----#---##----#---##----#---##----#---##----#---#
----#---------#---------#---------#---------#---------#---------#---------#---------#---------#-----
---#---#-----#---#-----#---#-----#---#-----#---#-----#---#-----#---#-----#---#-----#---#-----#---#--
-#-##------#-##------#-##------#-##------#-##------#-##------#-##------#-##------#-##------#-##-----
##-#---#E-##-#---#--##-#---#--##-#---#--##-#---#--##-#---#--##-#---#--##-#---#--##-#---#--##-#---#--
#--#------#--#------#--#------#--#------#--#------#--#------#--#------#--#------#--#------#--#------
--#---##----#---##----#---##----#---##----#---##----#---##----#---##----#---##----#---##----#---##--
-#----#-#--#----#-#--#----#-#--#----#-#--#----#-#--#----#-#--#----#-#--#----#-#--#----#-#--#----#-#-
---###-------###-------###-------###-------###-------###-------###-------###-------###-------###----
--#----##---#----##---#----##---#----##---#----##---#----##---#----##---#----##---#----##---#----##-
#----#---##----#---##----#---##----#---##----#---##----#---##----#---##----#---##----#---##----#---#
----#---------#---------#---------#---------#---------#---------#---------#---------#---------#-----
---#---#-----#---#-----#---#-----#---#-----#---#-----#---#-----#---#-----#---#-----#---#-----#---#--
-#-##------#-##------#-##------#-##------#-##------#-##------#-##------#-##------#-##------#-##-----
##-#---#--##-#---#--##-#---#--##-#---#--##-#---#--##-#---#--##-#---#--##-#---#--##-#---#--##-#---#--
#--#------#--#------#--#------#--#------#--#------#--#------#--#------#--#------#--#------#--#------
--#---##----#---##----#---##----#---##----#---##----#---##----#---##----#---##----#---##----#---##--
-#----#-#--#----#-#--#----#-#--#----#-#--#----#-#--#----#-#--#----#-#--#----#-#--#----#-#--#----#-#-
---###-------###-------###-------###-------###-------###-------###-------###-------###-------###----
--#----##---#----##---#----##---#----##---#----##---#----##---#----##---#----##---#----##---#----##-
#----#---##----#---##----#---##----#---##----#---##----#---##----#---##----#---##----#---##----#---#
----#---------#---------#---------#---------#---------#---------#---------#---------#---------#-----
---#---#-----#---#-----#---#-----#---#-----#---#-----#---#-----#---#-----#---#-----#---#-----#---#--
-#-##------#-##------#-##------#-##------#-##------#-##------#-##------#-##------#-##------#-##-----
##-#---#--##-#---#--##-#---#--##-#---#--##-#---#--##-#---#--##-#---#--##-#---#--##-#---#--##-#---#--
#--#------#--#------#--#------#--#------#--#------#--#------#--#------#--#------#--#------#--#------
--#---##----#---##----#---##----#---##----#---##----#---##----#---##----#---##----#---##----#---##--
-#----#-#--#----#-#--#----#-#--#----#-#--#----#-#--#----#-#--#----#-#--#----#-#--#----#-#--#----#-#-
---###-------###-------###-------###-------###-------###-------###-------###-------###-------###----
--#----##---#----##---#----##---#----##---#----##---#----##---#----##---#----##---#----##---#----##-
#----#---##----#---##----#---##----#---##----#---##----#---##----#---##----#---##----#---##----#---#
----#---------#---------#---------#---------#---------#---------#---------#---------#---------#-----
---#---#-----#---#-----#---#-----#---#-----#---#-----#---#-----#---#-----#---#-----#---#-----#---#--
-#-##------#-##------#-##------#-##------#-##------#-##------#-##------#-##------#-##------#-##-----
##-#---#--##-#---#--##-#---#--##-#---#--##-#---#--##-#---#--##-#---#--##-#---#--##-#---#--##-#---#--
#--#------#--#------#--#------#--#------#--#------#--#------#--#------#--#------#--#------#--#------
--#---##----#---##----#---##----#---##----#---##----#---##----#---##----#---##----#---##----#---##--
-#----#-#--#----#-#--#----#-#--#----#-#--#----#-#--#----#-#--#----#-#--#----#-#--#----#-#--#----#-#-
---###-------###-------###-------###-------###-------###-------###-------###-------###-------###----
--#----##---#----##---#----##---#----##---#----##---#----##---#----##---#----##---#----##---#----##-
#----#---##----#---##----#---##----#---##----#---##----#---##----#---##----#---##----#---##----#---#
----#---------#---------#---------#---------#---------#---------#---------#---------#---------#-----
---#---#-----#---#-----#---#-----#---#-----#---#-----#---#-----#---#-----#---#-----#---#-----#---#--
-#-##------#-##------#-##------#-##------#-##------#-##------#-##------#-##------#-##------#-##-----
##-#---#--##-#---#--##-#---#--##-#---#--##-#---#--##-#---#--##-#---#--##-#---#--##-#---#--##-#---#--
#--#------#--#------#--#------#--#------#--#------#--#------#--#------#--#------#--#------#--#------
--#---##----#---##----#---##----#---##----#---##----#---##----#---##----#---##----#---##----#---##--
-#----#-#--#----#-#--#----#-#--#----#-#--#----#-#--#----#-#--#----#-#--#----#-#--#----#-#--#----#-#-
---###-------###-------###-------###-------###-------###-------###-------###-------###-------###----
--#----##---#----##---#----##---#----##---#----##---#----##---#----##---#----##---#----##---#----##-
#----#---##----#---##----#---##----#---##----#---##----#---##----#---##----#---##----#---##----#---#
----#---------#---------#---------#---------#---------#---------#---------#---------#---------#-----
---#---#-----#---#-----#---#-----#---#-----#---#-----#---#-----#---#-----#---#-----#---#-----#---#--
-#-##------#-##------#-##------#-##------#-##------#-##------#-##------#-##------#-##------#-##-----
##-#---#--##-#---#--##-#---#--##-#---#--##-#---#--##-#---#--##-#---#--##-#---#--##-#---#--##-#---#--
#--#------#--#------#--#------#--#------#--#------#--#------#--#------#--#------#--#------#--#------
--#---##----#---##----#---##----#---##----#---##----#---##----#---##----#---##----#---##----#---##--
-#----#-#--#----#-#--#----#-#--#----#-#--#----#-#--#----#-#--#----#-#--#----#-#--#----#-#--#----#-#-
---###-------###-------###-------###-------###-------###-------###-------###-------###-------###----
--#----##---#----##---#----##---#----##---#----##---#----##---#----##---#----##---#----##---#----##-
#----#---##----#---##----#---##----#---##----#---##----#---##----#---##----#---##----#---##----#---#
----#---------#---------#---------#---------#---------#---------#---------#---------#---------#-----
---#---#-----#---#-----#---#-----#---#-----#---#-----#---#-----#---#-----#---#-----#---#-----#---#--
-#-##------#-##------#-##------#-##------#-##------#-##------#-##------#-##------#-##------#-##-----
##-#---#--##-#---#--##-#---#--##-#---#--##-#---#--##-#---#--##-#---#--##-#---#--##-#---#--##-#---#--
#--#------#--#------#--#------#--#------#--#------#--#------#--#------#--#------#--#------#--#------
--#---##----#---##----#---##----#---##----#---##----#---##----#---##----#---##----#---##----#---##--
-#----#-#--#----#-#--#----#-#--#----#-#--#----#-#--#----#-#--#----#-#--#----#-#--#----#-#--#----#-#-
---###-------###-------###-------###-------###-------###-------###-------###-------###-------###----
--#----##---#----##---#----##---#----##---#----##---#----##---#----##---#----##---#----##---#----##-
#----#---##----#---##----#---##----#---##----#---##----#---##----#---##----#---##----#---##----#---#
----#---------#---------#---------#---------#---------#---------#---------#---------#---------#-----
---#---#---S-#---#-----#---#-----#---#-----#---#-----#---#-----#---#-----#---#-----#---#-----#---#--
-#-##------#-##------#-##------#-##------#-##------#-##------#-##------#-##------#-##------#-##-----
##-#---#--##-#---#--##-#---#--##-#---#--##-#---#--##-#---#--##-#---#--##-#---#--##-#---#--##-#---#--
#--#------#--#------#--#------#--#------#--#------#--#------#--#------#--#------#--#------#--#------
--#---##----#---##----#---##----#---##----#---##----#---##----#---##----#---##----#---##----#---##--
-#----#-#--#----#-#--#----#-#--#----#-#--#----#-#--#----#-#--#----#-#--#----#-#--#----#-#--#----#-#-
---###-------###-------###-------###-------###-------###-------###-------###-------###-------###----
--#----##---#----##---#----##---#----##---#----##---#----##---#----##---#----##---#----##---#----##-
#----#---##----#---##----#---##----#---##----#---##----#---##----#---##----#---##----#---##----#---#
----#---------#---------#---------#---------#---------#---------#---------#---------#---------#-----
---#---#-----#---#-----#---#-----#---#-----#---#-----#---#-----#---#-----#---#-----#---#-----#---#--
-#-##------#-##------#-##------#-##------#-##------#-##------#-##------#-##------#-##------#-##-----
##-#---#--##-#---#--##-#---#--##-#---#--##-#---#--##-#---#--##-#---#--##-#---#--##-#---#--##-#---#--
#--#------#--#------#--#------#--#------#--#------#--#------#--#------#--#------#--#------#--#------
--#---##----#---##----#---##----#---##----#---##----#---##----#---##----#---##----#---##----#---##--
-#----#-#--#----#-#--#----#-#--#----#-#--#----#-#--#----#-#--#----#-#--#----#-#--#----#-#--#----#-#-
---###-------###-------###-------###-------###-------###-------###-------###-------###-------###----
--#----##---#----##---#----##---#----##---#----##---#----##---#----##---#----##---#----##---#----##-
#----#---##----#---##----#---##----#---##----#---##----#---##----#---##----#---##----#---##----#---#
----#---------#---------#---------#---------#---------#---------#---------#---------#---------#-----
---#---#-----#---#-----#---#-----#---#-----#---#-----#---#-----#---#-----#---#-----#---#-----#---#--
-#-##------#-##------#-##------#-##------#-##------#-##------#-##------#-##------#-##------#-##-----
##-#---#--##-#---#--##-#---#--##-#---#--##-#---#--##-#---#--##-#---#--##-#---#--##-#---#--##-#---#--
#--#------#--#------#--#------#--#------#--#------#--#------#--#------#--#------#--#------#--#------
