-#-#--#----#-#--#----#-#--#----#-#--#----#-#--#----#-#--#----#-#--#----#-#--#----#-#--#----#-#--#---
----------------------------------------------------------------------------------------------------
#---#--#--#---#--#--#---#--#--#---#--#--#---#--#--#---#--#--#---#--#--#---#--#--#---#--#--#---#--#--
#-#-##---##-#-##---##-#-##---##-#-##---##-#-##---##-#-##---##-#-##---##-#-##---##-#-##---##-#-##---#
--##---#----##---#----##---#----##---#----##---#----##---#----##---#----##---#----##---#----##---#--
#-##------#-##------#-##------#-##------#-##------#-##------#-##------#-##------#-##------#-##------
------#---------#---------#---------#---------#---------#---------#---------#---------#---------#---
#----##---#----##---#----##---#----##---#----##---#----##---#----##---#----##---#----##---#----##---
#--#----#-#--#----#-#--#----#-#--#----#-#--#----#-#--#----#-#--#----#-#--#----#-#--#----#-#--#----#-
##-------###-------###-------###-------###-------###-------###-------###-------###-------###-------#
-#-#--#----#-#--#----#-#--#----#-#--#----#-#--#----#-#--#----#-#--#----#-#--#----#-#--#----#-#--#---
----------------------------------------------------------------------------------------------------
#---#--#--#---#--#--#---#--#--#---#--#--#---#--#--#---#--#--#---#--#--#---#--#--#---#--#--#---#--#--
#-#-##---##-#-##---##-#-##---##-#-##---##-#-##---##-#-##---##-#-##---##-#-##---##-#-##-S-##-#-##---#
--##---#----##---#----##---#----##---#----##---#----##---#----##---#----##---#----##---#----##---#--
#-##------#-##------#-##------#-##------#-##------#-##------#-##------#-##------#-##------#-##------
------#---------#---------#---------#---------#---------#---------#---------#---------#---------#---
#----##---#----##---#----##---#----##---#----##---#----##---#----##---#----##---#----##---#----##---
#--#----#-#--#----#-#--#----#-#--#----#-#--#----#-#--#----#-#--#----#-#--#----#-#--#----#-#--#----#-
##-------###-------###-------###-------###-------###-------###-------###-------###-------###-------#
-#-#--#----#-#--#----#-#--#----#-#--#----#-#--#----#-#--#----#-#--#----#-#--#----#-#--#----#-#--#---
----------------------------------------------------------------------------------------------------
#---#--#--#---#--#--#---#--#--#---#--#--#---#--#--#---#--#--#---#--#--#---#--#--#---#--#--#---#--#--
#-#-##---##-#-##---##-#-##---##-#-##---##-#-##---##-#-##---##-#-##---##-#-##---##-#-##---##-#-##---#
--##---#----##---#----##---#----##---#----##---#----##---#----##---#----##---#----##---#----##---#--
#-##------#-##------#-##------#-##------#-##------#-##------#-##------#-##------#-##------#-##------
------#---------#---------#---------#---------#---------#---------#---------#---------#---------#---
#----##---#----##---#----##---#----##---#----##---#----##---#----##---#----##---#----##---#----##---
#--#----#-#--#----#-#--#----#-#--#----#-#--#----#-#--#----#-#--#----#-#--#----#-#--#----#-#--#----#-
##-------###-------###-------###-------###-------###-------###-------###-------###-------###-------#
-#-#--#----#-#--#----#-#--#----#-#--#----#-#--#----#-#--#----#-#--#----#-#--#----#-#--#----#-#--#---
----------------------------------------------------------------------------------------------------
#---#--#--#---#--#--#---#--#--#---#--#--#---#--#--#---#--#--#---#--#--#---#--#--#---#--#--#---#--#--
#-#-##---##-#-##---##-#-##---##-#-##---##-#-##---##-#-##---##-#-##---##-#-##---##-#-##---##-#-##---#
--##---#----##---#----##---#----##---#----##---#----##---#----##---#----##---#----##---#----##---#--
#-##------#-##------#-##------#-##------#-##------#-##------#-##------#-##------#-##------#-##------
------#---------#---------#---------#---------#---------#---------#---------#---------#---------#---
#----##---#----##---#----##---#----##---#----##---#----##---#----##---#----##---#----##---#----##---
#--#----#-#--#----#-#--#----#-#--#----#-#--#----#-#--#----#-#--#----#-#--#----#-#--#----#-#--#----#-
##-------###-------###-------###-------###-------###-------###-------###-------###-------###-------#
-#-#--#----#-#--#----#-#--#----#-#--#----#-#--#----#-#--#----#-#--#----#-#--#----#-#--#----#-#--#---
----------------------------------------------------------------------------------------------------
#---#--#--#---#--#--#---#--#--#---#--#--#---#--#--#---#--#--#---#--#--#---#--#--#---#--#--#---#--#--
#-#-##---##-#-##---##-#-##---##-#-##---##-#-##---##-#-##---##-#-##---##-#-##---##-#-##---##-#-##---#
--##---#----##---#----##---#----##---#----##---#----##---#----##---#----##---#----##---#----##---#--
#-##------#-##------#-##------#-##------#-##------#-##------#-##------#-##------#-##------#-##------
------#---------#---------#---------#---------#---------#---------#---------#---------#---------#---
#----##---#----##---#----##---#----##---#----##---#----##---#----##---#----##---#----##---#----##---
#--#----#-#--#----#-#--#----#-#--#----#-#--#----#-#--#----#-#--#----#-#--#----#-#--#----#-#--#----#-
##-------###-------###-------###-------###-------###-------###-------###-------###-------###-------#
-#-#--#----#-#--#----#-#--#----#-#--#----#-#--#----#-#--#----#-#--#----#-#--#----#-#--#----#-#--#---
----------------------------------------------------------------------------------------------------
#---#--#--#---#--#--#---#--#--#---#--#--#---#--#--#---#--#--#---#--#--#---#--#--#---#--#--#---#--#--
#-#-##---##-#-##---##-#-##---##-#-##---##-#-##---##-#-##---##-#-##---##-#-##---##-#-##---##-#-##---#
--##---#----##---#----##---#----##---#----##---#----##---#----##---#----##---#----##---#----##---#--
#-##------#-##------#-##------#-##------#-##------#-##------#-##------#-##------#-##------#-##------
------#---------#---------#---------#---------#---------#---------#---------#---------#---------#---
#----##---#----##---#----##---#----##---#----##---#----##---#----##---#----##---#----##---#----##---
#--#----#-#--#----#-#--#----#-#--#----#-#--#----#-#--#----#-#--#----#-#--#----#-#--#----#-#--#----#-
##-------###-------###-------###-------###-------###-------###-------###-------###-------###-------#
-#-#--#----#-#--#----#-#--#----#-#--#----#-#--#----#-#--#----#-#--#----#-#--#----#-#--#----#-#--#---
----------------------------------------------------------------------------------------------------
#---#--#--#---#--#--#---#--#--#---#--#--#---#--#--#---#--#--#---#--#--#---#--#--#---#--#--#---#--#--
#-#-##---##-#-##---##-#-##---##-#-##---##-#-##---##-#-##---##-#-##---##-#-##---##-#-##---##-#-##---#
--##---#----##---#----##---#----##---#----##---#----##---#----##---#----##---#----##---#----##---#--
#-##------#-##------#-##------#-##------#-##------#-##------#-##------#-##------#-##------#-##------
------#---------#---------#---------#---------#---------#---------#---------#---------#---------#---
#----##---#----##---#----##---#----##---#----##---#----##---#----##---#----##---#----##---#----##---
#--#----#-#--#----#-#--#----#-#--#----#-#--#----#-#--#----#-#--#----#-#--#----#-#--#----#-#--#----#-
##-------###-------###-------###-------###-------###-------###-------###-------###-------###-------#
-#-#--#----#-#--#----#-#--#----#-#--#----#-#--#----#-#--#----#-#--#----#-#--#----#-#--#----#-#--#---
----------------------------------------------------------------------------------------------------
#---#--#--#---#--#--#E--#--#--#---#--#--#---#--#--#---#--#--#---#--#--#---#--#--#---#--#--#---#--#--
#-#-##---##-#-##---##-#-##---##-#-##---##-#-##---##-#-##---##-#-##---##-#-##---##-#-##---##-#-##---#
--##---#----##---#----##---#----##---#----##---#----##---#----##---#----##---#----##---#----##---#--
#-##------#-##------#-##------#-##------#-##------#-##------#-##------#-##------#-##------#-##------
------#---------#---------#---------#---------#---------#---------#---------#---------#---------#---
#----##---#----##---#----##---#----##---#----##---#----##---#----##---#----##---#----##---#----##---
#--#----#-#--#----#-#--#----#-#--#----#-#--#----#-#--#----#-#--#----#-#--#----#-#--#----#-#--#----#-
##-------###-------###-------###-------###-------###-------###-------###-------###-------###-------#
-#-#--#----#-#--#----#-#--#----#-#--#----#-#--#----#-#--#----#-#--#----#-#--#----#-#--#----#-#--#---
----------------------------------------------------------------------------------------------------
#---#--#--#---#--#--#---#--#--#---#--#--#---#--#--#---#--#--#---#--#--#---#--#--#---#--#--#---#--#--
#-#-##---##-#-##---##-#-##---##-#-##---##-#-##---##-#-##---##-#-##---##-#-##---##-#-##---##-#-##---#
--##---#----##---#----##---#----##---#----##---#----##---#----##---#----##---#----##---#----##---#--
#-##------#-##------#-##------#-##------#-##------#-##------#-##------#-##------#-##------#-##------
------#---------#---------#---------#---------#---------#---------#---------#---------#---------#---
#----##---#----##---#----##---#----##---#----##---#----##---#----##---#----##---#----##---#----##---
#--#----#-#--#----#-#--#----#-#--#----#-#--#----#-#--#----#-#--#----#-#--#----#-#--#----#-#--#----#-
##-------###-------###-------###-------###-------###-------###-------###-------###-------###-------#
-#-#--#----#-#--#----#-#--#----#-#--#----#-#--#----#-#--#----#-#--#----#-#--#----#-#--#----#-#--#---
----------------------------------------------------------------------------------------------------
#---#--#--#---#--#--#---#--#--#---#--#--#---#--#--#---#--#--#---#--#--#---#--#--#---#--#--#---#--#--
#-#-##---##-#-##---##-#-##---##-#-##---##-#-##---##-#-##---##-#-##---##-#-##---##-#-##---##-#-##---#
--##---#----##---#----##---#----##---#----##---#----##---#----##---#----##---#----##---#----##---#--
#-##------#-##------#-##------#-##------#-##------#-##------#-##------#-##------#-##------#-##------
------#---------#---------#---------#---------#---------#---------#---------#---------#---------#---
#----##---#----##---#----##---#----##---#----##---#----##---#----##---#----##---#----##---#----##---
#--#----#-#--#----#-#--#----#-#--#----#-#--#----#-#--#----#-#--#----#-#--#----#-#--#----#-#--#----#-
##-------###-------###-------###-------###-------###-------###-------###-------###-------###-------#
