------#--#------#--#------#--#------#--#------#--#------#--#------#--#------#--#------#--#------#--#
#-#--##--##-#--##--##-#--##--##-#--##--##-#--##--##-#--##--##-#--##--##-#--##--##-#--##--##-#--##--#
----------------------------------------------------------------------------------------------------
#--#-#---##--#-#---##--#-#---##--#-#---##--#-#---##--#-#---##--#-#---##--#-#---##--#-#---##--#-#---#
#-#-#---###-#-#---###-#-#---###-#-#---###-#-#---###-#-#---###-#-#---###-#-#---###-#-#---###-#-#---##
---#---#-----#---#-----#---#-----#---#-----#---#-----#---#-----#---#-----#---#-----#---#-----#---#--
--##--------##--------##--------##--------##--------##--------##--------##--------##--------##------
---#--#------#--#------#--#------#--#------#--#------#--#------#--#------#--#------#--#------#--#---
----#---------#---------#---------#---------#---------#---------#---------#---------#---------#-----
--##-#------##-#------##-#------##-#------##-#------##-#------##-#------##-#------##-#------##-#----
------#--#------#--#------#--#------#--#------#--#------#--#------#--#------#--#------#--#------#--#
#-#--##--##-#--##--##-#--##--##-#--##--##-#--##--##-#--##--##-#--##--##-#--##--##-#--##--##-#--##--#
----------------------------------------------------------------------------------------------------
#--#-#---##--#-#---##--#-#---##--#-#---##--#-#---##--#-#---##--#-#---##--#-#---##--#-#---##--#-#---#
#-#-#---###-#-#---###-#-#---###-#-#---###-#-#---###-#-#---###-#-#---###-#-#---###-#-#---###-#-#---##
---#---#-----#---#-----#---#-----#---#-----#---#-----#---#-----#---#-----#---#-----#---#-----#---#--
--##--------##--------##--------##--------##--------##--------##--------##--------##--------##------
---#--#------#--#------#--#------#--#------#--#------#--#------#--#------#--#------#--#------#--#---
----#---------#---------#---------#---------#---------#---------#---------#---------#---------#-----
--##-#------##-#------##-#------##-#------##-#------##-#------##-#------##-#------##-#------##-#----
------#--#------#--#------#--#------#--#------#--#------#--#------#--#------#--#------#--#------#--#
#-#--##--##-#--##--##-#--##--##-#--##--##-#--##--##-#--##--##-#--##--##-#--##--##-#--##--##-#--##--#
-------------------------------------------------S--------------------------------------------------
#--#-#---##--#-#---##--#-#---##--#-#---##--#-#---##--#-#---##--#-#---##--#-#---##--#-#---##--#-#---#
#-#-#---###-#-#---###-#-#---###-#-#---###-#-#---###-#-#---###-#-#---###-#-#---###-#-#---###-#-#---##
---#---#-----#---#-----#---#-----#---#-----#---#-----#---#-----#---#-----#---#-----#---#-----#---#--
--##--------##--------##--------##--------##--------##--------##--------##--------##--------##------
---#--#------#--#------#--#------#--#------#--#------#--#------#--#------#--#------#--#------#--#---
----#---------#---------#---------#---------#---------#---------#---------#---------#---------#-----
--##-#------##-#------##-#------##-#------##-#------##-#------##-#------##-#------##-#------##-#----
------#--#------#--#------#--#------#--#------#--#------#--#------#--#------#--#------#--#------#--#
#-#--##--##-#--##--##-#--##--##-#--##--##-#--##--##-#--##--##-#--##--##-#--##--##-#--##--##-#--##--#
----------------------------------------------------------------------------------------------------
#--#-#---##--#-#---##--#-#---##--#-#---##--#-#---##--#-#---##--#-#---##--#-#---##--#-#---##--#-#---#
#-#-#---###-#-#---###-#-#---###-#-#---###-#-#---###-#-#---###-#-#---###-#-#---###-#-#---###-#-#---##
---#---#-----#---#-----#---#-----#---#-----#---#-----#---#-----#---#-----#---#-----#---#-----#---#--
--##--------##--------##--------##--------##--------##--------##--------##--------##--------##------
---#--#------#--#------#--#------#--#------#--#------#--#------#--#------#--#------#--#------#--#---
----#---------#---------#---------#---------#---------#---------#---------#---------#---------#-----
--##-#------##-#------##-#------##-#------##-#------##-#------##-#------##-#------##-#------##-#----
------#--#------#--#------#--#------#--#------#--#------#--#------#--#------#--#------#--#------#--#
#-#--##--##-#--##--##-#--##--##-#--##--##-#--##--##-#--##--##-#--##--##-#--##--##-#--##--##-#--##--#
----------------------------------------------------------------------------------------------------
#--#-#---##--#-#---##--#-#---##--#-#---##--#-#---##--#-#---##--#-#---##--#-#---##--#-#---##--#-#---#
#-#-#---###-#-#---###-#-#---###-#-#---###-#-#---###-#-#---###-#-#---###-#-#---###-#-#---###-#-#---##
---#---#-----#---#-----#---#-----#---#-----#---#-----#---#-----#---#-----#---#-----#---#-----#---#--
--##--------##--------##--------##--------##--------##--------##--------##--------##--------##------
---#--#------#--#------#--#------#--#------#--#------#--#------#--#------#--#------#--#------#--#---
----#---------#---------#---------#---------#---------#---------#---------#---------#---------#-----
--##-#------##-#------##-#------##-#------##-#------##-#------##-#------##-#------##-#------##-#----
------#--#------#--#------#--#------#--#------#--#------#--#------#--#------#--#------#--#------#--#
#-#--##--##-#--##--##-#--##--##-#--##--##-#--##--##-#--##--##-#--##--##-#--##--##-#--##--##-#--##--#
----------------------------------------------------------------------------------------------------
#--#-#---##--#-#---##--#-#---##--#-#---##--#-#---##--#-#---##--#-#---##--#-#---##--#-#---##--#-#---#
#-#-#---###-#-#---###-#-#---###-#-#---###-#-#---###-#-#---###-#-#---###-#-#---###-#-#---###-#-#---##
---#---#-----#---#-----#---#-----#---#-----#---#-----#---#-----#---#-----#---#-----#---#-----#---#--
--##--------##--------##--------##--------##--------##--------##--------##--------##--------##------
---#--#------#--#------#--#------#--#------#--#------#--#------#--#------#--#------#--#------#--#---
----#---------#---------#---------#---------#---------#---------#---------#---------#---------#-----
--##-#------##-#------##-#------##-#------##-#------##-#------##-#------##-#------##-#------##-#----
------#--#------#--#------#--#------#--#------#--#------#--#------#--#------#--#------#--#------#--#
#-#--##--##-#--##--##-#--##--##-#--##--##-#--##--##-#--##--##-#--##--##-#--##--##-#--##--##-#--##--#
----------------------------------------------------------------------------------------------------
#--#-#---##--#-#---##--#-#---##--#-#---##--#-#---##--#-#---##--#-#---##--#-#---##--#-#---##--#-#---#
#-#-#---###-#-#---###-#-#---###-#-#---###-#-#---###-#-#---###-#-#---###-#-#---###-#-#---###-#-#---##
---#---#-----#---#-----#---#-----#---#-----#---#-----#---#-----#---#-----#---#-----#---#-----#---#--
--##--------##--------##--------##--------##--------##--------##--------##--------##--------##------
---#--#------#--#------#--#------#--#------#--#------#--#------#--#------#--#------#--#------#--#---
----#---------#---------#---------#---------#---------#---------#---------#---------#---------#-----
--##-#------##-#------##-#------##-#------##-#------##-#------##-#------##-#------##-#------##-#----
------#--#------#--#------#--#------#--#------#--#------#--#------#--#------#--#------#--#------#--#
#-#--##--##-#--##--##-#--##--##-#--##--##-#--##--##-#--##--##-#--##--##-#--##--##-#--##--##-#--##--#
----------------------------------------------------------------------------------------------------
#--#-#---##--#-#---##--#-#---##--#-#---##--#-#---##--#-#---##--#-#---##--#-#---##--#-#---##--#-#---#
#-#-#---###-#-#---###-#-#---###-#-#---###-#-#---###-#-#---###-#-#---###-#-#---###-#-#---###-#-#---##
---#---#-----#---#-----#---#-----#---#-----#---#-----#---#-----#---#-----#---#-----#---#-----#---#--
--##--------##--------##--------##--------##--------##--------##--------##--------##--------##------
---#--#------#--#------#--#------#--#------#--#------#--#------#--#------#--#------#--#------#--#---
----#---------#---------#---------#---------#---------#---------#---------#---------#---------#-----
--##-#------##-#------##-#------##-#------##-#------##-#------##-#------##-#------##-#------##-#----
------#--#------#--#------#--#------#--#------#--#------#--#------#--#------#--#------#--#------#--#
#-#--##--##-#--##--##-#--##--##-#--##--##-#--##--##-#--##--##-#--##--##-#--##--##-#--##--##-#--##--#
----------------------------------------------------------------------------------------------------
#--#-#---##--#-#---##--#-#---##--#-#---##--#-#---##--#-#---##--#-#---##--#-#---##--#-#---##--#-#---#
#-#-#---###-#-#---###-#-#---###-#-#---###-#-#---###-#-#---###-#-#---###-#-#---###-#-#---###-#-#---##
---#---#-----#---#-----#---#-----#---#-----#---#-----#---#-----#---#-----#---#-----#---#-----#---#--
--##--------##--------##--------##--------##--------##--------##--------##--------##--------##------
---#--#------#--#------#--#------#--#------#--#------#--#------#--#------#--#------#--#------#--#---
----#---------#---------#---------#---------#---------#---------#---------#---------#---------#-----
--##-#------##-#------##-#------##-#------##-#------##-#------##-#------##-#------##-#------##-#----
------#--#------#--#------#--#------#--#------#--#------#--#------#--#------#--#------#--#------#--#
#-#--##--##-#--##--##-#--##--##-#--##--##-#--##--##-#--##--##-#--##--##-#--##--##-#--##--##-#--##--#
----------------------------------------------------------------------------------------------------
#--#-#---##--#-#---##--#-#---##--#-#---##--#-#---##--#-#---##--#-#---##--#-#---##--#-#---##--#-#---#
#-#-#---###-#-#---###-#-#---###-#-#---###-#-#---###-#-#---###-#-#---###-#-#---###-#-#---###-#-#---##
---#---#-----#---#-----#---#-----#---#-----#---#-----#---#-----#---#-----#---#-----#---#-----#---#--
--##--------##--------##--------##--------##--------##--------##--------##--------##--------##------
---#--#------#--#------#--#------#--#------#--#------#--#------#--#------#--#------#--#------#--#---
----#---------#---------#---------#---------#---------#---------#---------#---------#---------#----E
--##-#------##-#------##-#------##-#------##-#------##-#------##-#------##-#------##-#------##-#----
