##-#--##-###-#--##-###-#--##-###-#--##-###-#--##-###-#--##-###-#--##-###-#--##-###-#--##-###-#--##-#
-#-#-#-----#-#-#-----#-#-#-----#-#-#-----#-#-#-----#-#-#-----#-#-#-----#-#-#-----#-#-#-----#-#-#----
#------#--#------#--#------#--#------#--#------#--#------#--#------#--#------#--#------#--#------#--
---#---#-#---#---#-#---#---#-#---#---#-#---#---#-#---#---#-#---#---#-#---#---#-#---#---#-#---#---#-#
-------#---------#---------#---------#---------#---------#---------#---------#---------#---------#--
#----#-#--#----#-#--#----#-#--#----#-#--#----#-#--#----#-#--#----#-#--#----#-#--#----#-#--#----#-#--
-#--#------#--#------#--#------#--#------#--#------#--#------#--#------#--#------#--#------#--#-----
----------------------------------------------------------------------------------------------------
--#--#-#-#--#--#-#-#--#--#-#-#--#--#-#-#--#--#-#-#--#--#-#-#--#--#-#-#--#--#-#-#--#--#-#-#--#--#-#-#
--#---------#---------#---------#---------#---------#---------#---------#---------#---------#-------
##-#--##-###-#--##-###-#--##-###-#--##-###-#--##-###-#--##-###-#--##-###-#--##-###-#--##-###-#--##-#
-#-#-#-----#-#-#-----#-#-#-----#-#-#-----#-#-#-----#-#-#-----#-#-#-----#-#-#-----#-#-#-----#-#-#----
#------#--#------#--#------#--#------#--#------#--#-E----#--#------#--#------#--#------#--#------#--
---#---#-#---#---#-#---#---#-#---#---#-#---#---#-#---#---#-#---#---#-#---#---#-#---#---#-#---#---#-#
-------#---------#---------#---------#---------#---------#---------#---------#---------#---------#--
#----#-#--#----#-#--#----#-#--#----#-#--#----#-#--#----#-#--#----#-#--#----#-#--#----#-#--#----#-#--
-#--#------#--#------#--#------#--#------#--#------#--#------#--#------#--#------#--#------#--#-----
----------------------------------------------------------------------------------------------------
--#--#-#-#--#--#-#-#--#--#-#-#--#--#-#-#--#--#-#-#--#--#-#-#--#--#-#-#--#--#-#-#--#--#-#-#--#--#-#-#
--#---------#---------#---------#---------#---------#---------#---------#---------#---------#-------
##-#--##-###-#--##-###-#--##-###-#--##-###-#--##-###-#--##-###-#--##-###-#--##-###-#--##-###-#--##-#
-#-#-#-----#-#-#-----#-#-#-----#-#-#-----#-#-#-----#-#-#-----#-#-#-----#-#-#-----#-#-#-----#-#-#----
#------#--#------#--#------#--#------#--#------#--#------#--#------#--#------#--#------#--#------#--
---#---#-#---#---#-#---#---#-#---#---#-#---#---#-#---#---#-#---#---#-#---#---#-#---#---#-#---#---#-#
-------#---------#---------#---------#---------#---------#---------#---------#---------#---------#--
#----#-#--#----#-#--#----#-#--#----#-#--#----#-#--#----#-#--#----#-#--#----#-#--#----#-#--#----#-#--
-#--#------#--#------#--#------#--#------#--#------#--#------#--#------#--#------#--#------#--#-----
----------------------------------------------------------------------------------------------------
--#--#-#-#--#--#-#-#--#--#-#-#--#--#-#-#--#--#-#-#--#--#-#-#--#--#-#-#--#--#-#-#--#--#-#-#--#--#-#-#
--#---------#---------#---------#---------#---------#---------#---------#---------#---------#-------
##-#--##-###-#--##-###-#--##-###-#--##-###-#--##-###-#--##-###-#--##-###-#--##-###-#--##-###-#--##-#
-#-#-#-----#-#-#-----#-#-#-----#-#-#-----#-#-#-----#-#-#-----#-#-#-----#-#-#-----#-#-#-----#-#-#----
#------#--#------#--#------#--#------#--#------#--#------#--#------#--#------#--#------#--#------#--
---#---#-#---#---#-#---#---#-#---#---#-#---#---#-#---#---#-#---#---#-#---#---#-#---#---#-#---#---#-#
-------#---------#---------#---------#---------#---------#---------#---------#---------#---------#--
#----#-#--#----#-#--#----#-#--#----#-#--#----#-#--#----#-#--#----#-#--#----#-#--#----#-#--#----#-#--
-#--#------#--#------#--#------#--#------#--#------#--#------#--#------#--#------#--#------#--#-----
----------------------------------------------------------------------------------------------------
--#--#-#-#--#--#-#-#--#--#-#-#--#--#-#-#--#--#-#-#--#--#-#-#--#--#-#-#--#--#-#-#--#--#-#-#--#--#-#-#
--#---------#---------#---------#---------#---------#---------#---------#---------#---------#-------
##-#--##-###-#--##-###-#--##-###-#--##-###-#--##-###-#--##-###-#--##-###-#--##-###-#--##-###-#--##-#
-#-#-#-----#-#-#-----#-#-#-----#-#-#-----#-#-#-----#-#-#-----#-#-#-----#-#-#-----#-#-#-----#-#-#----
#------#--#------#--#------#--#------#--#------#--#------#--#------#--#------#--#------#--#------#--
---#---#-#---#---#-#---#---#-#---#---#-#---#---#-#---#---#-#---#---#-#---#---#-#---#---#-#---#---#-#
-------#---------#---------#---------#---------#---------#---------#---------#---------#---------#--
#----#-#--#----#-#--#----#-#--#----#-#--#----#-#--#----#-#--#----#-#--#----#-#--#----#-#--#----#-#--
-#--#------#--#------#--#------#--#------#--#------#--#------#--#------#--#------#--#------#--#-----
----------------------------------------------------------------------------------------------------
--#--#-#-#--#--#-#-#--#--#-#-#--#--#-#-#--#--#-#-#--#--#-#-#--#--#-#-#--#--#-#-#--#--#-#-#--#--#-#-#
--#---------#---------#---------#---------#---------#---------#---------#---------#---------#-------
##-#--##-###-#--##-###-#--##-###-#--##-###-#--##-###-#--##-###-#--##-###-#--##-###-#--##-###-#--##-#
-#-#-#-----#-#-#-----#-#-#-----#-#-#-----#-#-#-----#-#-#-----#-#-#-----#-#-#-----#-#-#-----#-#-#----
#------#--#------#--#------#--#------#--#------#--#------#--#------#--#------#--#------#--#------#--
---#---#-#---#---#-#---#---#-#---#---#-#---#---#-#---#---#-#---#---#-#---#---#-#---#---#-#---#---#-#
-------#---------#---------#---------#---------#---------#---------#---------#---------#---------#--
#----#-#--#----#-#--#----#-#--#----#-#--#----#-#--#----#-#--#----#-#--#----#-#--#----#-#--#----#-#--
-#--#------#--#------#--#------#--#------#--#------#--#------#--#------#--#------#--#------#--#-----
----------------------------------------------------------------------------------------------------
S-#--#-#-#--#--#-#-#--#--#-#-#--#--#-#-#--#--#-#-#--#--#-#-#--#--#-#-#--#--#-#-#--#--#-#-#--#--#-#-#
--#---------#---------#---------#---------#---------#---------#---------#---------#---------#-------
##-#--##-###-#--##-###-#--##-###-#--##-###-#--##-###-#--##-###-#--##-###-#--##-###-#--##-###-#--##-#
-#-#-#-----#-#-#-----#-#-#-----#-#-#-----#-#-#-----#-#-#-----#-#-#-----#-#-#-----#-#-#-----#-#-#----
#------#--#------#--#------#--#------#--#------#--#------#--#------#--#------#--#------#--#------#--
---#---#-#---#---#-#---#---#-#---#---#-#---#---#-#---#---#-#---#---#-#---#---#-#---#---#-#---#---#-#
-------#---------#---------#---------#---------#---------#---------#---------#---------#---------#--
#----#-#--#----#-#--#----#-#--#----#-#--#----#-#--#----#-#--#----#-#--#----#-#--#----#-#--#----#-#--
-#--#------#--#------#--#------#--#------#--#------#--#------#--#------#--#------#--#------#--#-----
----------------------------------------------------------------------------------------------------
--#--#-#-#--#--#-#-#--#--#-#-#--#--#-#-#--#--#-#-#--#--#-#-#--#--#-#-#--#--#-#-#--#--#-#-#--#--#-#-#
--#---------#---------#---------#---------#---------#---------#---------#---------#---------#-------
##-#--##-###-#--##-###-#--##-###-#--##-###-#--##-###-#--##-###-#--##-###-#--##-###-#--##-###-#--##-#
-#-#-#-----#-#-#-----#-#-#-----#-#-#-----#-#-#-----#-#-#-----#-#-#-----#-#-#-----#-#-#-----#-#-#----
#------#--#------#--#------#--#------#--#------#--#------#--#------#--#------#--#------#--#------#--
---#---#-#---#---#-#---#---#-#---#---#-#---#---#-#---#---#-#---#---#-#---#---#-#---#---#-#---#---#-#
-------#---------#---------#---------#---------#---------#---------#---------#---------#---------#--
#----#-#--#----#-#--#----#-#--#----#-#--#----#-#--#----#-#--#----#-#--#----#-#--#----#-#--#----#-#--
-#--#------#--#------#--#------#--#------#--#------#--#------#--#------#--#------#--#------#--#-----
----------------------------------------------------------------------------------------------------
--#--#-#-#--#--#-#-#--#--#-#-#--#--#-#-#--#--#-#-#--#--#-#-#--#--#-#-#--#--#-#-#--#--#-#-#--#--#-#-#
--#---------#---------#---------#---------#---------#---------#---------#---------#---------#-------
##-#--##-###-#--##-###-#--##-###-#--##-###-#--##-###-#--##-###-#--##-###-#--##-###-#--##-###-#--##-#
-#-#-#-----#-#-#-----#-#-#-----#-#-#-----#-#-#-----#-#-#-----#-#-#-----#-#-#-----#-#-#-----#-#-#----
#------#--#------#--#------#--#------#--#------#--#------#--#------#--#------#--#------#--#------#--
---#---#-#---#---#-#---#---#-#---#---#-#---#---#-#---#---#-#---#---#-#---#---#-#---#---#-#---#---#-#
-------#---------#---------#---------#---------#---------#---------#---------#---------#---------#--
#----#-#--#----#-#--#----#-#--#----#-#--#----#-#--#----#-#--#----#-#--#----#-#--#----#-#--#----#-#--
-#--#------#--#------#--#------#--#------#--#------#--#------#--#------#--#------#--#------#--#-----
----------------------------------------------------------------------------------------------------
--#--#-#-#--#--#-#-#--#--#-#-#--#--#-#-#--#--#-#-#--#--#-#-#--#--#-#-#--#--#-#-#--#--#-#-#--#--#-#-#
--#---------#---------#---------#---------#---------#---------#---------#---------#---------#-------
##-#--##-###-#--##-###-#--##-###-#--##-###-#--##-###-#--##-###-#--##-###-#--##-###-#--##-###-#--##-#
-#-#-#-----#-#-#-----#-#-#-----#-#-#-----#-#-#-----#-#-#-----#-#-#-----#-#-#-----#-#-#-----#-#-#----
#------#--#------#--#------#--#------#--#------#--#------#--#------#--#------#--#------#--#------#--
---#---#-#---#---#-#---#---#-#---#---#-#---#---#-#---#---#-#---#---#-#---#---#-#---#---#-#---#---#-#
-------#---------#---------#---------#---------#---------#---------#---------#---------#---------#--
#----#-#--#----#-#--#----#-#--#----#-#--#----#-#--#----#-#--#----#-#--#----#-#--#----#-#--#----#-#--
-#--#------#--#------#--#------#--#------#--#------#--#------#--#------#--#------#--#------#--#-----
----------------------------------------------------------------------------------------------------
--#--#-#-#--#--#-#-#--#--#-#-#--#--#-#-#--#--#-#-#--#--#-#-#--#--#-#-#--#--#-#-#--#--#-#-#--#--#-#-#
--#---------#---------#---------#---------#---------#---------#---------#---------#---------#-------
