#---#-----#--#-#----
----##--#--#---##---
##---#-#----#---#-#-
--#--#--#-------#--#
--#-#--#----#-------
-#-#--##-#-#----#--#
-------#--#------##-
#-#-#--#-#---#-#----
--##-##---#-##--#---
##-#--------#--#-#-#
-#------#--#-S---#-#
##--#--#---#-#----#-
--#--#--##-#--#--##-
---#-------#--#-----
-###--#--#------####
--#---##-#----#-----
#----#-------##-E#-#
---#-#------#-#-----
-#--#---##---##----#
#-----#---##------#-
