-----#--#-#----#---#
-#-------#----------
---##----------##---
-##-#--#----##--####
----#---###-#---#---
-#-----#--##--------
---#-------#----E#--
------#-----#---#--#
--#---##-##-#-----#-
-####--#-#---#---#--
--#-#----###-#---#-#
------#####---###-#-
#----##-##----#-#--#
#------###--#----###
#--#------------#---
#------##-##------#-
-####-#--------#--#-
##-#-#---#--#-#-#---
-#-----#------#-----
----#-#-#--#-#-S-##-
