--#--#---#---E------
--#--#-##---#-------
----------#----#--#-
--------#-#-####-#--
---#---#----#-----#-
------#---#---#--#--
#-#-#-##--S-###--#--
----------#-#---#--#
#-#--------##-------
-#-###--#-#----#-#--
---#------##-----#-#
--#-----#--#-##-----
----#--##------#----
-##---##-#----#--###
---#-#-#------##----
###--#--#-----------
---##-#--######---##
#--####-#####-##----
---##-#-#---#---#-#-
-#----##-----##----#
