------#----E-#-----#
--#------------#----
#-#----#-----------#
----#--##-#---S---#-
#--#--------#---#--#
-##-##---#---#--#--#
##--#-#-#-#--#-#--#-
--#-##--#-------#-##
#-##--#--#----#----#
-#------------#--#-#
##-#--###-----#-----
---#------------#-##
#-#-#---##-----#-###
#----#----#-----###-
-#------------#----#
#--#-#---##-#--#----
-#-----##--##-#-##--
###-#----#-###-#-##-
---------#------##--
-#---###--#-#-#---#-
