#-#-#-#----#--#-###-
##-##-----##-#--##-#
#-#-#-----#------##-
-###----------#-#-##
--#---##-#----------
---##------#--#----#
-----#---#-----#----
--##---#----#--#-###
------#-#---#--#----
---------------#---#
#-#-##--#-###--##---
-##--------------#--
#------#####-#------
--#----#-##----#--#-
-------#-------#----
-----#-#----##------
#-##-##---#-###----E
-####---###---S#-#--
-------#---#--------
#-##-#--#---#-#--###
