##-#-----##----###--
---#-#------#--#---#
----#----------#---#
-#-----#----#-##-#--
--#---#-#-----#-##--
-----------##---#--#
-#-#---##--#---S----
-#----#--#-#-##-#---
-#--#--###--#----#--
-#----#-#--##--##-#-
#---#------##-#-E---
---#--##-#--#--####-
#-------#-##-###---#
---#--#-#-##---#-#--
---------#---#---#-#
-#--#--------##----#
#-----##------###---
----------------##-#
-----#-##--#------##
--###----#-##---#--#
