-#-------#---#------
#-#------##---#--#-#
-#-----##--#--#-#---
---#-#--S---------#-
#-#---##---#--###---
----------#--#------
#---#---#---#-----#-
------#----#----#-#-
-------##-###---##--
##------#-#---#-E##-
----#-------#---##--
##--##--------#-##--
--#----##-##-----##-
##----#--#-##-#----#
##-------##-##--#-#-
#-#--#-----------#-#
---#-----#----#-#---
--###-##-#---#-#----
#-####-------#--#-##
----##----##--#-###-
