--#--#--#-###---#--#
##-#-#----#---###--#
----#---#----#------
#--####-#-----------
#----#---#-#----E--#
-#---#----#---#-----
-#---#----#-###--###
##-#-#-#---#-#--##--
-S-#--------------#-
-#----------##--#---
---------#-----#----
###---#--#-#---#--#-
#-------##-##--#----
-----#-#----##------
#---##----###--###--
--#-##-----##--#-###
------##--#----##-#-
--#-----#------#--#-
----#----------#####
#-#-#--#-#----#---#-
