##-#---#--##--##----
-##-#-#-#----##-----
---#---#--###-#--#--
#----#--#--##-#-#-#-
####--##--###--#-#-#
---#--#-------#-#---
------####--------##
-#--##-----#--#--#--
#-#--------#---#-#-#
-#--#----##-S--#----
--E-----------#--#--
-------#-##---------
------#-----#-#---#-
-#-#-#####--#-#-----
--##-----#-#--#--#--
----------#-#-##----
------##--#----#---#
----##-##---------##
#---#-#-#------#--#-
--##-#---#--#------#
