-#----##--#-----#--#
#--E---#--#----###-#
-----#--#----##-#S--
#-----#-##--#--#---#
#-#----#----###-----
#--#---#-#------#---
--##------##--#-#--#
----#-#-----#-##--#-
-#--#-----#--------#
---#-#-#-------#---#
--##------#--#----#-
-#--#-#--#-#---#----
--#-#----#-#--------
#####-----#--#---##-
--#-----#-----------
#---#--##---#---#-#-
#-#-----##---###-#--
-#--###------##---#-
--####----#---##--##
------###-#-------#-
