--#------####--#-#-#
#----##-----E---#---
-#----###----#----#-
--#-#--##----##--#-#
-#---#--#--#--------
-----#-##--------###
#--#---#-#-----##--#
--#-#-#----#--####--
###----#-#----#-----
#------#-#-#--------
#---#--#-------#-##-
-##--#------------##
---S--#-##--###-----
-#----#-----#-----#-
--#-##-##---------##
-##-----#-##-----#--
#--##-----#-----#--#
----#---##--#----#--
#-#--------#-###----
--#--#-#-#--#---##-#
