-#--------#-#--#-##-
#-##-##-#-#-#-##----
-#--#---#-----##--#-
-###--##--#-#-------
----#--##--##------#
-##-#-----#--###----
--#---#-----#--#---#
-------##E----#-----
-##----#----###--#--
--#-##-----#-#-#----
----#------##-#--#--
---#---#---------#--
#-##-#-#------#-#---
###---#-#---#-#-----
----####--#-------##
-###--###--##-------
---##-#--#----------
---#S-##------##---#
-----#---#----------
------##-#--#-#-##-#
