#-#-#-##------#--#-S
-------#----#####-#-
##--##--#--#-#-#----
-----------#-###-#--
------##------------
-#----#---#-#-------
-#--------##--#-##--
----#---#-#---------
--------#E---#----#-
-----###-----#--#---
#-----#--#-----#-###
-----#---#--#--##---
---#####--##-#-#-#--
#----#-###-##--###--
---##-#-----#-#-##--
---#-----####-#-#---
#----##-#--#--#---#-
--####---------###-#
----#----------#-###
--#--#-#---#--------
