##---#-#---#-#--##--
----###---#---#-----
##-------##-#----##-
-##----------#-#----
-##-#----#---#-#----
--#-----#----#-##---
--#S--###-----#-#---
#-#-#-------#-------
---#-##-#---#--##---
-#-#-----###--------
####---#-###----#--#
--#---#-#----#-##---
E##---#----#--------
----#---####----#---
-----#----#---#-#--#
------#-#-#---#--#--
#--#-#-----#-#-###--
--------#----##-----
---##-##--#---#-#--#
#--------#-###-#-##-
