---#--##----#-#--#--
--#-----#----##--###
-#-##--#--#-#------#
##--#--------#--##-#
----#-##--#----##---
-##-###---------#-##
---#-#-##-#---#-#---
--#------#-#--------
---#-#-#-##-#-#-#-#-
--#-------#--#-#----
#-------#--#-###--E-
-----###-##-------##
-#-----------#-#---#
#-#-#-#-----------#-
#-##-#---#---###----
#--#-------#----#---
------##-#----#-#-##
---#------S--#------
---#---###------##-#
--##----##-#-------#
