---#-------#-----#-#
---#--#--##-#--###-#
----#-#-#-###-----##
-#---#--#-#-#--#---#
-E-#----#---##--#---
---#----#-#-#-#-#-#-
----#--#--------#-#-
------------#-#-#-#-
----##---#-#-#---#-#
---###----------#---
------#--#--##------
#--#--#--#----#-----
----#-#-------###-##
##--##-#----#-----#-
---##-----#--###S--#
#--#------#---##-#--
#----#--------##--##
#----#-####---------
-#---#---#---####-#-
#-#----#---#------#-
