-#---#-##---#-#-#--#
--------------#-----
---#-##-#---#-#--#S#
-#-#-------##--#-##-
------#-#--------###
---#----#--##--#--#-
-###-##---#--E#----#
####--#--------#----
#--------#-#--#-----
#-----#-#-#-##------
#---#-----#---##-#-#
--#-#---------------
##-----#-----#-##-##
-------##------#----
##---#--#----##----#
------#--###-#------
####----##--#----#-#
-#---#-------------#
----#-#---##---##-##
---###-#-#------####
