#---#-#------------S
-#-----E#---###----#
-##-----#-##---#-#--
-#------#-----##---#
-##--#-----##--#-##-
---#-##-------###--#
#---#-#--#-#----##-#
------------##--#-#-
--#-----#-------#---
-#---####---##-##---
----#------#--##-#-#
-----#-#--#--##--#--
-#------##--#-#-#--#
-#-#------#-#-##----
--#-#-##-------#----
------##----###---#-
---##-----#-###-##--
###-#-------------#-
---#----#--#---##-#-
#----#-#-------#---#
