-----#---#E#-#-#---#
---#--#-----##------
-###-------#-#--#---
-###--------##---#-#
#---#----##---#-----
---#---#------#-##-#
#--------##-##-#---#
----#----###--#--##-
----#---------------
#-#-#---#-#--#-----#
---#------###--##-##
#-#--##-#--#----#-#-
------##-----#-#----
#-##---------#-#----
-##-#-#---#---#--#-#
#---#--#-----#---#--
##-#-----#-#-#----#-
--#-#--##-#-#-#-#---
##-#--------#-S#--#-
------##--#---#---#-
