-##-##--#---#--#--#-
--##-#----##-----#--
-#---#--#--##-#-----
#--#-#---#--##------
----##--#---#-----#-
-#-#-----##--#-----#
-##----##-###-------
#--##-----##---#-##-
--------------#---#-
-##---#---##--#---#-
##---#-#----------#-
#-##--##------#---#-
-----------#-##--#--
#-#--#--#----E---#--
-#-##-------#-###--#
#--##-##-#-#-#----#-
------------##--S#-#
#--#----#---#-#-#---
##-#-#----------#---
-#-#--#--#----#--#--
