#-#-#--##----##-#---
----##-#-----#------
---#---------#-#---#
-----#--#--------#--
-##---#--#-----#--#-
-------#---#-------#
-------##-----#-#-#-
-###--#-------#---#-
#---------#-#---#---
##-#----#-##-#-#-##-
-#---#--#---#-##----
#-#--#------##---##-
----##-----##-------
--#-#-----##-------#
-#----##-----###-#--
##-#--##-###-E-#----
#----------#-#---#--
--####-----#-#-#-##-
-#-##-##------#--S--
#--##--##-#--##-##--
