-#-#-###-##----##--#
#-#-#--#-------#-#--
-#--#----######-###-
#--#-----#----#-----
--##--------#--#---#
-#---#--#------#---#
--------------------
#--#--#---##-#------
---#--#--###-##---##
#--#-#-#----#---#--#
------#-#-#-----#---
#---E##--##-##------
----#--------#--#-#-
-#----#-----##------
#----#--#--#-##---#-
-----#----------#---
##--#-#-#S##--------
###--#--------#-###-
----#--#-----#---#-#
#-#---#---###-#-##--
