--#----##-----#--#-#
--###---#-#S##----#-
---#-#-E-----#-##---
-##------#--####-#--
----#--###--#-------
------#--#-----#--#-
-----##-#---------#-
----#----##----#####
---------#--#-#-#---
----#-#---##-#----#-
-#-------#----#--#--
---#----#----##-#-#-
-#--##--###-#---#--#
-#--#-------------#-
--#-------##---#--##
----####--#--###----
-#-#-#---#-##--#-#-#
------------####--##
#--#----#--------##-
#----##--#----#---#-
