-#----------##--#-##
---#----##--#----##-
---#--##-####----#--
--#--#----#####----#
--#----##----#----#-
----------#---------
---###--#----#--#---
------#--##-#----##-
##----#-S----####---
#-#-#---------#-#--#
-#---#-#####-#--#--#
#---#---#---#-------
---#----##------##-#
#------#--##-#-#-#--
-----#----#----#-###
------#-#--#------##
------##-------#--#-
###-#--#--##---##-##
-#-#-----------#--#-
---E---##------#---#
