--##-#####---#-#-#--
-#----#--#-#--#--##-
--#----##---#-##----
--------###---##--#-
#-##--###---#-##---#
#---------#---#-#--#
--------#-#-#---#-##
--E-----#-----#-----
##---#--------#-#-##
#-------#---#-------
--#---#-----#---####
-#--#--#--#-----#---
-----#-#---#-------#
-#-#-#--#######---##
-#--##S-#-------#---
-##---#---#----#----
---###--#---##--#---
-#-###-----#--------
----##--#-----------
-#----#---#-#-----#-
