#-#--#-----#------##
-###--#--##----#--##
#--#-#--#-#--#--#---
--------#---#-#--#--
--#-------#---#-#-#-
#----#------#--#--#-
-------#----#--###-#
#--##----#------#--#
--------##--#-#----#
-#---#--------###--#
---#-###---#-##--#--
--##-#-#------#-----
E--##--------#-----#
-------#-----#---#--
-#----#-##-----###-#
--##--###-#----#---#
--##--#-###-------S-
----#-#-#----#-#---#
#-----#-##-##-#---#-
--#--#-#-#---#------
