---#--#------#--#-##
--####-#---#------##
#--#---------#-#-#--
----#--#-#---------#
#----##--#-##--#--#-
---#-#-----#----#-##
-#-###-----------#--
#--------------#-#-#
#--##-#---#------#--
#---##--###---------
--##--##-#-------S-#
-----#----#-###-----
---------##-------#-
##-#--------##---##-
-#-##--#-#-##-----#-
-##-----#-#----##-#-
-####---------#---#-
-##--#---#-##-------
--#----#-#-##-###--#
#----#---E#-#----#--
