----#--------##--##-
---#---##---------#-
-##----#----##--#---
-------#----##----##
-#----#-------###-#-
#---------##--##---#
----#--#-###---##---
#-----#----#-----#--
#-----###----#------
---#--#--#---#----##
-#----#----#--#-----
--##---##--###-#--#-
----#-#---#----S-#--
---#---#---#-##-----
-#-#-####--#-#---#--
--#---##---##----##-
#-----##---#-#-#--E-
-#--#---------##--##
--#-#-#----##-#----#
-##--##--#----##--##
