------#---##----#--#
#---#----#-#-#--###-
----#---#---##-#----
#-------#-----#-----
----#-#-----------##
#--#----##-##-#-##--
#--##---####-----##-
-#--##-------##----#
#-----##----###---#-
#-#-##--#--###--#---
###---#-##--#--##-#-
--##---##--------#--
------#---#---##-#--
-------##----#--##--
-#------####--#####-
E-#----#------#-#---
#--------#----------
------#--###---#----
----##-##----#---#--
----S#---#------#---
