----##--#-##-#-###--
-#-----#--#-#-------
-#--#-#-------#--##-
#-----#------##---#-
#-#----##-#####---##
--####-----###-##--#
#------##-#-#---#---
--##-#-#-#-#------#-
-----#-#----#--###-#
#---#---###------#--
--------#--E#---##--
-#-#---#-------#---#
#-----#-------###---
-S----####-##--#-#-#
----#---#-----#----#
#-----#-#--#------#-
---#-##----------#--
#---#----------##-##
--------#---#----#--
-#---#-#-------#----
