?type=WithPattern;
?diagonal=IfAtMostOneObstacle;
-##--------##--------##--------##--------##--------##--------##--------##--------##--------##-------
-##--------##--------##--------##--------##--------##--------##--------##--------##--------##-------
#--#-#--###--#-#--###--#-#--###--#-#--###--#-#--###--#-#--###--#-#--###--#-#--###--#-#--###--#-#--##
#----#---##----#---##----#---##----#---##----#---##----#---##----#---##----#---##----#---##----#---#
--#-----#---#-----#---#-----#---#-----#---#-----#---#-----#---#-----#---#-----#---#-----#---#-----#-
------#---------#---------#---------#---------#---------#---------#---------#---------#---------#---
-#-----#---#-----#---#-----#---#-----#---#-----#---#-----#---#-----#---#-----#---#-----#---#-----#--
--##---#-#--##---#-#--##---#-#--##---#-#--##---#-#--##---#-#--##---#-#--##---#-#--##---#-#--##---#-#
------#---------#---------#---------#---------#---------#---------#---------#---------#---------#---
---##--------##--------##--------##--------##--------##--------##--------##--------##--------##-----
-##--------##--------##--------##--------##--------##--------##--------##--------##--------##-------
-##--------##--------##--------##--------##--------##--------##--------##--------##--------##-------
#--#-#--###--#-#--###--#-#--###--#-#--###--#-#--###--#-#--###--#-#--###--#-#--###--#-#--###--#-#--##
#----#---##----#---##----#---##----#---##----#---##----#---##----#---##----#---##----#---##----#---#
--#-----#---#-----#---#-----#---#-----#---#-----#---#-----#---#-----#---#-----#---#-----#---#-----#-
------#---------#---------#---------#---------#---------#---------#---------#---------#---------#---
-#-----#---#-----#---#-----#---#-----#---#-----#---#-----#---#-----#---#-----#---#-----#---#-----#--
--##---#-#--##---#-#--##---#-#--##---#-#--##---#-#--##---#-#--##---#-#--##---#-#--##---#-#--##---#-#
------#---------#---------#---------#---------#---------#---------#---------#---------#---------#---
---##--------##--------##--------##--------##--------##--------##--------##--------##--------##-----
-##--------##--------##--------##--------##--------##--------##--------##--------##--------##-------
-##--------##--------##--------##--------##--------##--------##--------##--------##--------##-------
#--#-#--###--#-#--###--#-#--###--#-#--###--#-#--###--#-#--###--#-#--###--#-#--###--#-#--###--#-#--##
#----#---##----#---##----#---##----#---##----#---##----#---##----#---##----#---##----#---##----#---#
--#-----#---#-----#---#-----#---#-----#---#-----#---#-----#---#-----#---#-----#---#-----#---#-----#-
------#---------#---------#---------#---------#---------#---------#---------#---------#---------#---
-#-----#---#-----#---#-----#---#-----#---#-----#---#-----#---#-----#---#-----#---#-----#---#-----#--
--##---#-#--##---#-#--##---#-#--##---#-#--##---#-#--##---#-#--##---#-#--##---#-#--##---#-#--##---#-#
------#---------#---------#---------#---------#---------#---------#---------#---------#---------#---
---##--------##--------##--------##--------##--------##--------##--------##--------##--------##-----
-##--------##--------##--------##--------##--------##--------##--------##--------##--------##-------
-##--------##--------##--------##--------##-E------##--------##--------##--------##--------##-------
#--#-#--###--#-#--###--#-#--###--#-#--###--#-#--###--#-#--###--#-#--###--#-#--###--#-#--###--#-#--##
#----#---##----#---##----#---##----#---##----#---##----#---##----#---##----#---##----#---##----#---#
--#-----#---#-----#---#-----#---#-----#---#-----#---#-----#---#-----#---#-----#---#-----#---#-----#-
------#---------#---------#---------#---------#---------#---------#---------#---------#---------#---
-#-----#---#-----#---#-----#---#-----#---#-----#---#-----#---#-----#---#-----#---#-----#---#-----#--
--##---#-#--##---#-#--##---#-#--##---#-#--##---#-#--##---#-#--##---#-#--##---#-#--##---#-#--##---#-#
------#---------#---------#---------#---------#---------#---------#---------#---------#---------#---
---##--------##--------##--------##--------##--------##--------##--------##--------##--------##-----
-##--------##--------##--------##--------##--------##--------##--------##--------##--------##-------
-##--------##--------##--------##--------##--------##--------##--------##--------##--------##-------
#--#-#--###--#-#--###--#-#--###--#-#--###--#-#--###--#-#--###--#-#--###--#-#--###--#-#--###--#-#--##
#----#---##----#---##----#---##----#---##----#---##----#---##----#---##----#---##----#---##----#---#
--#-----#---#-----#---#-----#---#-----#---#-----#---#-----#---#-----#---#-----#---#-----#---#-----#-
------#---------#---------#---------#---------#---------#---------#---------#---------#---------#---
-#-----#---#-----#---#-----#---#-----#---#-----#---#-----#---#-----#---#-----#---#-----#---#-----#--
--##---#-#--##---#-#--##---#-#--##---#-#--##---#-#--##---#-#--##---#-#--##---#-#--##---#-#--##---#-#
------#---------#---------#---------#---------#---------#---------#---------#---------#---------#---
---##--------##--------##--------##--------##--------##--------##--------##--------##--------##-----
-##--------##--------##--------##--------##--------##--------##--------##--------##--------##-------
-##--------##--------##--------##--------##--------##--------##--------##--------##--------##-------
#--#-#--###--#-#--###--#-#--###--#-#--###--#-#--###--#-#--###--#-#--###--#-#--###--#-#--###--#-#--##
#----#---##----#---##----#---##----#---##----#---##----#---##----#---##----#---##----#---##----#---#
--#-----#---#-----#---#-----#---#-----#---#-----#---#-----#---#-----#---#-----#---#-----#---#-----#-
------#---------#---------#---------#---------#---------#---------#---------#---------#---------#---
-#-----#---#-----#---#-----#---#-----#---#-----#---#-----#---#-----#---#-----#---#-----#---#-----#--
--##---#-#--##---#-#--##---#-#--##---#-#--##---#-#--##---#-#--##---#-#--##---#-#--##---#-#--##---#-#
------#---------#---------#---------#---------#---------#---------#---------#---------#---------#---
---##--------##--------##--------##--------##--------##--------##--------##--------##--------##-----
-##--------##--------##--------##--------##--------##--------##--------##--------##--------##-------
-##--------##--------##--------##--------##--------##--------##--------##--------##--------##-------
#--#-#--###--#-#--###--#-#--###--#-#--###--#-#--###--#-#--###--#-#--###--#-#--###--#-#--###--#-#--##
#----#---##----#---##----#---##----#---##----#---##----#---##----#---##----#---##----#---##----#---#
--#-----#---#-----#---#-----#---#-----#---#-----#---#-----#---#-----#---#-----#---#-----#---#-----#-
------#---------#---------#---------#---------#---------#---------#---------#---------#---------#---
-#-----#---#-----#---#-----#---#-----#---#-----#---#-----#---#-----#---#-----#---#-----#---#-----#--
--##---#-#--##---#-#--##---#-#--##---#-#--##---#-#--##---#-#--##---#-#--##---#-#--##---#-#--##---#-#
------#---------#---------#---------#---------#---------#---------#---------#---------#---------#---
---##--------##--------##--------##--------##--------##--------##--------##--------##--------##-----
-##--------##--------##--------##--------##--------##--------##--------##--------##--------##-------
-##--------##--------##--------##--------##--------##--------##--------##--------##--------##-------
#--#-#--###--#-#--###--#-#--###--#-#--###--#-#--###--#-#--###--#-#--###--#-#--###--#-#--###--#-#--##
#----#---##----#---##----#---##----#---##----#---##----#---##----#---##----#---##----#---##----#---#
--#-----#---#-----#---#-----#---#-----#---#-----#---#-----#---#-----#---#-----#---#-----#---#-----#-
------#---------#---------#---------#---------#---------#---------#---------#---------#---------#---
-#-----#---#-----#---#-----#---#-----#---#-----#---#-----#---#-----#---#-----#---#-----#---#-----#--
--##---#-#--##---#-#--##---#-#--##---#-#--##---#-#--##---#-#--##---#-#--##---#-#--##---#-#--##---#-#
------#---------#---------#---------#---------#---------#---------#---------#---------#---------#---
---##--------##--------##--------##--------##--------##--------##--------##--------##--------##-----
-##--------##--------##--------##--------##--------##--------##--------##--------##--------##-------
-##--------##--------##--------##--------##--------##--------##--------##--------##--------##-------
#--#-#--###--#-#--###--#-#--###--#-#--###--#-#--###--#-#--###--#-#--###--#-#--###--#-#--###--#-#--##
#----#---##----#---##----#---##----#---##----#---##----#---##----#---##----#---##----#---##----#---#
--#-----#---#-----#---#-----#---#-----#---#-----#---#-----#---#-----#---#-----#---#-----#---#-----#-
------#---------#---------#---------#---------#---------#---------#---------#---------#---------#---
-#-----#---#-----#---#-----#---#-----#---#-----#---#-----#---#-----#---#-----#---#-----#---#-----#--
--##---#-#--##---#-#--##---#-#--##---#-#--##---#-#--##---#-#--##---#-#--##---#-#--##---#-#--##---#-#
------#---------#---------#---------#---------#---------#---------#---------#---------#---------#---
---##--------##--------##--------##--------##--------##--------##--------##--------##--------##-----
-##--------##--------##--------##--------##--------##--------##--------##--------##--------##-------
-##--------##--------##--------##--------##--------##--------##--------##--------##--------##-------
#--#-#--###--#-#--###--#-#--###--#-#--###--#-#--###--#-#--###--#-#--###--#-#--###--#-#--###--#-#--##
#----#---##----#---##----#---##----#---##----#---##----#---##----#-S-##----#---##----#---##----#---#
--#-----#---#-----#---#-----#---#-----#---#-----#---#-----#---#-----#---#-----#---#-----#---#-----#-
------#---------#---------#---------#---------#---------#---------#---------#---------#---------#---
-#-----#---#-----#---#-----#---#-----#---#-----#---#-----#---#-----#---#-----#---#-----#---#-----#--
--##---#-#--##---#-#--##---#-#--##---#-#--##---#-#--##---#-#--##---#-#--##---#-#--##---#-#--##---#-#
------#---------#---------#---------#---------#---------#---------#---------#---------#---------#---
---##--------##--------##--------##--------##--------##--------##--------##--------##--------##-----