------------------------------------------------------S---------------------------------------------
-#-#-------#-#-------#-#-------#-#-------#-#-------#-#-------#-#-------#-#-------#-#-------#-#------
-###-------###-------###-------###-------###-------###-------###-------###-------###-------###------
-------##--------##--------##--------##--------##--------##--------##--------##--------##--------##-
#-------###-------###-------###-------###-------###-------###-------###-------###-------###-------##
-------#-#-------#-#-------#-#-------#-#-------#-#-------#-#-------#-#-------#-#-------#-#-------#-#
##-##-----##-##-----##-##-----##-##-----##-##-----##-##-----##-##-----##-##-----##-##-----##-##-----
#-----#-#-#-----#-#-#-----#-#-#-----#-#-#-----#-#-#-----#-#-#-----#-#-#-----#-#-#-----#-#-#-----#-#-
-----##--#-----##--#-----##--#-----##--#-----##--#-----##--#-----##--#-----##--#-----##--#-----##--#
--#--#------#--#------#--#------#--#------#--#------#--#------#--#------#--#------#--#------#--#----
----------------------------------------------------------------------------------------------------
-#-#-------#-#-------#-#-------#-#-------#-#-------#-#-------#-#-------#-#-------#-#-------#-#------
-###-------###-------###-------###-------###-------###-------###-------###-------###-------###------
-------##--------##--------##--------##--------##--------##--------##--------##--------##--------##-
#-------###-------###-------###-------###-------###-------###-------###-------###-------###-------##
-------#-#-------#-#-------#-#-------#-#-------#-#-------#-#-------#-#-------#-#-------#-#-------#-#
##-##-----##-##-----##-##-----##-##-----##-##-----##-##-----##-##-----##-##-----##-##-----##-##-----
#-----#-#-#-----#-#-#-----#-#-#-----#-#-#-----#-#-#-----#-#-#-----#-#-#-----#-#-#-----#-#-#-----#-#-
-----##--#-----##--#-----##--#-----##--#-----##--#-----##--#-----##--#-----##--#-----##--#-----##--#
--#--#------#--#------#--#------#--#------#--#------#--#------#--#------#--#------#--#------#--#----
----------------------------------------------------------------------------------------------------
-#-#-------#-#-------#-#-------#-#-------#-#-------#-#-------#-#-------#-#-------#-#-------#-#------
-###-------###-------###-------###-------###-------###-------###-------###-------###-------###------
-------##--------##--------##--------##--------##--------##--------##--------##--------##--------##-
#-------###-------###-------###-------###-------###-------###-------###-------###-------###-------##
-------#-#-------#-#-------#-#-------#-#-------#-#-------#-#-------#-#-------#-#-------#-#-------#-#
##-##-----##-##-----##-##-----##-##-----##-##-----##-##-----##-##-----##-##-----##-##-----##-##-----
#-----#-#-#-----#-#-#-----#-#-#-----#-#-#-----#-#-#-----#-#-#-----#-#-#-----#-#-#-----#-#-#-----#-#-
-----##--#-----##--#-----##--#-----##--#-----##--#-----##--#-----##--#-----##--#-----##--#-----##--#
--#--#------#--#------#--#------#--#------#--#------#--#------#--#------#--#------#--#------#--#----
----------------------------------------------------------------------------------------------------
-#-#-------#-#-------#-#-------#-#-------#-#-------#-#-------#-#-------#-#-------#-#-------#-#------
-###-------###-------###-------###-------###-------###-------###-------###-------###-------###------
-------##--------##--------##--------##--------##--------##--------##--------##--------##--------##-
#-------###-------###-------###-------###-------###-------###-------###-------###-------###-------##
-------#-#-------#-#-------#-#-------#-#-------#-#-------#-#-------#-#-------#-#-------#-#-------#-#
##-##-----##-##-----##-##-----##-##-----##-##-----##-##-----##-##-----##-##-----##-##-----##-##-----
#-----#-#-#-----#-#-#-----#-#-#-----#-#-#-----#-#-#-----#-#-#-----#-#-#-----#-#-#-----#-#-#-----#-#-
-----##--#-----##--#-----##--#-----##--#-----##--#-----##--#-----##--#-----##--#-----##--#-----##--#
--#--#------#--#------#--#------#--#------#--#------#--#------#--#------#--#------#--#------#--#----
----------------------------------------------------------------------------------------------------
-#-#-------#-#-------#-#-------#-#-------#-#-------#-#-------#-#-------#-#-------#-#-------#-#------
-###-------###-------###-------###-------###-------###-------###-------###-------###-------###------
-------##--------##--------##--------##--------##--------##--------##--------##--------##--------##-
#-------###-------###-------###-------###-------###-------###-------###-------###-------###-------##
-------#-#-------#-#-------#-#-------#-#-------#-#-------#-#-------#-#-------#-#-------#-#-------#-#
##-##-----##-##-----##-##-----##-##-----##-##-----##-##-----##-##-----##-##-----##-##-----##-##-----
#-----#-#-#-----#-#-#-----#-#-#-----#-#-#-----#-#-#-----#-#-#-----#-#-#-----#-#-#-----#-#-#-----#-#-
-----##--#-----##--#-----##--#-----##--#-----##--#-----##--#-----##--#-----##--#-----##--#-----##--#
--#--#------#--#------#--#------#--#------#--#------#--#------#--#------#--#------#--#------#--#----
----------------------------------------------------------------------------------------------------
-#-#-------#-#-------#-#-------#-#-------#-#-------#-#-------#-#-------#-#-------#-#-------#-#------
-###-------###-------###-------###-------###-------###-------###-------###-------###-------###------
-------##--------##--------##--------##--------##--------##--------##--------##--------##--------##-
#-------###-------###-------###-------###-------###-------###-------###-------###-------###-------##
-------#-#-------#-#-------#-#-------#-#-------#-#-------#-#-------#-#-------#-#-------#-#-------#-#
##-##-----##-##-----##-##-----##-##-----##-##-----##-##-----##-##-----##-##-----##-##-----##-##-----
#-----#-#-#-----#-#-#-----#-#-#-----#-#-#-----#-#-#-----#-#-#-----#-#-#-----#-#-#-----#-#-#-----#-#-
-----##--#-----##--#-----##--#-----##--#-----##--#-----##--#-----##--#-----##--#-----##--#-----##--#
--#--#------#--#------#--#------#--#------#--#------#--#------#--#------#--#------#--#------#--#----
----------------------------------------------------------------------------------------------------
-#-#-------#-#-------#-#-------#-#-------#-#-------#-#-------#-#-------#-#-------#-#-------#-#------
-###-------###-------###-------###-------###-------###-------###-------###-------###-------###------
-------##--------##--------##--------##--------##--------##--------##--------##--------##--------##-
#-------###-------###-------###-------###-------###-------###-------###-------###-------###-------##
-------#-#-------#-#-------#-#-------#-#-------#-#-------#-#-------#-#-------#-#-------#-#-------#-#
##-##-----##-##-----##-##-----##-##-----##-##-----##-##-----##-##-----##-##-----##-##-----##-##-----
#-----#-#-#-----#-#-#-----#-#-#-----#-#-#-----#-#-#-----#-#-#-----#-#-#-----#-#-#-----#-#-#-----#-#-
-----##--#-----##--#-----##--#-----##--#-----##--#-----##--#-----##--#-----##--#-----##--#-----##--#
--#--#------#--#------#--#------#--#------#--#------#--#------#--#------#--#------#--#------#--#----
----------------------------------------------------------------------------------------------------
-#-#-------#-#-------#-#-------#-#-------#-#-------#-#-------#-#-------#-#-------#-#-------#-#------
-###-------###-------###-------###-------###-------###-------###-------###-------###-------###------
-------##--------##--------##--------##--------##--------##--------##--------##--------##--------##-
#-------###-------###-------###-------###-------###-------###-------###-------###-------###-------##
-------#-#-------#-#-------#-#-------#-#-------#-#-------#-#-------#-#-------#-#-------#-#-------#-#
##-##-----##-##-----##-##-----##-##-----##-##-----##-##-----##-##-----##-##-----##-##-----##-##-----
#-----#-#-#-----#-#-#-----#-#-#-----#-#-#-----#-#-#-----#-#-#-----#-#-#-----#-#-#-----#-#-#-----#-#-
-----##--#-----##--#-----##--#-----##--#-----##--#-----##--#-----##--#-----##--#-----##--#-----##--#
--#--#------#--#------#--#------#--#------#--#------#--#------#--#------#--#------#--#------#--#----
----------------------------------------------------------------------------------------------------
-#-#-------#-#-------#-#-------#-#-------#-#-------#-#-------#-#-------#-#-------#-#-------#-#------
-###-------###-------###-------###-------###-------###-------###--E----###-------###-------###------
-------##--------##--------##--------##--------##--------##--------##--------##--------##--------##-
#-------###-------###-------###-------###-------###-------###-------###-------###-------###-------##
-------#-#-------#-#-------#-#-------#-#-------#-#-------#-#-------#-#-------#-#-------#-#-------#-#
##-##-----##-##-----##-##-----##-##-----##-##-----##-##-----##-##-----##-##-----##-##-----##-##-----
#-----#-#-#-----#-#-#-----#-#-#-----#-#-#-----#-#-#-----#-#-#-----#-#-#-----#-#-#-----#-#-#-----#-#-
-----##--#-----##--#-----##--#-----##--#-----##--#-----##--#-----##--#-----##--#-----##--#-----##--#
--#--#------#--#------#--#------#--#------#--#------#--#------#--#------#--#------#--#------#--#----
----------------------------------------------------------------------------------------------------
-#-#-------#-#-------#-#-------#-#-------#-#-------#-#-------#-#-------#-#-------#-#-------#-#------
-###-------###-------###-------###-------###-------###-------###-------###-------###-------###------
-------##--------##--------##--------##--------##--------##--------##--------##--------##--------##-
#-------###-------###-------###-------###-------###-------###-------###-------###-------###-------##
-------#-#-------#-#-------#-#-------#-#-------#-#-------#-#-------#-#-------#-#-------#-#-------#-#
##-##-----##-##-----##-##-----##-##-----##-##-----##-##-----##-##-----##-##-----##-##-----##-##-----
#-----#-#-#-----#-#-#-----#-#-#-----#-#-#-----#-#-#-----#-#-#-----#-#-#-----#-#-#-----#-#-#-----#-#-
-----##--#-----##--#-----##--#-----##--#-----##--#-----##--#-----##--#-----##--#-----##--#-----##--#
--#--#------#--#------#--#------#--#------#--#------#--#------#--#------#--#------#--#------#--#----
