-#-----#-#-#-----#-#-#-----#-#-#-----#-#-#-----#-#-#-----#-#-#-----#-#-#-----#-#-#-----#-#-#-----#-#
-###----##-###----##-###----##-###----##-###----##-###----##-###----##-###----##-###----##-###----##
--#---------#---------#---------#---------#---------#---------#---------#---------#---------#-------
#---------#---------#---------#---------#---------#---------#---------#---------#---------#---------
-----#---------#---------#---------#---------#---------#---------#---------#---------#---------#----
#--#-##---#--#-##---#--#-##---#--#-##---#--#-##---#--#-##---#--#-##---#--#-##---#--#-##---#--#-##---
-----#---------#---------#---------#---------#---------#---------#---------#---------#---------#----
----##--------##--------##--------##--------##--------##--------##--------##--------##--------##----
---------#---------#---------#---------#---------#---------#---------#---------#---------#---------#
-##-#-#-#--##-#-#-#--##-#-#-#--##-#-#-#--##-#-#-#--##-#-#-#--##-#-#-#--##-#-#-#--##-#-#-#--##-#-#-#-
-#-----#-#-#-----#-#-#-----#-#-#-----#-#-#-----#-#-#-----#-#-#-----#-#-#-----#-#-#-----#-#-#-----#-#
-###----##-###----##-###----##-###----##-###----##-###----##-###----##-###----##-###----##-###----##
--#---------#---------#---------#---------#---------#---------#---------#---------#---------#-------
#---------#---------#---------#---------#---------#---------#---------#---------#---------#---------
-----#---------#---------#---------#---------#---------#---------#---------#---------#---------#----
#--#-##---#--#-##---#--#-##---#--#-##---#--#-##---#--#-##---#--#-##---#--#-##---#--#-##---#--#-##---
-----#---------#---------#---------#---------#---------#---------#---------#---------#---------#----
----##--------##--------##--------##--------##--------##--------##--------##--------##--------##----
---------#---------#---------#---------#---------#---------#---------#---------#---------#---------#
-##-#-#-#--##-#-#-#--##-#-#-#--##-#-#-#--##-#-#-#--##-#-#-#--##-#-#-#--##-#-#-#--##-#-#-#--##-#-#-#-
-#-----#-#-#-----#-#-#-----#-#-#-----#-#-#-----#-#-#-----#-#-#-----#-#-#-----#-#-#-----#-#-#-----#-#
-###----##-###----##-###----##-###----##-###----##-###----##-###----##-###----##-###----##-###----##
--#---------#---------#---------#---------#---------#---------#---------#---------#---------#-------
#---------#---------#---------#---------#---------#---------#---------#---------#---------#---------
-----#---------#---------#---------#---------#---------#---------#---------#---------#---------#----
#--#-##---#--#-##---#--#-##---#--#-##---#--#-##---#--#-##---#--#-##---#--#-##---#--#-##---#--#-##---
-----#---------#---------#---------#---------#---------#---------#---------#---------#---------#----
----##--------##--------##--------##--------##--------##--------##--------##--------##--------##----
---------#---------#---------#---------#---------#---------#---------#---------#---------#---------#
-##-#-#-#--##-#-#-#--##-#-#-#--##-#-#-#--##-#-#-#--##-#-#-#--##-#-#-#--##-#-#-#--##-#-#-#--##-#-#-#-
-#-----#-#-#-----#-#-#-----#-#-#-----#-#-#-----#-#-#-----#-#-#-----#-#-#-----#-#-#-----#-#-#-----#-#
-###----##-###----##-###----##-###----##-###----##-###----##-###----##-###----##-###----##-###----##
--#---------#---------#---------#---------#---------#---------#---------#---------#---------#-------
#---------#---------#---------#---------#---------#---------#---------#---------#---------#---------
-----#---------#---------#---------#---------#---------#---------#---------#---------#---------#----
#--#-##---#--#-##---#--#-##---#--#-##---#--#-##---#--#-##---#--#-##---#--#-##---#--#-##---#--#-##---
-----#---------#---------#---------#---------#---------#---------#---------#---------#---------#----
----##--------##--------##--------##--------##--------##--------##--------##--------##--------##----
---------#---------#---------#---------#---------#---------#---------#---------#---------#---------#
-##-#-#-#--##-#-#-#--##-#-#-#--##-#-#-#--##-#-#-#--##-#-#-#--##-#-#-#--##-#-#-#--##-#-#-#--##-#-#-#-
-#-----#-#-#-----#-#-#-----#-#-#-----#-#-#-----#-#-#-----#-#-#-----#-#-#-----#-#-#-----#-#-#-----#-#
-###----##-###----##-###----##-###----##-###----##-###----##-###----##-###----##-###----##-###----##
--#---------#---------#---------#---------#---------#---------#---------#---------#---------#-------
#---------#---------#---------#---------#---------#---------#---------#---------#---------#---------
-----#---------#---------#---------#---------#---------#---------#---------#---------#---------#----
#--#-##---#--#-##---#--#-##---#--#-##---#--#-##---#--#-##---#--#-##---#--#-##---#--#-##---#--#-##---
-----#---------#---------#---------#---------#---------#---------#---------#---------#---------#----
----##--------##---E----##--------##--------##--------##--------##--------##--------##--------##----
---------#---------#---------#---------#---------#---------#---------#---------#---------#---------#
-##-#-#-#--##-#-#-#--##-#-#-#--##-#-#-#--##-#-#-#--##-#-#-#--##-#-#-#--##-#-#-#--##-#-#-#--##-#-#-#-
-#-----#-#-#-----#-#-#-----#-#-#-----#-#-#-----#-#-#-----#-#-#-----#-#-#-----#-#-#-----#-#-#-----#-#
-###----##-###----##-###----##-###----##-###----##-###----##-###----##-###----##-###----##-###----##
--#---------#---------#---------#---------#---------#---------#---------#---------#---------#-------
#---------#---------#-------S-#---------#---------#---------#---------#---------#---------#---------
-----#---------#---------#---------#---------#---------#---------#---------#---------#---------#----
#--#-##---#--#-##---#--#-##---#--#-##---#--#-##---#--#-##---#--#-##---#--#-##---#--#-##---#--#-##---
-----#---------#---------#---------#---------#---------#---------#---------#---------#---------#----
----##--------##--------##--------##--------##--------##--------##--------##--------##--------##----
---------#---------#---------#---------#---------#---------#---------#---------#---------#---------#
-##-#-#-#--##-#-#-#--##-#-#-#--##-#-#-#--##-#-#-#--##-#-#-#--##-#-#-#--##-#-#-#--##-#-#-#--##-#-#-#-
-#-----#-#-#-----#-#-#-----#-#-#-----#-#-#-----#-#-#-----#-#-#-----#-#-#-----#-#-#-----#-#-#-----#-#
-###----##-###----##-###----##-###----##-###----##-###----##-###----##-###----##-###----##-###----##
--#---------#---------#---------#---------#---------#---------#---------#---------#---------#-------
#---------#---------#---------#---------#---------#---------#---------#---------#---------#---------
-----#---------#---------#---------#---------#---------#---------#---------#---------#---------#----
#--#-##---#--#-##---#--#-##---#--#-##---#--#-##---#--#-##---#--#-##---#--#-##---#--#-##---#--#-##---
-----#---------#---------#---------#---------#---------#---------#---------#---------#---------#----
----##--------##--------##--------##--------##--------##--------##--------##--------##--------##----
---------#---------#---------#---------#---------#---------#---------#---------#---------#---------#
-##-#-#-#--##-#-#-#--##-#-#-#--##-#-#-#--##-#-#-#--##-#-#-#--##-#-#-#--##-#-#-#--##-#-#-#--##-#-#-#-
-#-----#-#-#-----#-#-#-----#-#-#-----#-#-#-----#-#-#-----#-#-#-----#-#-#-----#-#-#-----#-#-#-----#-#
-###----##-###----##-###----##-###----##-###----##-###----##-###----##-###----##-###----##-###----##
--#---------#---------#---------#---------#---------#---------#---------#---------#---------#-------
#---------#---------#---------#---------#---------#---------#---------#---------#---------#---------
-----#---------#---------#---------#---------#---------#---------#---------#---------#---------#----
#--#-##---#--#-##---#--#-##---#--#-##---#--#-##---#--#-##---#--#-##---#--#-##---#--#-##---#--#-##---
-----#---------#---------#---------#---------#---------#---------#---------#---------#---------#----
----##--------##--------##--------##--------##--------##--------##--------##--------##--------##----
---------#---------#---------#---------#---------#---------#---------#---------#---------#---------#
-##-#-#-#--##-#-#-#--##-#-#-#--##-#-#-#--##-#-#-#--##-#-#-#--##-#-#-#--##-#-#-#--##-#-#-#--##-#-#-#-
-#-----#-#-#-----#-#-#-----#-#-#-----#-#-#-----#-#-#-----#-#-#-----#-#-#-----#-#-#-----#-#-#-----#-#
-###----##-###----##-###----##-###----##-###----##-###----##-###----##-###----##-###----##-###----##
--#---------#---------#---------#---------#---------#---------#---------#---------#---------#-------
#---------#---------#---------#---------#---------#---------#---------#---------#---------#---------
-----#---------#---------#---------#---------#---------#---------#---------#---------#---------#----
#--#-##---#--#-##---#--#-##---#--#-##---#--#-##---#--#-##---#--#-##---#--#-##---#--#-##---#--#-##---
-----#---------#---------#---------#---------#---------#---------#---------#---------#---------#----
----##--------##--------##--------##--------##--------##--------##--------##--------##--------##----
---------#---------#---------#---------#---------#---------#---------#---------#---------#---------#
-##-#-#-#--##-#-#-#--##-#-#-#--##-#-#-#--##-#-#-#--##-#-#-#--##-#-#-#--##-#-#-#--##-#-#-#--##-#-#-#-
-#-----#-#-#-----#-#-#-----#-#-#-----#-#-#-----#-#-#-----#-#-#-----#-#-#-----#-#-#-----#-#-#-----#-#
-###----##-###----##-###----##-###----##-###----##-###----##-###----##-###----##-###----##-###----##
--#---------#---------#---------#---------#---------#---------#---------#---------#---------#-------
#---------#---------#---------#---------#---------#---------#---------#---------#---------#---------
-----#---------#---------#---------#---------#---------#---------#---------#---------#---------#----
#--#-##---#--#-##---#--#-##---#--#-##---#--#-##---#--#-##---#--#-##---#--#-##---#--#-##---#--#-##---
-----#---------#---------#---------#---------#---------#---------#---------#---------#---------#----
----##--------##--------##--------##--------##--------##--------##--------##--------##--------##----
---------#---------#---------#---------#---------#---------#---------#---------#---------#---------#
-##-#-#-#--##-#-#-#--##-#-#-#--##-#-#-#--##-#-#-#--##-#-#-#--##-#-#-#--##-#-#-#--##-#-#-#--##-#-#-#-
