-#------#--#------#--#------#--#------#--#------#--#------#--#------#--#------#--#------#--#------#-
------#--#------#--#------#--#------#--#------#--#------#--#------#--#------#--#------#--#------#--#
##-##-----##-##-----##-##-----##-##-----##-##-----##-##-----##-##-----##-##-----##-##-----##-##-----
##-###----##-###----##-###----##-###----##-###----##-###----##-###----##-###----##-###----##-###----
--#---------#---------#---------#---------#---------#---------#---------#---------#---------#-------
------##--------##--------##--------##--------##--------##--------##--------##--------##--------##--
#--#------#--#------#--#------#--#------#--#------#--#------#--#------#--#------#--#------#--#------
--#---------#---------#---------#---------#---------#---------#---------#---------#---------#-------
#---##--#-#---##--#-#---##--#-#---##--#-#---##--#-#---##--#-#---##--#-#---##--#-#---##--#-#---##--#-
-----#---#-----#---#-----#---#-----#---#-----#---#-----#---#-----#---#-----#---#-----#---#-----#---#
-#------#--#------#--#------#--#------#--#------#--#------#--#------#--#------#--#------#--#------#-
------#--#------#--#------#--#------#--#------#--#------#--#------#--#------#--#------#--#------#--#
##-##-----##-##-----##-##-----##-##-----##-##-----##-##-----##-##-----##-##-----##-##-----##-##-----
##-###----##-###----##-###----##-###----##-###----##-###----##-###----##-###----##-###----##-###----
--#---------#---------#---------#---------#---------#---------#---------#---------#---------#-------
------##--------##--------##--------##--------##--------##--------##--------##--------##--------##--
#--#------#--#------#--#------#--#------#--#------#--#------#--#------#--#------#--#------#--#------
--#---------#---------#---------#---------#---------#---------#---------#---------#---------#-------
#---##--#-#---##--#-#---##--#-#---##--#-#---##--#-#---##--#-#---##--#-#---##--#-#---##--#-#---##--#-
-----#---#-----#---#-----#---#-----#---#-----#---#-----#---#-----#---#-----#---#-----#---#-----#---#
-#------#--#------#--#------#--#------#--#------#--#------#--#------#--#------#--#------#--#------#-
------#--#------#--#------#--#------#--#------#--#------#--#------#--#------#--#------#--#------#--#
##-##-----##-##-----##-##-----##-##-----##-##-----##-##-----##-##-----##-##-----##-##-----##-##-----
##-###----##-###----##-###----##-###----##-###----##-###----##-###----##-###----##-###----##-###----
--#---------#---------#---------#---------#---------#---------#---------#---------#---------#-------
------##--------##--------##--------##--------##--------##--------##--------##--------##--------##--
#--#------#--#------#--#------#--#------#--#------#--#------#--#------#--#------#--#------#--#------
--#---------#---------#---------#---------#---------#---------#---------#---------#---------#-------
#---##--#-#---##--#-#---##--#-#---##--#-#---##--#-#---##--#-#---##--#-#---##--#-#---##--#-#---##--#-
-----#---#-----#---#-----#---#-----#---#-----#---#-----#---#-----#---#-----#---#-----#---#-----#---#
-#------#--#------#--#------#--#------#--#------#--#------#--#------#--#------#--#------#--#------#-
------#--#------#--#------#--#------#--#------#--#------#--#------#--#------#--#------#--#------#--#
##-##-----##-##-----##-##-----##-##-----##-##-----##-##-----##-##-S---##-##-----##-##-----##-##-----
##-###----##-###----##-###----##-###----##-###----##-###----##-###----##-###----##-###----##-###----
--#---------#---------#---------#---------#---------#---------#---------#---------#---------#-------
------##--------##--------##--------##--------##--------##--------##--------##--------##--------##--
#--#------#--#------#--#------#--#------#--#------#--#------#--#------#--#------#--#------#--#------
--#---------#---------#---------#---------#---------#---------#---------#---------#---------#-------
#---##--#-#---##--#-#---##--#-#---##--#-#---##--#-#---##--#-#---##--#-#---##--#-#---##--#-#---##--#-
-----#---#-----#---#-----#---#-----#---#-----#---#-----#---#-----#---#-----#---#-----#---#-----#---#
-#------#--#------#--#------#--#------#--#------#--#------#--#------#--#------#--#------#--#------#-
------#--#------#--#------#--#------#--#------#--#------#--#------#--#------#--#------#--#------#--#
##-##-----##-##-----##-##-----##-##-----##-##-----##-##-----##-##-----##-##-----##-##-----##-##-----
##-###----##-###----##-###----##-###----##-###----##-###----##-###----##-###----##-###----##-###----
--#---------#---------#---------#---------#---------#---------#---------#---------#---------#-------
------##--------##--------##--------##--------##--------##--------##--------##--------##--------##--
#--#------#--#------#--#------#--#------#--#------#--#------#--#------#--#------#--#------#--#------
--#---------#---------#---------#---------#---------#---------#---------#---------#---------#-------
#---##--#-#---##--#-#---##--#-#---##--#-#---##--#-#---##--#-#---##--#-#---##--#-#---##--#-#---##--#-
-----#---#-----#---#-----#---#-----#---#-----#---#-----#---#-----#---#-----#---#-----#---#-----#---#
-#------#--#------#--#------#--#------#--#------#--#------#--#------#--#------#--#------#--#------#-
------#--#------#--#------#--#------#--#------#--#------#--#------#--#------#--#------#--#------#--#
##-##-----##-##-----##-##-----##-##-----##-##-----##-##-----##-##-----##-##-----##-##-----##-##-----
##-###----##-###----##-###----##-###----##-###----##-###----##-###----##-###----##-###----##-###----
--#---------#---------#---------#---------#---------#---------#---------#---------#---------#-------
------##--------##--------##--------##--------##--------##--------##--------##--------##--------##--
#--#------#--#------#--#------#--#------#--#------#--#------#--#------#--#------#--#------#--#------
--#---------#---------#---------#---------#---------#---------#---------#---------#---------#-------
#---##--#-#---##--#-#---##--#-#---##--#-#---##--#-#---##--#-#---##--#-#---##--#-#---##--#-#---##--#-
-----#---#-----#---#-----#---#-----#---#-----#---#-----#---#-----#---#-----#---#-----#---#-----#---#
-#------#--#------#--#------#--#------#--#------#--#------#--#------#--#------#--#------#--#------#-
------#--#------#--#------#--#------#--#------#--#------#--#------#--#------#--#------#--#------#--#
##-##-----##-##-----##-##-----##-##-----##-##-----##-##-----##-##-----##-##-----##-##-----##-##-----
##-###----##-###----##-###----##-###----##-###----##-###----##-###----##-###----##-###----##-###----
--#---------#---------#---------#---------#---------#---------#---------#---------#---------#-------
------##--------##--------##--------##--------##--------##--------##--------##--------##--------##--
#--#------#--#------#--#------#--#------#--#------#--#------#--#------#--#------#--#------#--#------
--#---------#---------#---------#---------#---------#---------#---------#---------#---------#-------
#---##--#-#---##--#-#---##--#-#---##--#-#---##--#-#---##--#-#---##--#-#---##--#-#---##--#-#---##--#-
-----#---#-----#---#-----#---#-----#---#-----#---#-----#---#-----#---#-----#---#-----#---#-----#---#
-#------#--#------#--#------#--#------#--#------#--#------#--#------#--#------#--#------#--#------#-
------#--#------#--#------#--#------#--#------#--#------#--#------#--#------#--#------#--#------#--#
##-##-----##-##-----##-##-----##-##-----##-##-----##-##-----##-##-----##-##-----##-##-----##-##-----
##-###----##-###----##-###----##-###----##-###----##-###----##-###----##-###----##-###----##-###----
--#---------#---------#---------#---------#---------#---------#---------#---------#---------#-------
------##--------##--------##--------##--------##--------##--------##--------##--------##--------##-E
#--#------#--#------#--#------#--#------#--#------#--#------#--#------#--#------#--#------#--#------
--#---------#---------#---------#---------#---------#---------#---------#---------#---------#-------
#---##--#-#---##--#-#---##--#-#---##--#-#---##--#-#---##--#-#---##--#-#---##--#-#---##--#-#---##--#-
-----#---#-----#---#-----#---#-----#---#-----#---#-----#---#-----#---#-----#---#-----#---#-----#---#
-#------#--#------#--#------#--#------#--#------#--#------#--#------#--#------#--#------#--#------#-
------#--#------#--#------#--#------#--#------#--#------#--#------#--#------#--#------#--#------#--#
##-##-----##-##-----##-##-----##-##-----##-##-----##-##-----##-##-----##-##-----##-##-----##-##-----
##-###----##-###----##-###----##-###----##-###----##-###----##-###----##-###----##-###----##-###----
--#---------#---------#---------#---------#---------#---------#---------#---------#---------#-------
------##--------##--------##--------##--------##--------##--------##--------##--------##--------##--
#--#------#--#------#--#------#--#------#--#------#--#------#--#------#--#------#--#------#--#------
--#---------#---------#---------#---------#---------#---------#---------#---------#---------#-------
#---##--#-#---##--#-#---##--#-#---##--#-#---##--#-#---##--#-#---##--#-#---##--#-#---##--#-#---##--#-
-----#---#-----#---#-----#---#-----#---#-----#---#-----#---#-----#---#-----#---#-----#---#-----#---#
-#------#--#------#--#------#--#------#--#------#--#------#--#------#--#------#--#------#--#------#-
------#--#------#--#------#--#------#--#------#--#------#--#------#--#------#--#------#--#------#--#
##-##-----##-##-----##-##-----##-##-----##-##-----##-##-----##-##-----##-##-----##-##-----##-##-----
##-###----##-###----##-###----##-###----##-###----##-###----##-###----##-###----##-###----##-###----
--#---------#---------#---------#---------#---------#---------#---------#---------#---------#-------
------##--------##--------##--------##--------##--------##--------##--------##--------##--------##--
#--#------#--#------#--#------#--#------#--#------#--#------#--#------#--#------#--#------#--#------
--#---------#---------#---------#---------#---------#---------#---------#---------#---------#-------
#---##--#-#---##--#-#---##--#-#---##--#-#---##--#-#---##--#-#---##--#-#---##--#-#---##--#-#---##--#-
-----#---#-----#---#-----#---#-----#---#-----#---#-----#---#-----#---#-----#---#-----#---#-----#---#
