#---------#---------#---------#---------#---------#---------#---------#---------#---------#---------
----##--#-----##--#-----##--#-----##--#-----##--#-----##--#-----##--#-----##--#-----##--#-----##--#-
##-----#--##-----#--##-----#--##-----#--##-----#--##-----#--##-----#--##-----#--##-----#--##-----#--
---#---------#---------#---------#---------#---------#---------#---------#---------#---------#------
#----##---#----##---#----##---#----##---#----##---#----##---#----##---#----##---#----##---#----##---
--#--#--#---#--#--#---#--#--#---#--#--#---#--#--#---#--#--#---#--#--#---#--#--#---#--#--#---#--#--#-
--#----##---#----##---#----##---#----##---#----##---#----##---#----##---#----##---#----##---#----##-
--#--#------#--#------#--#------#--#------#--#------#S-#------#--#------#--#------#--#------#--#----
#-#---#-#-#-#---#-#-#-#---#-#-#-#---#-#-#-#---#-#-#-#---#-#-#-#---#-#-#-#---#-#-#-#---#-#-#-#---#-#-
--#--#---#--#--#---#--#--#---#--#--#---#--#--#---#--#--#---#--#--#---#--#--#---#--#--#---#--#--#---#
#---------#---------#---------#---------#---------#---------#---------#---------#---------#---------
----##--#-----##--#-----##--#-----##--#-----##--#-----##--#-----##--#-----##--#-----##--#-----##--#-
##-----#--##-----#--##-----#--##-----#--##-----#--##-----#--##-----#--##-----#--##-----#--##-----#--
---#---------#---------#---------#---------#---------#---------#---------#---------#---------#------
#----##---#----##---#----##---#----##---#----##---#----##---#----##---#----##---#----##---#----##---
--#--#--#---#--#--#---#--#--#---#--#--#---#--#--#---#--#--#---#--#--#---#--#--#---#--#--#---#--#--#-
--#----##---#----##---#----##---#----##---#----##---#----##---#----##---#----##---#----##---#----##-
--#--#------#--#------#--#------#--#------#--#------#--#------#--#------#--#------#--#------#--#----
#-#---#-#-#-#---#-#-#-#---#-#-#-#---#-#-#-#---#-#-#-#---#-#-#-#---#-#-#-#---#-#-#-#---#-#-#-#---#-#-
--#--#---#--#--#---#--#--#---#--#--#---#--#--#---#--#--#---#--#--#---#--#--#---#--#--#---#--#--#---#
#---------#---------#---------#---------#---------#---------#---------#---------#---------#---------
----##--#-----##--#-----##--#-----##--#-----##--#-----##--#-----##--#-----##--#-----##--#-----##--#-
##-----#--##-----#--##-----#--##-----#--##-----#--##-----#--##-----#--##-----#--##-----#--##-----#--
---#---------#---------#---------#---------#---------#---------#---------#---------#---------#------
#----##---#----##---#----##---#----##---#----##---#----##---#----##---#----##---#----##---#----##---
--#--#--#---#--#--#---#--#--#---#--#--#---#--#--#---#--#--#---#--#--#---#--#--#---#--#--#---#--#--#-
--#----##---#----##---#----##---#----##---#----##---#----##---#----##---#----##---#----##---#----##-
--#--#------#--#------#--#------#--#------#--#------#--#------#--#------#--#------#--#------#--#----
#-#---#-#-#-#---#-#-#-#---#-#-#-#---#-#-#-#---#-#-#-#---#-#-#-#---#-#-#-#---#-#-#-#---#-#-#-#---#-#-
--#--#---#--#--#---#--#--#---#--#--#---#--#--#---#--#--#---#--#--#---#--#--#---#--#--#---#--#--#---#
#---------#---------#---------#---------#---------#---------#---------#---------#---------#---------
----##--#-----##--#-----##--#-----##--#-----##--#-----##--#-----##--#-----##--#-----##--#-----##--#-
##-----#--##-----#--##-----#--##-----#--##-----#--##-----#--##-----#--##-----#--##-----#--##-----#--
---#---------#---------#---------#---------#---------#---------#---------#---------#---------#------
#----##---#----##---#----##---#----##---#----##---#----##---#----##---#----##---#----##---#----##---
--#--#--#---#--#--#---#--#--#---#--#--#---#--#--#---#--#--#---#--#--#---#--#--#---#--#--#---#--#--#-
--#----##---#----##---#----##---#----##---#----##---#----##---#----##---#----##---#----##---#----##-
--#--#------#--#------#--#------#--#------#--#------#--#------#--#------#--#------#--#------#--#----
#-#---#-#-#-#---#-#-#-#---#-#-#-#---#-#-#-#---#-#-#-#---#-#-#-#---#-#-#-#---#-#-#-#---#-#-#-#---#-#-
--#--#---#--#--#---#--#--#---#--#--#---#--#--#---#--#--#---#--#--#---#--#--#---#--#--#---#--#--#---#
#---------#---------#---------#---------#---------#---------#---------#---------#---------#---------
----##--#-----##--#-----##--#-----##--#-----##--#-----##--#-----##--#-----##--#-----##--#-----##--#-
##-----#--##-----#--##-----#--##-----#--##-----#--##-----#--##-----#--##-----#--##-----#--##-----#--
---#---------#---------#---------#---------#---------#---------#---------#---------#---------#------
#----##---#----##---#----##---#----##---#----##---#----##---#----##---#----##---#----##---#----##---
--#--#--#---#--#--#---#--#--#---#--#--#---#--#--#---#--#--#---#--#--#---#--#--#---#--#--#---#--#--#-
--#----##---#----##---#----##---#----##---#----##---#----##---#----##---#----##---#----##---#----##-
--#--#------#--#------#--#------#--#------#--#------#--#------#--#------#--#------#--#------#--#----
#-#---#-#-#-#---#-#-#-#---#-#-#-#---#-#-#-#---#-#-#-#---#-#-#-#---#-#-#-#---#-#-#-#---#-#-#-#---#-#-
--#--#---#--#--#---#--#--#---#--#--#---#--#--#---#--#--#---#--#--#---#--#--#---#--#--#---#--#--#---#
#---------#---------#---------#---------#---------#---------#---------#---------#---------#---------
----##--#-----##--#-----##--#-----##--#-----##--#-----##--#-----##--#-----##--#-----##--#-----##--#-
##-----#--##-----#--##-----#--##-----#--##-----#--##-----#--##-----#--##-----#--##-----#--##-----#--
---#---------#---------#---------#---------#---------#---------#---------#---------#---------#------
#----##---#----##---#----##---#----##---#----##---#----##---#----##---#----##---#----##---#----##---
--#--#--#---#--#--#---#--#--#---#--#--#---#--#--#---#--#--#---#--#--#---#--#--#---#--#--#---#--#--#-
--#----##---#----##---#----##---#----##---#----##---#----##---#----##---#----##---#----##---#----##-
--#--#------#--#------#--#------#--#------#--#------#--#------#--#------#--#------#--#------#--#----
#-#---#-#-#-#---#-#-#-#---#-#-#-#---#-#-#-#---#-#-#-#---#-#-#-#---#-#-#-#---#-#-#-#---#-#-#-#---#-#-
--#--#---#--#--#---#--#--#---#--#--#---#--#--#---#--#--#---#--#--#---#--#--#---#--#--#---#--#--#---#
#---------#---------#---------#---------#---------#---------#---------#---------#---------#---------
----##--#-----##--#-----##--#-----##--#-----##--#-----##--#-----##--#-----##--#-----##--#-----##--#-
##-----#--##-----#--##-----#--##-----#--##-----#--##-----#--##-----#--##-----#--##-----#--##-----#--
---#---------#---------#---------#---------#---------#---------#---------#---------#---------#------
#----##---#----##---#----##---#----##---#----##---#----##---#----##---#----##---#----##---#----##---
--#--#--#---#--#--#---#--#--#---#--#--#---#--#--#---#--#--#---#--#--#---#--#--#---#--#--#---#--#--#-
--#----##---#----##---#----##---#----##---#----##---#----##---#----##---#----##---#----##---#----##-
--#--#------#--#------#--#------#--#------#--#------#--#------#--#------#--#------#--#------#--#----
#-#---#-#-#-#---#-#-#-#---#-#-#-#---#-#-#-#---#-#-#-#---#-#-#-#---#-#-#-#---#-#-#-#---#-#-#-#---#-#-
--#--#---#--#--#---#--#--#---#--#--#---#--#--#---#--#--#---#--#--#---#--#--#---#--#--#---#--#--#---#
#----E----#---------#---------#---------#---------#---------#---------#---------#---------#---------
----##--#-----##--#-----##--#-----##--#-----##--#-----##--#-----##--#-----##--#-----##--#-----##--#-
##-----#--##-----#--##-----#--##-----#--##-----#--##-----#--##-----#--##-----#--##-----#--##-----#--
---#---------#---------#---------#---------#---------#---------#---------#---------#---------#------
#----##---#----##---#----##---#----##---#----##---#----##---#----##---#----##---#----##---#----##---
--#--#--#---#--#--#---#--#--#---#--#--#---#--#--#---#--#--#---#--#--#---#--#--#---#--#--#---#--#--#-
--#----##---#----##---#----##---#----##---#----##---#----##---#----##---#----##---#----##---#----##-
--#--#------#--#------#--#------#--#------#--#------#--#------#--#------#--#------#--#------#--#----
#-#---#-#-#-#---#-#-#-#---#-#-#-#---#-#-#-#---#-#-#-#---#-#-#-#---#-#-#-#---#-#-#-#---#-#-#-#---#-#-
--#--#---#--#--#---#--#--#---#--#--#---#--#--#---#--#--#---#--#--#---#--#--#---#--#--#---#--#--#---#
#---------#---------#---------#---------#---------#---------#---------#---------#---------#---------
----##--#-----##--#-----##--#-----##--#-----##--#-----##--#-----##--#-----##--#-----##--#-----##--#-
##-----#--##-----#--##-----#--##-----#--##-----#--##-----#--##-----#--##-----#--##-----#--##-----#--
---#---------#---------#---------#---------#---------#---------#---------#---------#---------#------
#----##---#----##---#----##---#----##---#----##---#----##---#----##---#----##---#----##---#----##---
--#--#--#---#--#--#---#--#--#---#--#--#---#--#--#---#--#--#---#--#--#---#--#--#---#--#--#---#--#--#-
--#----##---#----##---#----##---#----##---#----##---#----##---#----##---#----##---#----##---#----##-
--#--#------#--#------#--#------#--#------#--#------#--#------#--#------#--#------#--#------#--#----
#-#---#-#-#-#---#-#-#-#---#-#-#-#---#-#-#-#---#-#-#-#---#-#-#-#---#-#-#-#---#-#-#-#---#-#-#-#---#-#-
--#--#---#--#--#---#--#--#---#--#--#---#--#--#---#--#--#---#--#--#---#--#--#---#--#--#---#--#--#---#
#---------#---------#---------#---------#---------#---------#---------#---------#---------#---------
----##--#-----##--#-----##--#-----##--#-----##--#-----##--#-----##--#-----##--#-----##--#-----##--#-
##-----#--##-----#--##-----#--##-----#--##-----#--##-----#--##-----#--##-----#--##-----#--##-----#--
---#---------#---------#---------#---------#---------#---------#---------#---------#---------#------
#----##---#----##---#----##---#----##---#----##---#----##---#----##---#----##---#----##---#----##---
--#--#--#---#--#--#---#--#--#---#--#--#---#--#--#---#--#--#---#--#--#---#--#--#---#--#--#---#--#--#-
--#----##---#----##---#----##---#----##---#----##---#----##---#----##---#----##---#----##---#----##-
--#--#------#--#------#--#------#--#------#--#------#--#------#--#------#--#------#--#------#--#----
#-#---#-#-#-#---#-#-#-#---#-#-#-#---#-#-#-#---#-#-#-#---#-#-#-#---#-#-#-#---#-#-#-#---#-#-#-#---#-#-
--#--#---#--#--#---#--#--#---#--#--#---#--#--#---#--#--#---#--#--#---#--#--#---#--#--#---#--#--#---#
