----#---------#---------#---------#---------#---------#---------#---------#---------#---------#-----
-#--##-##--#--##-##--#--##-##--#--##-##--#--##-##--#--##-##--#--##-##--#--##-##--#--##-##--#--##-##-
----------------------------------------------------------------------------------------------------
----#----#----#----#----#----#----#----#----#----#----#----#----#----#----#----#----#----#----#----#
--##-#-#----##-#-#----##-#-#----##-#-#----##-#-#----##-#-#----##-#-#----##-#-#----##-#-#----##-#-#--
##--#-##--##--#-##--##--#-##--##--#-##--##--#-##--##--#-##--##--#-##--##--#-##--##--#-##--##--#-##--
--#---------#---------#---------#---------#---------#---------#---------#---------#---------#-------
#----#----#----#----#----#----#----#----#----#----#----#----#----#----#----#----#----#----#----#----
#---#-----#---#-----#---#-----#---#-----#---#-----#---#-----#---#-----#---#-----#---#-----#---#-----
#--------##--------##--------##--------##--------##--------##--------##--------##--------##--------#
----#---------#---------#---------#---------#---------#---------#---------#---------#---------#-----
-#--##-##--#--##-##--#--##-##--#--##-##--#--##-##--#--##-##--#--##-##--#--##-##--#--##-##--#--##-##-
----------------------------------------------------------------------------------------------------
----#----#----#----#----#----#----#----#----#----#----#----#----#----#----#----#----#----#----#----#
--##-#-#----##-#-#----##-#-#----##-#-#----##-#-#----##-#-#----##-#-#----##-#-#----##-#-#----##-#-#--
##--#-##--##--#-##--##--#-##--##--#-##--##--#-##--##--#-##--##--#-##--##--#-##--##--#-##--##--#-##--
--#---------#---------#---------#---------#---------#---------#---------#---------#---------#-------
#----#----#----#----#----#----#----#----#----#----#----#----#----#----#----#----#----#----#----#----
#---#-----#---#-----#---#-----#---#-----#---#-----#---#-----#---#-----#---#-----#---#-----#---#-----
#--------##--------##--------##--------##--------##--------##--------##--------##--------##--------#
----#---------#---------#---------#---------#---------#---------#---------#---------#---------#-----
-#--##-##--#--##-##--#--##-##--#--##-##--#--##-##--#--##-##--#--##-##--#--##-##--#--##-##--#--##-##-
----------------------------------------------------------------------------------------------------
----#----#----#----#----#----#----#----#----#----#----#----#----#----#----#----#----#----#----#----#
--##-#-#----##-#-#----##-#-#----##-#-#----##-#-#----##-#-#----##-#-#----##-#-#----##-#-#----##-#-#--
##--#-##--##--#-##--##--#-##--##--#-##--##--#-##--##--#-##--##--#-##--##--#-##--##--#-##--##--#-##--
--#---------#---------#---------#---------#---------#---------#---------#---------#---------#-------
#----#----#----#----#----#----#----#----#----#----#----#----#----#----#----#----#----#----#----#----
#---#-----#---#-----#---#-----#---#-----#---#-----#---#-----#---#-----#---#-----#---#-----#---#-----
#--------##--------##--------##--------##--------##-------E##--------##--------##--------##--------#
----#---------#---------#---------#---------#---------#---------#---------#---------#---------#-----
-#--##-##--#--##-##--#--##-##--#--##-##--#--##-##--#--##-##--#--##-##--#--##-##--#--##-##--#--##-##-
----------------------------------------------------------------------------------------------------
----#----#----#----#----#----#----#----#----#----#----#----#----#----#----#----#----#----#----#----#
--##-#-#----##-#-#----##-#-#----##-#-#----##-#-#----##-#-#----##-#-#----##-#-#----##-#-#----##-#-#--
##--#-##--##--#-##--##--#-##--##--#-##--##--#-##--##--#-##--##--#-##--##--#-##--##--#-##--##--#-##--
--#---------#---------#---------#---------#---------#---------#---------#---------#---------#-------
#----#----#----#----#----#----#----#----#----#----#----#----#----#----#----#----#----#----#----#----
#---#-----#---#-----#---#-----#---#-----#---#-----#---#-----#---#-----#---#-----#---#-----#---#-----
#--------##--------##--------##--------##--------##--------##--------##--------##--------##--------#
----#---------#---------#---------#---------#---------#---------#---------#---------#---------#-----
-#--##-##--#--##-##--#--##-##--#--##-##--#--##-##--#--##-##--#--##-##--#--##-##--#--##-##--#--##-##-
----------------------------------------------------------------------------------------------------
----#----#----#----#----#----#----#----#----#----#----#----#----#----#----#----#----#----#----#----#
--##-#-#----##-#-#----##-#-#----##-#-#----##-#-#----##-#-#----##-#-#----##-#-#----##-#-#----##-#-#--
##--#-##--##--#-##--##--#-##--##--#-##--##--#-##--##--#-##--##--#-##--##--#-##--##--#-##--##--#-##--
--#---------#---------#---------#---------#---------#---------#---------#---------#---------#-------
#----#----#----#----#----#----#----#----#----#----#----#----#----#----#----#----#----#----#----#----
#---#-----#---#-----#---#-----#---#-----#---#-----#---#-----#---#-----#---#-----#---#-----#---#-----
#--------##--------##--------##--------##--------##--------##--------##--------##--------##--------#
----#---------#---------#---------#---------#---------#---------#---------#---------#---------#-----
-#--##-##--#--##-##--#--##-##--#--##-##--#--##-##--#--##-##--#--##-##--#--##-##--#--##-##--#--##-##-
----------------------------------------------------------------------------------------------------
----#----#----#----#----#----#----#----#----#----#----#----#----#----#----#----#----#----#----#----#
--##-#-#----##-#-#----##-#-#----##-#-#----##-#-#----##-#-#----##-#-#----##-#-#----##-#-#----##-#-#--
##--#-##--##--#-##--##--#-##--##--#-##--##--#-##--##--#-##--##--#-##--##--#-##--##--#-##--##--#-##--
--#---------#---------#---------#---------#---------#---------#---------#---------#---------#-------
#----#----#----#----#----#----#----#----#----#----#----#----#----#----#----#----#----#----#----#----
#---#-----#---#-----#---#-----#---#-----#---#-----#---#-----#---#-----#---#-----#---#-----#---#-----
#--------##--------##--------##--------##--------##--------##--------##--------##--------##--------#
----#---------#S--------#---------#---------#---------#---------#---------#---------#---------#-----
-#--##-##--#--##-##--#--##-##--#--##-##--#--##-##--#--##-##--#--##-##--#--##-##--#--##-##--#--##-##-
----------------------------------------------------------------------------------------------------
----#----#----#----#----#----#----#----#----#----#----#----#----#----#----#----#----#----#----#----#
--##-#-#----##-#-#----##-#-#----##-#-#----##-#-#----##-#-#----##-#-#----##-#-#----##-#-#----##-#-#--
##--#-##--##--#-##--##--#-##--##--#-##--##--#-##--##--#-##--##--#-##--##--#-##--##--#-##--##--#-##--
--#---------#---------#---------#---------#---------#---------#---------#---------#---------#-------
#----#----#----#----#----#----#----#----#----#----#----#----#----#----#----#----#----#----#----#----
#---#-----#---#-----#---#-----#---#-----#---#-----#---#-----#---#-----#---#-----#---#-----#---#-----
#--------##--------##--------##--------##--------##--------##--------##--------##--------##--------#
----#---------#---------#---------#---------#---------#---------#---------#---------#---------#-----
-#--##-##--#--##-##--#--##-##--#--##-##--#--##-##--#--##-##--#--##-##--#--##-##--#--##-##--#--##-##-
----------------------------------------------------------------------------------------------------
----#----#----#----#----#----#----#----#----#----#----#----#----#----#----#----#----#----#----#----#
--##-#-#----##-#-#----##-#-#----##-#-#----##-#-#----##-#-#----##-#-#----##-#-#----##-#-#----##-#-#--
##--#-##--##--#-##--##--#-##--##--#-##--##--#-##--##--#-##--##--#-##--##--#-##--##--#-##--##--#-##--
--#---------#---------#---------#---------#---------#---------#---------#---------#---------#-------
#----#----#----#----#----#----#----#----#----#----#----#----#----#----#----#----#----#----#----#----
#---#-----#---#-----#---#-----#---#-----#---#-----#---#-----#---#-----#---#-----#---#-----#---#-----
#--------##--------##--------##--------##--------##--------##--------##--------##--------##--------#
----#---------#---------#---------#---------#---------#---------#---------#---------#---------#-----
-#--##-##--#--##-##--#--##-##--#--##-##--#--##-##--#--##-##--#--##-##--#--##-##--#--##-##--#--##-##-
----------------------------------------------------------------------------------------------------
----#----#----#----#----#----#----#----#----#----#----#----#----#----#----#----#----#----#----#----#
--##-#-#----##-#-#----##-#-#----##-#-#----##-#-#----##-#-#----##-#-#----##-#-#----##-#-#----##-#-#--
##--#-##--##--#-##--##--#-##--##--#-##--##--#-##--##--#-##--##--#-##--##--#-##--##--#-##--##--#-##--
--#---------#---------#---------#---------#---------#---------#---------#---------#---------#-------
#----#----#----#----#----#----#----#----#----#----#----#----#----#----#----#----#----#----#----#----
#---#-----#---#-----#---#-----#---#-----#---#-----#---#-----#---#-----#---#-----#---#-----#---#-----
#--------##--------##--------##--------##--------##--------##--------##--------##--------##--------#
----#---------#---------#---------#---------#---------#---------#---------#---------#---------#-----
-#--##-##--#--##-##--#--##-##--#--##-##--#--##-##--#--##-##--#--##-##--#--##-##--#--##-##--#--##-##-
----------------------------------------------------------------------------------------------------
----#----#----#----#----#----#----#----#----#----#----#----#----#----#----#----#----#----#----#----#
--##-#-#----##-#-#----##-#-#----##-#-#----##-#-#----##-#-#----##-#-#----##-#-#----##-#-#----##-#-#--
##--#-##--##--#-##--##--#-##--##--#-##--##--#-##--##--#-##--##--#-##--##--#-##--##--#-##--##--#-##--
--#---------#---------#---------#---------#---------#---------#---------#---------#---------#-------
#----#----#----#----#----#----#----#----#----#----#----#----#----#----#----#----#----#----#----#----
#---#-----#---#-----#---#-----#---#-----#---#-----#---#-----#---#-----#---#-----#---#-----#---#-----
#--------##--------##--------##--------##--------##--------##--------##--------##--------##--------#
