-#------#--#------#--#------#--#------#--#------#--#------#--#------#--#------#--#------#--#------#-
-#--#----#-#--#----#-#--#----#-#--#----#-#--#----#-#--#----#-#--#----#-#--#----#-#--#----#-#--#----#
-#---#--#--#---#--#--#---#--#--#---#--#--#---#--#--#---#--#--#---#--#--#---#--#--#---#--#--#---#--#-
--#----#-#--#----#-#--#----#-#--#----#-#--#----#-#--#----#-#--#----#-#--#----#-#--#----#-#--#----#-#
-##--------##--------##--------##--------##--------##--------##--------##--------##--------##-------
#--#-##---#--#-##---#--#-##---#--#-##---#--#-##---#--#-##---#--#-##---#--#-##---#--#-##---#--#-##---
-----#--#------#--#------#--#------#--#------#--#------#--#------#--#------#--#------#--#------#--#-
-#------##-#------##-#------##-#------##-#------##-#------##-#------##-#------##-#------##-#------##
-#------#--#------#--#------#--#------#--#------#--#------#--#------#--#------#--#------#--#------#-
--##----#---##----#---##----#---##----#---##----#---##----#---##----#---##----#---##----#---##----#-
-#------#--#------#--#------#--#------#--#------#--#------#--#------#--#------#--#------#--#------#-
-#--#----#-#--#----#-#--#----#-#--#----#-#--#----#-#--#----#-#--#----#-#--#----#-#--#----#-#--#----#
-#---#--#--#---#--#--#---#--#--#---#--#--#---#--#--#---#--#--#---#--#--#---#--#--#---#--#--#---#--#-
--#----#-#--#S---#-#--#----#-#--#----#-#--#----#-#--#----#-#--#----#-#--#----#-#--#----#-#--#----#-#
-##--------##--------##--------##--------##--------##--------##--------##--------##--------##-------
#--#-##---#--#-##---#--#-##---#--#-##---#--#-##---#--#-##---#--#-##---#--#-##---#--#-##---#--#-##---
-----#--#------#--#------#--#------#--#------#--#------#--#------#--#------#--#------#--#------#--#-
-#------##-#------##-#------##-#------##-#------##-#------##-#------##-#------##-#------##-#------##
-#------#--#------#--#------#--#------#--#------#--#------#--#------#--#------#--#------#--#------#-
--##----#---##----#---##----#---##----#---##----#---##----#---##----#---##----#---##----#---##----#-
-#------#--#------#--#------#--#------#--#------#--#------#--#------#--#------#--#------#--#------#-
-#--#----#-#--#----#-#--#----#-#--#----#-#--#----#-#--#----#-#--#----#-#--#----#-#--#----#-#--#----#
-#---#--#--#---#--#--#---#--#--#---#--#--#---#--#--#---#--#--#---#--#--#---#--#--#---#--#--#---#--#-
--#----#-#--#----#-#--#----#-#--#----#-#--#----#-#--#----#-#--#----#-#--#----#-#--#----#-#--#----#-#
-##--------##--------##--------##--------##--------##--------##--------##--------##--------##-------
#--#-##---#--#-##---#--#-##---#--#-##---#--#-##---#--#-##---#--#-##---#--#-##---#--#-##---#--#-##---
-----#--#------#--#------#--#------#--#------#--#------#--#------#--#------#--#------#--#------#--#-
-#------##-#------##-#------##-#------##-#------##-#------##-#------##-#------##-#------##-#------##
-#------#--#------#--#------#--#------#--#------#--#------#--#------#--#------#--#------#--#------#-
--##----#---##----#---##----#---##----#---##----#---##----#---##----#---##----#---##----#---##----#-
-#------#--#------#--#------#--#------#--#------#--#------#--#------#--#------#--#------#--#------#-
-#--#----#-#--#----#-#--#----#-#--#----#-#--#----#-#--#----#-#--#----#-#--#----#-#--#----#-#--#----#
-#---#--#--#---#--#--#---#--#--#---#--#--#---#--#--#---#--#--#---#--#--#---#--#--#---#--#--#---#--#-
--#----#-#--#----#-#--#----#-#--#----#-#--#----#-#--#----#-#--#----#-#--#----#-#--#----#-#--#----#-#
-##--------##--------##--------##--------##--------##--------##--------##--------##--------##-------
#--#-##---#--#-##---#--#-##---#--#-##---#--#-##---#--#-##---#--#-##---#--#-##---#--#-##---#--#-##---
-----#--#------#--#------#--#------#--#------#--#------#--#------#--#------#--#------#--#------#--#-
-#------##-#------##-#------##-#------##-#------##-#------##-#------##-#------##-#------##-#------##
-#------#--#------#--#------#--#------#--#------#--#------#--#------#--#------#--#------#--#------#-
--##----#---##----#---##----#---##----#---##----#---##----#---##----#---##----#---##----#---##----#-
-#------#--#------#--#------#--#------#--#------#--#------#--#------#--#------#--#------#--#------#-
-#--#----#-#--#----#-#--#----#-#--#----#-#--#----#-#--#----#-#--#----#-#--#----#-#--#----#-#--#----#
-#---#--#--#---#--#--#---#--#--#---#--#--#---#--#--#---#--#--#---#--#--#---#--#--#---#--#--#---#--#-
--#----#-#--#----#-#--#----#-#--#----#-#--#----#-#--#----#-#--#----#-#--#----#-#--#----#-#--#----#-#
-##--------##--------##--------##--------##--------##--------##--------##--------##--------##-------
#--#-##---#--#-##---#--#-##---#--#-##---#--#-##---#--#-##---#--#-##---#--#-##---#--#-##---#--#-##---
-----#--#------#--#------#--#------#--#------#--#------#--#------#--#------#--#------#--#------#--#-
-#------##-#------##-#------##-#------##-#------##-#------##-#------##-#------##-#------##-#------##
-#------#--#------#--#------#--#------#--#------#--#------#--#------#--#------#--#------#--#------#-
--##----#---##----#---##----#---##----#---##----#---##----#---##----#---##----#---##----#---##----#-
-#------#--#------#--#------#--#------#--#------#--#------#--#------#--#------#--#------#--#------#-
-#--#----#-#--#----#-#--#----#-#--#----#-#--#----#-#--#----#-#--#----#-#--#----#-#--#----#-#--#----#
-#---#--#--#---#--#--#---#--#--#---#--#--#---#--#--#---#--#--#---#--#--#---#--#--#---#--#--#---#--#-
--#----#-#--#----#-#--#----#-#--#----#-#--#----#-#--#----#-#--#----#-#--#----#-#--#----#-#--#----#-#
-##--------##--------##--------##--------##--------##--------##--------##--------##--------##-------
#--#-##---#--#-##---#--#-##---#--#-##---#--#-##---#--#-##---#--#-##---#--#-##---#--#-##---#--#-##---
-----#--#------#--#------#--#------#--#------#--#------#--#------#--#------#--#------#--#------#--#-
-#------##-#------##-#------##-#------##-#------##-#------##-#------##-#------##-#------##-#------##
-#------#--#------#--#------#--#------#--#------#--#------#--#------#--#------#--#------#--#------#-
--##----#---##----#---##----#---##----#---##----#---##----#---##----#---##----#---##----#---##----#-
-#------#--#------#--#------#--#------#--#------#--#------#--#------#--#------#--#------#--#------#-
-#--#----#-#--#----#-#--#----#-#--#----#-#--#----#-#--#----#-#--#----#-#--#----#-#--#----#-#--#----#
-#---#--#--#---#--#--#---#--#--#---#--#--#---#--#--#---#--#--#---#--#--#---#--#--#---#--#--#---#--#-
--#----#-#--#----#-#--#----#-#--#----#-#--#----#-#--#----#-#--#----#-#--#----#-#--#----#-#--#----#-#
-##--------##--------##--------##--------##--------##--------##--------##--------##--------##-------
#--#-##---#--#-##---#--#-##---#--#-##---#--#-##---#--#-##---#--#-##---#--#-##---#--#-##---#--#-##---
-----#--#------#--#------#--#------#--#------#--#------#--#------#--#------#--#------#--#------#--#-
-#------##-#------##-#------##-#------##-#------##-#------##-#------##-#------##-#------##-#------##
-#------#--#------#--#------#--#------#--#------#--#------#--#------#--#------#--#------#--#------#-
--##----#---##----#---##----#---##----#---##----#---##----#---##----#---##----#---##----#---##----#-
-#------#--#------#--#------#--#------#--#------#--#------#--#------#--#------#--#------#--#------#-
-#--#----#-#--#----#-#--#----#-#--#----#-#--#----#-#--#----#-#--#----#-#--#----#-#--#----#-#--#----#
-#---#--#--#---#--#--#---#--#--#---#--#--#---#--#--#---#--#--#---#--#--#---#--#--#---#--#--#---#--#-
--#----#-#--#----#-#--#----#-#--#----#-#--#----#-#--#----#-#--#----#-#--#----#-#--#----#-#--#----#-#
-##--------##--------##--------##--------##--------##--------##--------##--------##--------##-------
#--#-##---#--#-##---#--#-##---#--#-##---#--#-##---#--#-##---#--#-##---#--#-##---#--#-##---#--#-##---
-----#--#------#--#------#--#------#--#------#--#------#--#------#--#------#--#------#--#------#--#-
-#------##-#------##-#------##-#------##-#------##-#------##-#------##-#------##-#------##-#------##
-#------#--#------#--#------#--#------#--#------#--#------#--#------#--#------#--#------#--#------#-
--##----#---##----#---##----#---##----#---##----#---##----#---##----#---##----#---##----#---##----#-
-#------#--#------#--#------#--#------#--#------#--#------#--#------#--#------#--#------#--#------#-
-#--#----#-#--#----#-#--#----#-#--#----#-#--#----#-#--#----#-#--#----#-#--#----#-#--#----#-#--#----#
-#---#--#--#---#--#--#---#--#--#---#--#--#---#--#--#---#--#--#---#--#--#---#--#--#---#--#--#---#--#-
--#----#-#--#----#-#--#----#-#--#----#-#--#----#-#--#----#-#--#----#-#--#----#-#--#----#-#--#----#-#
-##--------##--------##--------##--------##--------##--------##--------##--------##--------##-------
#--#-##---#--#-##---#--#-##---#--#-##---#--#-##---#--#-##---#--#-##---#--#-##---#--#-##---#--#-##---
-----#--#------#--#------#--#------#--#------#--#------#--#------#--#------#--#------#--#------#--#-
-#------##-#------##-#------##-#------##-#------##-#------##-#------##-#------##-#------##-#------##
-#------#--#------#--#------#--#------#--#------#--#------#--#------#--#------#--#------#--#------#-
--##----#---##----#---##----#---##----#---##----#---##----#---##----#---##----#---##----#---##----#-
-#------#--#------#--#------#--#------#--#------#--#------#--#------#--#------#--#------#--#------#-
-#--#----#-#--#----#-#--#----#-#--#----#-#--#----#-#--#----#-#--#---E#-#--#----#-#--#----#-#--#----#
-#---#--#--#---#--#--#---#--#--#---#--#--#---#--#--#---#--#--#---#--#--#---#--#--#---#--#--#---#--#-
--#----#-#--#----#-#--#----#-#--#----#-#--#----#-#--#----#-#--#----#-#--#----#-#--#----#-#--#----#-#
-##--------##--------##--------##--------##--------##--------##--------##--------##--------##-------
#--#-##---#--#-##---#--#-##---#--#-##---#--#-##---#--#-##---#--#-##---#--#-##---#--#-##---#--#-##---
-----#--#------#--#------#--#------#--#------#--#------#--#------#--#------#--#------#--#------#--#-
-#------##-#------##-#------##-#------##-#------##-#------##-#------##-#------##-#------##-#------##
-#------#--#------#--#------#--#------#--#------#--#------#--#------#--#------#--#------#--#------#-
--##----#---##----#---##----#---##----#---##----#---##----#---##----#---##----#---##----#---##----#-
