------#--#------#--#------#--#------#--#------#--#------#--#------#--#------#--#------#--#------#--#
--#-#-#-##--#-#-#-##--#-#-#-##--#-#-#-##--#-#-#-##--#-#-#-##--#-#-#-##--#-#-#-##--#-#-#-##--#-#-#-##
---#---------#---------#---------#---------#---------#---------#---------#---------#---------#------
#-----#-###-----#-###-----#-###-----#-###-----#-###-----#-###-----#-###-----#-###-----#-###-----#-##
------##--------##--------##--------##--------##--------##--------##--------##--------##--------##--
----#--##-----#--##-----#--##-----#--##-----#--##-----#--##-----#--##-----#--##-----#--##-----#--##-
-#----##---#----##---#----##---#----##---#----##---#----##---#----##---#----##---#----##---#----##--
--##---#----##---#----##---#----##---#----##---#----##---#----##---#----##---#----##---#----##---#--
#-----##--#-----##--#-----##--#-----##--#-----##--#-----##--#-----##--#-----##--#-----##--#-----##--
-----#-#-------#-#-------#-#-------#-#-------#-#-------#-#-------#-#-------#-#-------#-#-------#-#--
------#--#------#--#------#--#------#--#------#--#------#--#------#--#------#--#------#--#------#--#
--#-#-#-##--#-#-#-##--#-#-#-##--#-#-#-##--#-#-#-##--#-#-#-##--#-#-#-##--#-#-#-##--#-#-#-##--#-#-#-##
---#---------#---------#---------#---------#---------#---------#---------#---------#---------#------
#-----#-###-----#-###-----#-###-----#-###-----#-###-----#-###-----#-###-----#-###-----#-###-----#-##
------##--------##--------##--------##--------##--------##--------##--------##--------##--------##--
----#--##-----#--##-----#--##-----#--##-----#--##-----#--##-----#--##-----#--##-----#--##-----#--##-
-#----##---#----##---#----##---#----##---#----##---#----##---#----##---#----##---#----##---#----##--
--##---#----##---#----##---#----##---#----##---#----##---#----##---#----##---#----##---#----##---#--
#-----##--#-----##--#-----##--#-----##--#-----##--#-----##--#-----##--#-----##--#-----##--#-----##--
-----#-#-------#-#-------#-#-------#-#-------#-#-------#-#-------#-#-------#-#-------#-#-------#-#--
------#--#------#--#------#--#------#--#------#--#------#--#------#--#------#--#------#--#------#--#
--#-#-#-##--#-#-#-##--#-#-#-##--#-#-#-##--#-#-#-##--#-#-#-##--#-#-#-##--#-#-#-##--#-#-#-##--#-#-#-##
---#---------#---------#---------#---------#---------#---------#---------#---------#---------#------
#-----#-###-----#-###-----#-###-----#-###-----#-###-----#-###-----#-###-----#-###-----#-###-----#-##
------##--------##--------##--------##--------##--------##--------##--------##--------##--------##--
----#--##-----#--##-----#--##-----#--##-----#--##-----#--##-----#--##-----#--##-----#--##-----#--##-
-#----##---#----##---#----##---#----##---#----##---#----##---#----##---#----##---#----##---#----##--
--##---#----##---#----##---#----##---#----##---#----##---#----##---#----##---#----##---#----##---#--
#-----##--#-----##--#-----##--#-----##--#-----##--#-----##--#-----##--#-----##--#-----##--#-----##--
-----#-#-------#-#-------#-#-------#-#-------#-#-------#-#-------#-#-------#-#-------#-#-------#-#--
------#--#------#--#------#--#------#--#------#--#------#--#------#--#------#--#------#--#------#--#
--#-#-#-##--#-#-#-##--#-#-#-##--#-#-#-##--#-#-#-##--#-#-#-##--#-#-#-##--#-#-#-##--#-#-#-##--#-#-#-##
---#---------#---------#---------#---------#---------#---------#---------#---------#---------#------
#-----#-###-----#-###-----#-###-----#-###-----#-###-----#-###-----#-###-----#-###-----#-###-----#-##
------##--------##--------##--------##--------##--------##S-------##--------##--------##--------##--
----#--##-----#--##-----#--##-----#--##-----#--##-----#--##-----#--##-----#--##-----#--##-----#--##-
-#----##---#----##---#----##---#----##---#----##---#----##---#----##---#----##---#----##---#----##--
--##---#----##---#----##---#----##---#----##---#----##---#----##---#----##---#----##---#----##---#--
#-----##--#-----##--#-----##--#-----##--#-----##--#-----##--#-----##--#-----##--#-----##--#-----##--
-----#-#-------#-#-------#-#-------#-#-------#-#-------#-#-------#-#-------#-#-------#-#-------#-#--
------#--#------#--#------#--#------#--#------#--#------#--#------#--#------#--#------#--#------#--#
--#-#-#-##--#-#-#-##--#-#-#-##--#-#-#-##--#-#-#-##--#-#-#-##--#-#-#-##--#-#-#-##--#-#-#-##--#-#-#-##
---#---------#---------#---------#---------#---------#---------#---------#---------#---------#------
#-----#-###-----#-###-----#-###-----#-###-----#-###-----#-###-----#-###-----#-###-----#-###-----#-##
------##--------##--------##--------##--------##--------##--------##--------##--------##--------##--
----#--##-----#--##-----#--##-----#--##-----#--##-----#--##-----#--##-----#--##-----#--##-----#--##-
-#----##---#----##---#----##---#----##---#----##---#----##---#----##---#----##---#----##---#----##--
--##---#----##---#----##---#----##---#----##---#----##---#----##---#----##---#----##---#----##---#--
#-----##--#-----##--#-----##--#-----##--#-----##--#-----##--#-----##--#-----##--#-----##--#-----##--
-----#-#-------#-#-------#-#-------#-#-------#-#-------#-#-------#-#-------#-#-------#-#-------#-#--
------#--#------#--#------#--#------#--#------#--#------#--#------#--#------#--#------#--#------#--#
--#-#-#-##--#-#-#-##--#-#-#-##--#-#-#-##--#-#-#-##--#-#-#-##--#-#-#-##--#-#-#-##--#-#-#-##--#-#-#-##
---#---------#---------#---------#---------#---------#---------#---------#---------#---------#------
#-----#-###-----#-###-----#-###-----#-###-----#-###-----#-###-----#-###-----#-###-----#-###-----#-##
------##--------##--------##--------##--------##--------##--------##--------##--------##--------##--
----#--##-----#--##-----#--##-----#--##-----#--##-----#--##-----#--##-----#--##-----#--##-----#--##-
-#----##---#----##---#----##---#----##---#----##---#----##---#----##---#----##---#----##---#----##--
--##---#----##---#----##---#----##---#----##---#----##---#----##---#----##---#----##---#----##---#--
#-----##--#-----##--#-----##--#-----##--#-----##--#-----##--#-----##--#-----##--#-----##--#-----##--
-----#-#-------#-#-------#-#-------#-#-------#-#-------#-#-------#-#-------#-#-------#-#-------#-#--
------#--#------#--#------#--#------#--#------#--#------#--#------#--#------#--#------#--#------#--#
--#-#-#-##--#-#-#-##--#-#-#-##--#-#-#-##--#-#-#-##--#-#-#-##--#-#-#-##--#-#-#-##--#-#-#-##--#-#-#-##
---#---------#---------#---------#---------#---------#---------#---------#---------#---------#------
#-----#-###-----#-###-----#-###-----#-###-----#-###-----#-###-----#-###-----#-###-----#-###-----#-##
------##--------##-------E##--------##--------##--------##--------##--------##--------##--------##--
----#--##-----#--##-----#--##-----#--##-----#--##-----#--##-----#--##-----#--##-----#--##-----#--##-
-#----##---#----##---#----##---#----##---#----##---#----##---#----##---#----##---#----##---#----##--
--##---#----##---#----##---#----##---#----##---#----##---#----##---#----##---#----##---#----##---#--
#-----##--#-----##--#-----##--#-----##--#-----##--#-----##--#-----##--#-----##--#-----##--#-----##--
-----#-#-------#-#-------#-#-------#-#-------#-#-------#-#-------#-#-------#-#-------#-#-------#-#--
------#--#------#--#------#--#------#--#------#--#------#--#------#--#------#--#------#--#------#--#
--#-#-#-##--#-#-#-##--#-#-#-##--#-#-#-##--#-#-#-##--#-#-#-##--#-#-#-##--#-#-#-##--#-#-#-##--#-#-#-##
---#---------#---------#---------#---------#---------#---------#---------#---------#---------#------
#-----#-###-----#-###-----#-###-----#-###-----#-###-----#-###-----#-###-----#-###-----#-###-----#-##
------##--------##--------##--------##--------##--------##--------##--------##--------##--------##--
----#--##-----#--##-----#--##-----#--##-----#--##-----#--##-----#--##-----#--##-----#--##-----#--##-
-#----##---#----##---#----##---#----##---#----##---#----##---#----##---#----##---#----##---#----##--
--##---#----##---#----##---#----##---#----##---#----##---#----##---#----##---#----##---#----##---#--
#-----##--#-----##--#-----##--#-----##--#-----##--#-----##--#-----##--#-----##--#-----##--#-----##--
-----#-#-------#-#-------#-#-------#-#-------#-#-------#-#-------#-#-------#-#-------#-#-------#-#--
------#--#------#--#------#--#------#--#------#--#------#--#------#--#------#--#------#--#------#--#
--#-#-#-##--#-#-#-##--#-#-#-##--#-#-#-##--#-#-#-##--#-#-#-##--#-#-#-##--#-#-#-##--#-#-#-##--#-#-#-##
---#---------#---------#---------#---------#---------#---------#---------#---------#---------#------
#-----#-###-----#-###-----#-###-----#-###-----#-###-----#-###-----#-###-----#-###-----#-###-----#-##
------##--------##--------##--------##--------##--------##--------##--------##--------##--------##--
----#--##-----#--##-----#--##-----#--##-----#--##-----#--##-----#--##-----#--##-----#--##-----#--##-
-#----##---#----##---#----##---#----##---#----##---#----##---#----##---#----##---#----##---#----##--
--##---#----##---#----##---#----##---#----##---#----##---#----##---#----##---#----##---#----##---#--
#-----##--#-----##--#-----##--#-----##--#-----##--#-----##--#-----##--#-----##--#-----##--#-----##--
-----#-#-------#-#-------#-#-------#-#-------#-#-------#-#-------#-#-------#-#-------#-#-------#-#--
------#--#------#--#------#--#------#--#------#--#------#--#------#--#------#--#------#--#------#--#
--#-#-#-##--#-#-#-##--#-#-#-##--#-#-#-##--#-#-#-##--#-#-#-##--#-#-#-##--#-#-#-##--#-#-#-##--#-#-#-##
---#---------#---------#---------#---------#---------#---------#---------#---------#---------#------
#-----#-###-----#-###-----#-###-----#-###-----#-###-----#-###-----#-###-----#-###-----#-###-----#-##
------##--------##--------##--------##--------##--------##--------##--------##--------##--------##--
----#--##-----#--##-----#--##-----#--##-----#--##-----#--##-----#--##-----#--##-----#--##-----#--##-
-#----##---#----##---#----##---#----##---#----##---#----##---#----##---#----##---#----##---#----##--
--##---#----##---#----##---#----##---#----##---#----##---#----##---#----##---#----##---#----##---#--
#-----##--#-----##--#-----##--#-----##--#-----##--#-----##--#-----##--#-----##--#-----##--#-----##--
-----#-#-------#-#-------#-#-------#-#-------#-#-------#-#-------#-#-------#-#-------#-#-------#-#--
