--#-#-------#-#-------#-#-------#-#-------#-#-------#-#-------#-#-------#-#-------#-#-------#-#-----
--#---##----#---##----#---##----#---##----#---##----#---##----#---##----#---##----#---##----#---##--
-----#---#-----#---#-----#---#-----#---#-----#---#-----#---#-----#---#-----#---#-----#---#-----#---#
--#-----#---#-----#---#-----#---#-----#---#-----#---#-----#---#-----#---#-----#---#-----#---#-----#-
----#---------#---------#---------#---------#---------#---------#---------#---------#---------#-----
----##--------##--------##--------##--------##--------##--------##--------##--------##--------##----
--#----#----#----#----#----#----#----#----#----#----#----#----#----#----#----#----#----#----#----#--
-#----#----#----#----#----#----#----#----#----#----#----#----#----#----#----#----#----#----#----#---
---##-##-----##-##-----##-##-----##-##-----##-##-----##-##-----##-##-----##-##-----##-##-----##-##--
#-----#-#-#-----#-#-#-----#-#-#-----#-#-#-----#-#-#-----#-#-#-----#-#-#-----#-#-#-----#-#-#-----#-#-
--#-#-------#-#-------#-#-------#-#-------#-#-------#-#-------#-#-------#-#-------#-#-------#-#-----
--#---##----#---##----#---##----#---##----#---##----#---##----#---##----#---##----#---##----#---##--
-----#---#-----#---#-----#---#-----#---#-----#---#-----#---#-----#---#-----#---#-----#---#-----#---#
--#-----#---#-----#---#-----#---#-----#---#-----#---#-----#---#-----#---#-----#---#-----#---#-----#-
----#---------#---------#---------#---------#---------#---------#---------#---------#---------#-----
----##--------##--------##--------##--------##--------##--------##--------##--------##--------##----
--#----#----#----#----#----#----#----#----#----#----#----#----#----#----#----#----#----#----#----#--
-#----#----#----#----#----#----#----#----#----#----#----#----#----#----#----#----#----#----#----#---
---##-##-----##-##-----##-##-----##-##-----##-##-----##-##-----##-##-----##-##-----##-##-----##-##--
#-----#-#-#-----#-#-#-----#-#-#-----#-#-#-----#-#-#-----#-#-#-----#-#-#-----#-#-#-----#-#-#-----#-#-
--#-#-------#-#-------#-#-------#-#-------#-#-------#-#-------#-#-------#-#-------#-#-------#-#-----
--#---##----#---##----#---##----#---##----#---##----#---##----#---##----#---##----#---##----#---##--
-----#---#-----#---#-----#---#-----#---#-----#---#-----#---#-----#---#-----#---#-----#---#-----#---#
--#-----#---#-----#---#-----#---#-----#---#-----#---#-----#---#-----#---#-----#---#-----#---#-----#-
----#---------#---------#---------#---------#---------#---------#---------#---------#---------#-----
----##--------##--------##--------##--------##--------##--------##--------##--------##--------##----
--#----#----#----#----#----#----#----#----#----#----#----#----#----#----#----#----#----#----#----#--
-#----#----#----#----#----#----#----#----#----#----#----#----#----#----#----#----#----#----#----#---
---##-##-----##-##-----##-##-----##-##-----##-##-----##-##-----##-##-----##-##-----##-##-----##-##--
#-----#-#-#-----#-#-#-----#-#-#-----#-#-#-----#-#-#-----#-#-#-----#-#-#-----#-#-#-----#-#-#-----#-#-
--#-#-------#-#-------#-#-------#-#-------#-#-------#-#-------#-#-------#-#-------#-#-------#-#-----
--#---##----#---##----#---##----#---##----#---##----#---##----#---##----#---##----#---##----#---##--
-----#---#-----#---#-----#---#-----#---#-----#---#E----#---#-----#---#-----#---#-----#---#-----#---#
--#-----#---#-----#---#-----#---#-----#---#-----#---#-----#---#-----#---#-----#---#-----#---#-----#-
----#---------#---------#---------#---------#---------#---------#---------#---------#---------#-----
----##--------##--------##--------##--------##--------##--------##--------##--------##--------##----
--#----#----#----#----#----#----#----#----#----#----#----#----#----#----#----#----#----#----#----#--
-#----#----#----#----#----#----#----#----#----#----#----#----#----#----#----#----#----#----#----#---
---##-##--S--##-##-----##-##-----##-##-----##-##-----##-##-----##-##-----##-##-----##-##-----##-##--
#-----#-#-#-----#-#-#-----#-#-#-----#-#-#-----#-#-#-----#-#-#-----#-#-#-----#-#-#-----#-#-#-----#-#-
--#-#-------#-#-------#-#-------#-#-------#-#-------#-#-------#-#-------#-#-------#-#-------#-#-----
--#---##----#---##----#---##----#---##----#---##----#---##----#---##----#---##----#---##----#---##--
-----#---#-----#---#-----#---#-----#---#-----#---#-----#---#-----#---#-----#---#-----#---#-----#---#
--#-----#---#-----#---#-----#---#-----#---#-----#---#-----#---#-----#---#-----#---#-----#---#-----#-
----#---------#---------#---------#---------#---------#---------#---------#---------#---------#-----
----##--------##--------##--------##--------##--------##--------##--------##--------##--------##----
--#----#----#----#----#----#----#----#----#----#----#----#----#----#----#----#----#----#----#----#--
-#----#----#----#----#----#----#----#----#----#----#----#----#----#----#----#----#----#----#----#---
---##-##-----##-##-----##-##-----##-##-----##-##-----##-##-----##-##-----##-##-----##-##-----##-##--
#-----#-#-#-----#-#-#-----#-#-#-----#-#-#-----#-#-#-----#-#-#-----#-#-#-----#-#-#-----#-#-#-----#-#-
--#-#-------#-#-------#-#-------#-#-------#-#-------#-#-------#-#-------#-#-------#-#-------#-#-----
--#---##----#---##----#---##----#---##----#---##----#---##----#---##----#---##----#---##----#---##--
-----#---#-----#---#-----#---#-----#---#-----#---#-----#---#-----#---#-----#---#-----#---#-----#---#
--#-----#---#-----#---#-----#---#-----#---#-----#---#-----#---#-----#---#-----#---#-----#---#-----#-
----#---------#---------#---------#---------#---------#---------#---------#---------#---------#-----
----##--------##--------##--------##--------##--------##--------##--------##--------##--------##----
--#----#----#----#----#----#----#----#----#----#----#----#----#----#----#----#----#----#----#----#--
-#----#----#----#----#----#----#----#----#----#----#----#----#----#----#----#----#----#----#----#---
---##-##-----##-##-----##-##-----##-##-----##-##-----##-##-----##-##-----##-##-----##-##-----##-##--
#-----#-#-#-----#-#-#-----#-#-#-----#-#-#-----#-#-#-----#-#-#-----#-#-#-----#-#-#-----#-#-#-----#-#-
--#-#-------#-#-------#-#-------#-#-------#-#-------#-#-------#-#-------#-#-------#-#-------#-#-----
--#---##----#---##----#---##----#---##----#---##----#---##----#---##----#---##----#---##----#---##--
-----#---#-----#---#-----#---#-----#---#-----#---#-----#---#-----#---#-----#---#-----#---#-----#---#
--#-----#---#-----#---#-----#---#-----#---#-----#---#-----#---#-----#---#-----#---#-----#---#-----#-
----#---------#---------#---------#---------#---------#---------#---------#---------#---------#-----
----##--------##--------##--------##--------##--------##--------##--------##--------##--------##----
--#----#----#----#----#----#----#----#----#----#----#----#----#----#----#----#----#----#----#----#--
-#----#----#----#----#----#----#----#----#----#----#----#----#----#----#----#----#----#----#----#---
---##-##-----##-##-----##-##-----##-##-----##-##-----##-##-----##-##-----##-##-----##-##-----##-##--
#-----#-#-#-----#-#-#-----#-#-#-----#-#-#-----#-#-#-----#-#-#-----#-#-#-----#-#-#-----#-#-#-----#-#-
--#-#-------#-#-------#-#-------#-#-------#-#-------#-#-------#-#-------#-#-------#-#-------#-#-----
--#---##----#---##----#---##----#---##----#---##----#---##----#---##----#---##----#---##----#---##--
-----#---#-----#---#-----#---#-----#---#-----#---#-----#---#-----#---#-----#---#-----#---#-----#---#
--#-----#---#-----#---#-----#---#-----#---#-----#---#-----#---#-----#---#-----#---#-----#---#-----#-
----#---------#---------#---------#---------#---------#---------#---------#---------#---------#-----
----##--------##--------##--------##--------##--------##--------##--------##--------##--------##----
--#----#----#----#----#----#----#----#----#----#----#----#----#----#----#----#----#----#----#----#--
-#----#----#----#----#----#----#----#----#----#----#----#----#----#----#----#----#----#----#----#---
---##-##-----##-##-----##-##-----##-##-----##-##-----##-##-----##-##-----##-##-----##-##-----##-##--
#-----#-#-#-----#-#-#-----#-#-#-----#-#-#-----#-#-#-----#-#-#-----#-#-#-----#-#-#-----#-#-#-----#-#-
--#-#-------#-#-------#-#-------#-#-------#-#-------#-#-------#-#-------#-#-------#-#-------#-#-----
--#---##----#---##----#---##----#---##----#---##----#---##----#---##----#---##----#---##----#---##--
-----#---#-----#---#-----#---#-----#---#-----#---#-----#---#-----#---#-----#---#-----#---#-----#---#
--#-----#---#-----#---#-----#---#-----#---#-----#---#-----#---#-----#---#-----#---#-----#---#-----#-
----#---------#---------#---------#---------#---------#---------#---------#---------#---------#-----
----##--------##--------##--------##--------##--------##--------##--------##--------##--------##----
--#----#----#----#----#----#----#----#----#----#----#----#----#----#----#----#----#----#----#----#--
-#----#----#----#----#----#----#----#----#----#----#----#----#----#----#----#----#----#----#----#---
---##-##-----##-##-----##-##-----##-##-----##-##-----##-##-----##-##-----##-##-----##-##-----##-##--
#-----#-#-#-----#-#-#-----#-#-#-----#-#-#-----#-#-#-----#-#-#-----#-#-#-----#-#-#-----#-#-#-----#-#-
--#-#-------#-#-------#-#-------#-#-------#-#-------#-#-------#-#-------#-#-------#-#-------#-#-----
--#---##----#---##----#---##----#---##----#---##----#---##----#---##----#---##----#---##----#---##--
-----#---#-----#---#-----#---#-----#---#-----#---#-----#---#-----#---#-----#---#-----#---#-----#---#
--#-----#---#-----#---#-----#---#-----#---#-----#---#-----#---#-----#---#-----#---#-----#---#-----#-
----#---------#---------#---------#---------#---------#---------#---------#---------#---------#-----
----##--------##--------##--------##--------##--------##--------##--------##--------##--------##----
--#----#----#----#----#----#----#----#----#----#----#----#----#----#----#----#----#----#----#----#--
-#----#----#----#----#----#----#----#----#----#----#----#----#----#----#----#----#----#----#----#---
---##-##-----##-##-----##-##-----##-##-----##-##-----##-##-----##-##-----##-##-----##-##-----##-##--
#-----#-#-#-----#-#-#-----#-#-#-----#-#-#-----#-#-#-----#-#-#-----#-#-#-----#-#-#-----#-#-#-----#-#-
