------###-------###-------###-------###-------###-------###-------###-------###-------###-------###-
-#------##-#------##-#------##-#------##-#------##-#------##-#------##-#------##-#------##-#------##
----#-#-------#-#-------#-#-------#-#-------#-#-------#-#-------#-#-------#-#-------#-#-------#-#---
#--#---#--#--#---#--#--#---#--#--#---#--#--#---#--#--#---#--#--#---#--#--#---#--#--#---#--#--#---#--
--##--------##--------##--------##--------##--------##--------##--------##--------##--------##------
--##--#-----##--#-----##--#-----##--#-----##--#-----##--#-----##--#-----##--#-----##--#-----##--#---
-----#-##------#-##------#-##------#-##------#-##------#-##------#-##------#-##------#-##------#-##-
--------#---------#---------#---------#---------#---------#---------#---------#---------#---------#-
#----#--#-#----#--#-#----#--#-#----#--#-#----#--#-#----#--#-#----#--#-#----#--#-#----#--#-#----#--#-
--#---#-----#---#-----#---#-----#---#-----#---#-----#---#-----#---#-----#---#-----#---#-----#---#---
------###-------###-------###-------###-------###-------###-------###-------###-------###-------###-
-#------##-#------##-#------##-#------##-#------##-#------##-#------##-#------##-#------##-#------##
----#-#-------#-#-------#-#-------#-#-------#-#-------#-#-------#-#-------#-#-------#-#-------#-#---
#--#---#--#--#---#--#--#---#--#--#---#--#--#---#--#--#---#--#--#---#--#--#---#--#--#---#--#--#---#--
--##--------##--------##--------##--------##--------##--------##--------##--------##--------##------
--##--#-----##--#-----##--#-----##--#-----##--#-----##--#-----##--#-----##--#-----##--#-----##--#---
-----#-##------#-##------#-##------#-##------#-##------#-##------#-##------#-##------#-##------#-##-
--------#---------#---------#---------#---------#---------#---------#---------#---------#---------#-
#----#--#-#----#--#-#----#--#-#----#--#-#----#--#-#----#--#-#----#--#-#----#--#-#----#--#-#----#--#-
--#---#-----#---#-----#---#-----#---#-----#---#-----#---#-----#---#-----#---#-----#---#-----#---#---
------###-------###-------###-------###-------###-------###-------###-------###-------###-------###-
-#------##-#------##-#------##-#------##-#------##-#------##-#------##-#------##-#------##-#------##
----#-#-------#-#-------#-#-------#-#-------#-#-------#-#-------#-#-------#-#-------#-#-------#-#---
#--#---#--#--#---#--#--#---#--#--#---#--#--#---#--#--#---#--#--#---#--#--#---#--#--#---#--#--#---#--
--##--------##--------##--------##--------##--------##--------##--------##--------##--------##------
--##--#-----##--#-----##--#-----##--#-----##--#-----##--#-----##--#-----##--#-----##--#-----##--#---
-----#-##------#-##------#E##------#-##------#-##------#-##------#-##------#-##------#-##------#-##-
--------#---------#---------#---------#---------#---------#---------#---------#---------#---------#-
#----#--#-#----#--#-#----#--#-#----#--#-#----#--#-#----#--#-#----#--#-#----#--#-#----#--#-#----#--#-
--#---#-----#---#-----#---#-----#---#-----#---#-----#---#-----#---#-----#---#-----#---#-----#---#---
------###-------###-------###-------###-------###-------###-------###-------###-------###-------###-
-#------##-#------##-#------##-#------##-#------##-#------##-#------##-#------##-#------##-#------##
----#-#-------#-#-------#-#-------#-#-------#-#-------#-#-------#-#-------#-#-------#-#-------#-#---
#--#---#--#--#---#--#--#---#--#--#---#--#--#---#--#--#---#--#--#---#--#--#---#--#--#---#--#--#---#--
--##--------##--------##--------##--------##--------##--------##--------##--------##--------##------
--##--#-----##--#-----##--#-----##--#-----##--#-----##--#-----##--#-----##--#-----##--#-----##--#---
-----#-##------#-##------#-##------#-##------#-##------#-##------#-##------#-##------#-##------#-##-
--------#---------#---------#---------#---------#---------#---------#---------#---------#---------#-
#----#--#-#----#--#-#----#--#-#----#--#-#----#--#-#----#--#-#----#--#-#----#--#-#----#--#-#----#--#-
--#---#-----#---#-----#---#-----#---#-----#---#-----#---#-----#---#-----#---#-----#---#-----#---#---
------###-------###-------###-------###-------###-------###-------###-------###-------###-------###-
-#------##-#------##-#------##-#------##-#------##-#------##-#------##-#------##-#------##-#------##
----#-#-------#-#-------#-#-------#-#-------#-#-------#-#-------#-#-------#-#-------#-#-------#-#---
#--#---#--#--#---#--#--#---#--#--#---#--#--#---#--#--#---#--#--#---#--#--#---#--#--#---#--#--#---#--
--##--------##--------##--------##--------##--------##--------##--------##--------##--------##------
--##--#-----##--#-----##--#-----##--#-----##--#-----##--#-----##--#-----##--#-----##--#-----##--#---
-----#-##------#-##------#-##------#-##------#-##------#-##------#-##------#-##------#-##------#-##-
--------#---------#---------#---------#---------#---------#---------#---------#---------#---------#-
#----#--#-#----#--#-#----#--#-#----#--#-#----#--#-#----#--#-#----#--#-#----#--#-#----#--#-#----#--#-
--#---#-----#---#-----#---#-----#---#-----#---#-----#---#-----#---#-----#---#-----#---#-----#---#---
------###-------###-------###-------###-------###-------###-------###-------###-------###-------###-
-#------##-#------##-#------##-#------##-#------##-#------##-#------##-#------##-#------##-#------##
----#-#-------#-#-------#-#-------#-#-------#-#-------#-#-------#-#-------#-#-------#-#-------#-#---
#--#---#--#--#---#--#--#---#--#--#---#--#--#---#--#--#---#--#--#---#--#--#---#--#--#---#--#--#---#--
--##--------##--------##--------##--------##--------##--------##--------##--------##--------##------
--##--#-----##--#-----##--#-----##--#-----##--#-----##--#-----##--#-----##--#-----##--#-----##--#---
-----#-##------#-##------#-##------#-##------#-##------#-##------#-##------#-##------#-##------#-##-
--------#---------#---------#---------#---------#---------#---------#---------#---------#---------#-
#----#--#-#----#--#-#----#--#-#----#--#-#----#--#-#----#--#-#----#--#-#----#--#-#----#--#-#----#--#-
--#---#-----#---#-----#---#-----#---#-----#---#-----#---#-----#---#-----#---#-----#---#-----#---#---
------###-------###-------###-------###-------###-------###-------###-------###-------###-------###-
-#------##-#------##-#------##-#------##-#------##-#------##-#------##-#------##-#------##-#------##
----#-#-------#-#-------#-#-------#-#-------#-#-------#-#-------#-#-------#-#-------#-#-------#-#---
#--#---#--#--#---#--#--#---#--#--#---#--#--#---#--#--#---#--#--#---#--#--#---#--#--#---#--#--#---#--
--##--------##--------##--------##--------##--------##--------##--------##--------##--------##------
--##--#-----##--#-----##--#-----##--#-----##--#-----##--#-----##--#-----##--#-----##--#-----##--#---
-----#-##------#-##------#-##------#-##------#-##------#-##------#-##------#-##------#-##------#-##-
--------#---------#---------#---------#---------#---------#---------#---------#---------#---------#-
#----#--#-#----#--#-#----#--#-#----#--#-#----#--#-#----#--#-#----#--#-#----#--#-#----#--#-#----#--#-
--#---#-----#---#-----#---#-----#---#-----#---#-----#---#-----#---#-----#---#-----#---#-----#---#---
------###-------###-------###-------###-------###-------###-------###-------###-------###-------###-
-#------##-#------##-#------##-#------##-#------##-#------##-#-----S##-#------##-#------##-#------##
----#-#-------#-#-------#-#-------#-#-------#-#-------#-#-------#-#-------#-#-------#-#-------#-#---
#--#---#--#--#---#--#--#---#--#--#---#--#--#---#--#--#---#--#--#---#--#--#---#--#--#---#--#--#---#--
--##--------##--------##--------##--------##--------##--------##--------##--------##--------##------
--##--#-----##--#-----##--#-----##--#-----##--#-----##--#-----##--#-----##--#-----##--#-----##--#---
-----#-##------#-##------#-##------#-##------#-##------#-##------#-##------#-##------#-##------#-##-
--------#---------#---------#---------#---------#---------#---------#---------#---------#---------#-
#----#--#-#----#--#-#----#--#-#----#--#-#----#--#-#----#--#-#----#--#-#----#--#-#----#--#-#----#--#-
--#---#-----#---#-----#---#-----#---#-----#---#-----#---#-----#---#-----#---#-----#---#-----#---#---
------###-------###-------###-------###-------###-------###-------###-------###-------###-------###-
-#------##-#------##-#------##-#------##-#------##-#------##-#------##-#------##-#------##-#------##
----#-#-------#-#-------#-#-------#-#-------#-#-------#-#-------#-#-------#-#-------#-#-------#-#---
#--#---#--#--#---#--#--#---#--#--#---#--#--#---#--#--#---#--#--#---#--#--#---#--#--#---#--#--#---#--
--##--------##--------##--------##--------##--------##--------##--------##--------##--------##------
--##--#-----##--#-----##--#-----##--#-----##--#-----##--#-----##--#-----##--#-----##--#-----##--#---
-----#-##------#-##------#-##------#-##------#-##------#-##------#-##------#-##------#-##------#-##-
--------#---------#---------#---------#---------#---------#---------#---------#---------#---------#-
#----#--#-#----#--#-#----#--#-#----#--#-#----#--#-#----#--#-#----#--#-#----#--#-#----#--#-#----#--#-
--#---#-----#---#-----#---#-----#---#-----#---#-----#---#-----#---#-----#---#-----#---#-----#---#---
------###-------###-------###-------###-------###-------###-------###-------###-------###-------###-
-#------##-#------##-#------##-#------##-#------##-#------##-#------##-#------##-#------##-#------##
----#-#-------#-#-------#-#-------#-#-------#-#-------#-#-------#-#-------#-#-------#-#-------#-#---
#--#---#--#--#---#--#--#---#--#--#---#--#--#---#--#--#---#--#--#---#--#--#---#--#--#---#--#--#---#--
--##--------##--------##--------##--------##--------##--------##--------##--------##--------##------
--##--#-----##--#-----##--#-----##--#-----##--#-----##--#-----##--#-----##--#-----##--#-----##--#---
-----#-##------#-##------#-##------#-##------#-##------#-##------#-##------#-##------#-##------#-##-
--------#---------#---------#---------#---------#---------#---------#---------#---------#---------#-
#----#--#-#----#--#-#----#--#-#----#--#-#----#--#-#----#--#-#----#--#-#----#--#-#----#--#-#----#--#-
--#---#-----#---#-----#---#-----#---#-----#---#-----#---#-----#---#-----#---#-----#---#-----#---#---
