--#---#-#---#---#-#---#---#-#---#---#-#---#---#-#---#---#-#---#---#-#---#---#-#---#---#-#---#---#-#-
--#--#--#---#--#--#---#--#--#---#--#--#---#--#--#---#--#--#---#--#--#---#--#--#---#--#--#---#--#--#-
---#-##------#-##------#-##------#-##------#-##------#-##------#-##------#-##------#-##------#-##---
----#-##------#-##------#-##------#-##------#-##------#-##------#-##------#-##------#-##------#-##--
#------##-#------##-#------##-#------##-#------##-#------##-#------##-#------##-#------##-#------##-
---#-----#---#-----#---#-----#---#-----#---#-----#---#-----#---#-----#---#-----#---#-----#---#-----#
---#---------#---------#---------#---------#---------#---------#---------#---------#---------#------
###---#---###---#---###---#---###---#---###---#---###---#---###---#---###---#---###---#---###---#---
-------#---------#---------#---------#---------#---------#---------#---------#---------#---------#--
-#----#--#-#----#--#-#----#--#-#----#--#-#----#--#-#----#--#-#----#--#-#----#--#-#----#--#-#----#--#
--#---#-#---#---#-#---#---#-#---#---#-#---#---#-#---#---#-#---#---#-#---#---#-#---#---#-#---#---#-#-
--#--#--#---#--#--#---#--#--#---#--#--#---#--#--#---#--#--#---#--#--#---#--#--#---#--#--#---#--#--#-
---#-##------#-##------#-##------#-##------#-##------#-##------#-##------#-##------#-##------#-##---
----#-##------#-##------#-##------#-##------#-##------#-##------#-##------#-##------#-##------#-##--
#------##-#------##-#------##-#------##-#------##-#------##-#------##-#------##-#------##-#------##-
---#-----#---#-----#---#-----#---#-----#---#-----#---#-----#---#-----#---#-----#---#-----#---#-----#
---#---------#---------#---------#---------#---------#---------#---------#---------#---------#------
###---#---###---#---###---#---###---#---###---#---###---#---###---#---###---#---###---#---###---#---
-------#---------#---------#---------#---------#---------#---------#---------#---------#---------#--
-#----#--#-#----#--#-#----#--#-#----#--#-#----#--#-#----#--#-#----#--#-#----#--#-#----#--#-#----#--#
--#---#-#---#---#-#---#---#-#---#---#-#---#---#-#---#---#-#---#---#-#---#---#-#---#---#-#---#---#-#-
--#--#--#---#--#--#---#--#--#---#--#--#---#--#--#---#--#--#---#--#--#---#--#--#---#--#--#---#--#--#-
---#-##------#-##------#-##------#-##------#-##------#-##------#-##------#-##------#-##------#-##---
----#-##------#-##------#-##------#-##------#-##------#-##------#-##------#-##------#-##------#-##--
#------##-#------##-#------##-#------##-#------##-#------##-#------##-#------##-#------##-#------##-
---#-----#---#-----#---#-----#---#-----#---#-----#---#-----#---#-----#---#-----#---#-----#---#-----#
---#---------#---------#---------#---------#---------#---------#---------#---------#---------#------
###---#---###---#---###---#---###---#---###---#---###---#---###---#---###---#---###---#---###---#---
-------#---------#---------#---------#---------#---------#---------#---------#---------#---------#--
-#----#--#-#----#--#-#----#--#-#----#--#-#----#--#-#----#--#-#----#--#-#----#--#-#----#--#-#----#--#
--#---#-#---#---#-#---#---#-#---#---#-#---#---#-#---#---#-#---#---#-#---#---#-#---#---#-#---#---#-#-
--#--#--#---#--#--#---#--#--#---#--#--#---#--#--#---#--#--#---#--#--#---#--#--#---#--#--#---#--#--#-
---#-##------#-##------#-##------#-##------#-##------#-##------#-##------#-##------#-##------#-##---
----#-##------#-##------#-##------#-##------#-##------#-##------#-##------#-##------#-##------#-##--
#------##-#------##-#------##-#------##-#------##-#------##-#------##-#------##-#------##-#------##-
---#-----#---#-----#---#-----#---#-----#---#-----#---#-----#---#-----#---#-----#---#-----#---#-----#
---#---------#---------#---------#---------#---------#---------#---------#---------#---------#------
###---#---###---#---###---#---###---#---###---#---###---#---###---#---###---#---###---#---###---#---
-------#---------#---------#---------#---------#---------#---------#---------#---------#---------#--
-#----#--#-#----#--#-#----#--#-#----#--#-#----#--#-#----#--#-#----#--#-#----#--#-#----#--#-#----#--#
--#---#-#---#---#-#---#---#-#---#---#-#---#---#-#---#---#-#---#---#-#---#---#-#---#---#-#---#---#-#-
--#--#--#---#--#--#---#--#--#---#--#--#---#--#--#---#--#--#---#--#--#---#--#--#---#--#--#---#--#--#-
---#-##------#-##------#-##------#-##------#-##------#-##------#-##------#-##------#-##------#-##---
----#-##------#-##------#-##------#-##------#-##------#-##------#-##------#-##------#-##------#-##--
#------##-#------##-#------##-#------##-#------##-#------##-#------##-#------##-#------##-#------##-
---#-----#---#-----#---#-----#---#-----#---#-----#---#-----#---#-----#---#-----#---#-----#---#-----#
---#---------#---------#---------#---------#---------#---------#---------#---------#---------#------
###---#---###---#---###---#---###---#---###---#---###---#---###---#---###---#---###---#---###---#---
-------#---------#---------#---------#---------#---------#---------#---------#---------#---------#--
-#----#--#-#----#--#-#----#--#-#----#--#-#----#--#-#----#--#-#----#--#-#----#--#-#----#--#-#----#--#
--#---#-#---#---#-#---#---#-#---#---#-#---#---#-#---#---#-#---#---#-#---#---#-#---#---#-#---#---#-#-
--#--#--#---#--#--#---#--#--#---#--#--#---#--#--#---#--#--#---#--#--#---#--#--#---#--#--#---#--#--#-
---#-##------#-##------#-##------#-##------#-##------#-##------#-##------#-##------#-##------#-##---
----#-##------#-##------#-##------#-##------#-##------#-##------#-##------#-##------#-##------#-##--
#------##-#------##-#------##-#------##-#------##-#------##-#------##-#------##-#------##-#------##-
---#-----#---#-----#---#-----#---#-----#---#-----#---#-----#---#-----#---#-----#---#-----#---#-----#
---#---------#---------#---------#---------#---------#---------#---------#---------#---------#------
###---#---###---#---###---#---###---#---###---#---###---#---###---#---###---#---###---#---###---#---
-------#---------#---------#---------#---------#---------#---------#---------#---------#---------#--
-#----#--#-#----#--#-#----#--#-#----#--#-#----#--#-#----#--#-#----#--#-#----#--#-#----#--#-#----#--#
--#---#-#---#---#-#---#---#-#---#---#-#---#---#-#---#---#-#---#---#-#---#---#-#---#---#-#---#---#-#-
--#--#--#---#--#--#---#--#--#---#--#--#---#--#--#---#--#--#---#--#--#---#--#--#---#--#--#---#--#--#-
---#-##------#-##------#-##------#-##------#-##------#-##------#-##------#-##------#-##------#-##---
----#-##------#-##------#-##------#-##------#-##------#-##------#-##------#-##------#-##------#-##--
#------##-#------##-#------##-#------##-#------##-#------##-#------##-#------##-#------##-#------##-
---#-----#---#-----#---#-----#---#-----#---#-----#---#-----#---#-----#---#-----#---#-----#---#-----#
---#---------#---------#---------#---------#---------#---------#---------#---------#---------#------
###---#---###---#---###---#---###---#---###---#---###---#---###---#---###---#---###---#---###---#---
-------#---------#---------#---------#---------#---------#---------#---------#---------#---------#--
-#----#--#-#----#--#-#----#--#-#----#--#-#----#--#-#----#--#-#----#--#-#----#--#-#----#--#-#----#--#
--#---#-#---#---#-#---#---#-#---#---#-#---#---#-#---#---#-#---#---#-#---#---#-#---#---#-#---#---#-#-
--#--#--#---#--#--#---#--#--#---#--#--#---#--#--#---#--#--#---#--#--#---#--#--#---#--#--#---#--#--#-
---#-##------#-##------#-##------#-##------#-##------#-##------#-##------#-##------#-##------#-##---
----#-##------#-##------#-##------#-##------#-##------#-##------#-##------#-##------#-##------#-##--
#------##-#------##-#------##-#------##-#------##-#------##-#------##-#------##-#------##-#------##-
---#-----#---#-----#---#-----#---#-----#---#-----#---#-----#---#-----#---#-----#---#-----#---#-----#
---#---------#---------#---------#---------#---------#---------#---------#---------#---------#------
###---#---###---#---###---#---###---#---###---#---###---#---###---#---###---#---###---#---###---#---
-------#---------#---------#---------#---------#---------#---------#---------#---------#---------#--
-#----#--#-#----#--#-#----#--#-#----#--#-#----#--#-#----#--#-#----#--#-#----#--#-#----#--#-#----#--#
--#---#-#---#---#-#---#---#-#---#---#-#---#---#-#---#---#-#---#---#-#---#---#-#---#---#-#---#---#-#-
--#--#-S#---#--#--#---#--#--#---#--#--#---#--#--#---#--#--#---#--#--#---#--#--#---#--#--#---#--#--#-
---#-##------#-##------#-##------#-##------#-##------#-##------#-##------#-##------#-##------#-##---
----#-##------#-##------#-##------#-##------#-##------#-##------#-##------#-##------#-##------#-##--
#------##-#------##-#------##-#------##-#------##-#------##-#------##-#------##-#------##-#------##-
---#-----#---#-----#---#-----#---#-----#---#-----#---#-----#---#-----#---#-----#---#-----#---#-----#
---#---------#---------#---------#---------#---------#---------#---------#---------#---------#------
###---#---###---#---###---#---###---#---###---#---###---#---###---#---###---#---###---#---###---#---
-------#---------#---------#---------#---------#---------#---------#---------#---------#---------#--
-#----#--#-#----#--#-#----#--#-#----#--#-#----#--#-#----#--#-#----#--#-#----#--#-#----#--#-#----#--#
--#---#-#---#---#-#---#---#-#---#---#-#---#---#-#---#---#-#---#---#-#---#---#-#---#---#-#---#---#-#-
--#--#--#---#--#--#---#--#--#---#--#--#---#--#--#---#--#--#---#--#--#---#--#--#---#--#--#---#--#--#-
---#-##------#-##------#-##------#-##------#-##------#-##------#-##------#-##------#-##------#-##---
----#-##------#-##------#-##------#-##------#-##------#-##------#-##------#-##------#-##------#-##--
#------##-#------##-#------##-#------##-#------##-#------##-#------##-#------##-#------##-#------##-
---#-----#---#-----#---#-----#---#-----#---#-----#---#-----#---#-----#---#-----#---#-----#---#-----#
---#---------#---------#---------#---------#---------#---------#---------#---------#---------#------
###---#---###---#---###---#---###---#---###---#---###---#---###---#---###---#---###---#---###---#---
-------#---------#---------#---------#---------#---------#---------#---------#---------#E--------#--
-#----#--#-#----#--#-#----#--#-#----#--#-#----#--#-#----#--#-#----#--#-#----#--#-#----#--#-#----#--#
