#----#--###----#--###----#--###----#--###----#--###----#--###----#--###----#--###----#--###----#--##
---#---------#---------#---------#---------#---------#---------#---------#---------#---------#------
#--####---#--####---#--####---#--####---#--####---#--####---#--####---#--####---#--####---#--####---
-###---#---###---#---###---#---###---#---###---#---###---#---###---#---###---#---###---#---###---#--
-----#--##-----#--##-----#--##-----#--##-----#--##-----#--##-----#--##-----#--##-----#--##-----#--##
----------------------------------------------------------------------------------------------------
-----#---------#---------#---------#---------#---------#---------#---------#---------#---------#----
#---##-#-##---##-#-##---##-#-##---##-#-##---##-#-##---##-#-##---##-#-##---##-#-##---##-#-##---##-#-#
-#--#-##---#--#-##---#--#-##---#--#-##---#--#-##---#--#-##---#--#-##---#--#-##---#--#-##---#--#-##--
-------#---------#---------#---------#---------#---------#---------#---------#---------#---------#--
#----#--###----#--###----#--###----#--###----#--###----#--###----#--###----#--###----#--###----#--##
---#---------#---------#---------#---------#---------#---------#---------#---------#---------#------
#--####---#--####---#--####---#--####---#--####---#--####---#--####---#--####---#--####---#--####---
-###---#---###---#---###---#---###---#---###---#---###---#---###---#---###---#---###---#---###---#--
-----#--##-----#--##-----#--##-----#--##-----#--##-----#--##-----#--##-----#--##-----#--##-----#--##
----------------------E-----------------------------------------------------------------------------
-----#---------#---------#---------#---------#---------#---------#---------#---------#---------#----
#---##-#-##---##-#-##---##-#-##---##-#-##---##-#-##---##-#-##---##-#-##---##-#-##---##-#-##---##-#-#
-#--#-##---#--#-##---#--#-##---#--#-##---#--#-##---#--#-##---#--#-##---#--#-##---#--#-##---#--#-##--
-------#---------#---------#---------#---------#---------#---------#---------#---------#---------#--
#----#--###----#--###----#--###----#--###----#--###----#--###----#--###----#--###----#--###----#--##
---#---------#---------#---------#---------#---------#---------#---------#---------#---------#------
#--####---#--####---#--####---#--####---#--####---#--####---#--####---#--####---#--####---#--####---
-###---#---###---#---###---#---###---#---###---#---###---#---###---#---###---#---###---#---###---#--
-----#--##-----#--##-----#--##-----#--##-----#--##-----#--##-----#--##-----#--##-----#--##-----#--##
----------------------------------------------------------------------------------------------------
-----#---------#---------#---------#---------#---------#---------#---------#---------#---------#----
#---##-#-##---##-#-##---##-#-##---##-#-##---##-#-##---##-#-##---##-#-##---##-#-##---##-#-##---##-#-#
S#--#-##---#--#-##---#--#-##---#--#-##---#--#-##---#--#-##---#--#-##---#--#-##---#--#-##---#--#-##--
-------#---------#---------#---------#---------#---------#---------#---------#---------#---------#--
#----#--###----#--###----#--###----#--###----#--###----#--###----#--###----#--###----#--###----#--##
---#---------#---------#---------#---------#---------#---------#---------#---------#---------#------
#--####---#--####---#--####---#--####---#--####---#--####---#--####---#--####---#--####---#--####---
-###---#---###---#---###---#---###---#---###---#---###---#---###---#---###---#---###---#---###---#--
-----#--##-----#--##-----#--##-----#--##-----#--##-----#--##-----#--##-----#--##-----#--##-----#--##
----------------------------------------------------------------------------------------------------
-----#---------#---------#---------#---------#---------#---------#---------#---------#---------#----
#---##-#-##---##-#-##---##-#-##---##-#-##---##-#-##---##-#-##---##-#-##---##-#-##---##-#-##---##-#-#
-#--#-##---#--#-##---#--#-##---#--#-##---#--#-##---#--#-##---#--#-##---#--#-##---#--#-##---#--#-##--
-------#---------#---------#---------#---------#---------#---------#---------#---------#---------#--
#----#--###----#--###----#--###----#--###----#--###----#--###----#--###----#--###----#--###----#--##
---#---------#---------#---------#---------#---------#---------#---------#---------#---------#------
#--####---#--####---#--####---#--####---#--####---#--####---#--####---#--####---#--####---#--####---
-###---#---###---#---###---#---###---#---###---#---###---#---###---#---###---#---###---#---###---#--
-----#--##-----#--##-----#--##-----#--##-----#--##-----#--##-----#--##-----#--##-----#--##-----#--##
----------------------------------------------------------------------------------------------------
-----#---------#---------#---------#---------#---------#---------#---------#---------#---------#----
#---##-#-##---##-#-##---##-#-##---##-#-##---##-#-##---##-#-##---##-#-##---##-#-##---##-#-##---##-#-#
-#--#-##---#--#-##---#--#-##---#--#-##---#--#-##---#--#-##---#--#-##---#--#-##---#--#-##---#--#-##--
-------#---------#---------#---------#---------#---------#---------#---------#---------#---------#--
#----#--###----#--###----#--###----#--###----#--###----#--###----#--###----#--###----#--###----#--##
---#---------#---------#---------#---------#---------#---------#---------#---------#---------#------
#--####---#--####---#--####---#--####---#--####---#--####---#--####---#--####---#--####---#--####---
-###---#---###---#---###---#---###---#---###---#---###---#---###---#---###---#---###---#---###---#--
-----#--##-----#--##-----#--##-----#--##-----#--##-----#--##-----#--##-----#--##-----#--##-----#--##
----------------------------------------------------------------------------------------------------
-----#---------#---------#---------#---------#---------#---------#---------#---------#---------#----
#---##-#-##---##-#-##---##-#-##---##-#-##---##-#-##---##-#-##---##-#-##---##-#-##---##-#-##---##-#-#
-#--#-##---#--#-##---#--#-##---#--#-##---#--#-##---#--#-##---#--#-##---#--#-##---#--#-##---#--#-##--
-------#---------#---------#---------#---------#---------#---------#---------#---------#---------#--
#----#--###----#--###----#--###----#--###----#--###----#--###----#--###----#--###----#--###----#--##
---#---------#---------#---------#---------#---------#---------#---------#---------#---------#------
#--####---#--####---#--####---#--####---#--####---#--####---#--####---#--####---#--####---#--####---
-###---#---###---#---###---#---###---#---###---#---###---#---###---#---###---#---###---#---###---#--
-----#--##-----#--##-----#--##-----#--##-----#--##-----#--##-----#--##-----#--##-----#--##-----#--##
----------------------------------------------------------------------------------------------------
-----#---------#---------#---------#---------#---------#---------#---------#---------#---------#----
#---##-#-##---##-#-##---##-#-##---##-#-##---##-#-##---##-#-##---##-#-##---##-#-##---##-#-##---##-#-#
-#--#-##---#--#-##---#--#-##---#--#-##---#--#-##---#--#-##---#--#-##---#--#-##---#--#-##---#--#-##--
-------#---------#---------#---------#---------#---------#---------#---------#---------#---------#--
#----#--###----#--###----#--###----#--###----#--###----#--###----#--###----#--###----#--###----#--##
---#---------#---------#---------#---------#---------#---------#---------#---------#---------#------
#--####---#--####---#--####---#--####---#--####---#--####---#--####---#--####---#--####---#--####---
-###---#---###---#---###---#---###---#---###---#---###---#---###---#---###---#---###---#---###---#--
-----#--##-----#--##-----#--##-----#--##-----#--##-----#--##-----#--##-----#--##-----#--##-----#--##
----------------------------------------------------------------------------------------------------
-----#---------#---------#---------#---------#---------#---------#---------#---------#---------#----
#---##-#-##---##-#-##---##-#-##---##-#-##---##-#-##---##-#-##---##-#-##---##-#-##---##-#-##---##-#-#
-#--#-##---#--#-##---#--#-##---#--#-##---#--#-##---#--#-##---#--#-##---#--#-##---#--#-##---#--#-##--
-------#---------#---------#---------#---------#---------#---------#---------#---------#---------#--
#----#--###----#--###----#--###----#--###----#--###----#--###----#--###----#--###----#--###----#--##
---#---------#---------#---------#---------#---------#---------#---------#---------#---------#------
#--####---#--####---#--####---#--####---#--####---#--####---#--####---#--####---#--####---#--####---
-###---#---###---#---###---#---###---#---###---#---###---#---###---#---###---#---###---#---###---#--
-----#--##-----#--##-----#--##-----#--##-----#--##-----#--##-----#--##-----#--##-----#--##-----#--##
----------------------------------------------------------------------------------------------------
-----#---------#---------#---------#---------#---------#---------#---------#---------#---------#----
#---##-#-##---##-#-##---##-#-##---##-#-##---##-#-##---##-#-##---##-#-##---##-#-##---##-#-##---##-#-#
-#--#-##---#--#-##---#--#-##---#--#-##---#--#-##---#--#-##---#--#-##---#--#-##---#--#-##---#--#-##--
-------#---------#---------#---------#---------#---------#---------#---------#---------#---------#--
#----#--###----#--###----#--###----#--###----#--###----#--###----#--###----#--###----#--###----#--##
---#---------#---------#---------#---------#---------#---------#---------#---------#---------#------
#--####---#--####---#--####---#--####---#--####---#--####---#--####---#--####---#--####---#--####---
-###---#---###---#---###---#---###---#---###---#---###---#---###---#---###---#---###---#---###---#--
-----#--##-----#--##-----#--##-----#--##-----#--##-----#--##-----#--##-----#--##-----#--##-----#--##
----------------------------------------------------------------------------------------------------
-----#---------#---------#---------#---------#---------#---------#---------#---------#---------#----
#---##-#-##---##-#-##---##-#-##---##-#-##---##-#-##---##-#-##---##-#-##---##-#-##---##-#-##---##-#-#
-#--#-##---#--#-##---#--#-##---#--#-##---#--#-##---#--#-##---#--#-##---#--#-##---#--#-##---#--#-##--
-------#---------#---------#---------#---------#---------#---------#---------#---------#---------#--
