##----#-#-##----#-#-##----#-#-##----#-#-##----#-#-##----#-#-##----#-#-##----#-#-##----#-#-##----#-#-
#--#------#--#------#--#------#--#------#--#------#--#------#--#------#--#------#--#------#--#------
-#---##----#---##----#---##----#---##----#---##----#---##----#---##----#---##----#---##----#---##---
#-#-#-#---#-#-#-#---#-#-#-#---#-#-#-#---#-#-#-#---#-#-#-#---#-#-#-#---#-#-#-#---#-#-#-#---#-#-#-#---
-#---------#---------#---------#---------#---------#---------#---------#---------#---------#--------
---##--------##--------##--------##--------##--------##--------##--------##--------##--------##-----
-------#---------#---------#---------#---------#---------#---------#---------#---------#---------#--
-###-#-----###-#-----###-#-----###-#-----###-#-----###-#-----###-#-----###-#-----###-#-----###-#----
----#--#-#----#--#-#----#--#-#----#--#-#----#--#-#----#--#-#----#--#-#----#--#-#----#--#-#----#--#-#
--#----#----#----#----#----#----#----#----#----#----#----#----#----#----#----#----#----#----#----#--
##----#-#-##----#-#-##----#-#-##----#-#-##----#-#-##----#-#-##----#-#-##----#-#-##----#-#-##----#-#-
#--#------#--#------#--#------#--#------#--#------#--#------#--#------#--#------#--#------#--#------
-#---##----#---##----#---##----#---##----#---##----#---##----#---##----#---##----#---##----#---##---
#-#-#-#---#-#-#-#---#-#-#-#---#-#-#-#---#-#-#-#---#-#-#-#---#-#-#-#---#-#-#-#---#-#-#-#---#-#-#-#---
-#---------#---------#---------#---------#---------#---------#---------#---------#---------#--------
---##--------##--------##--------##--------##--------##--------##--------##--------##--------##-----
-------#---------#E--------#---------#---------#---------#---------#---------#---------#---------#--
-###-#-----###-#-----###-#-----###-#-----###-#-----###-#-----###-#-----###-#-----###-#-----###-#----
----#--#-#----#--#-#----#--#-#----#--#-#----#--#-#----#--#-#----#--#-#----#--#-#----#--#-#----#--#-#
--#----#----#----#----#----#----#----#----#----#----#----#----#----#----#----#----#----#----#----#--
##----#-#-##----#-#-##----#-#-##----#-#-##----#-#-##----#-#-##----#-#-##----#-#-##----#-#-##----#-#-
#--#------#--#------#--#------#--#------#--#------#--#------#--#------#--#------#--#------#--#------
-#---##----#---##----#---##----#---##----#---##----#---##----#---##----#---##----#---##----#---##---
#-#-#-#---#-#-#-#---#-#-#-#---#-#-#-#---#-#-#-#---#-#-#-#---#-#-#-#---#-#-#-#---#-#-#-#---#-#-#-#---
-#---------#---------#---------#---------#---------#---------#---------#---------#---------#--------
---##--------##--------##--------##--------##--------##--------##--------##--------##--------##-----
-------#---------#---------#---------#---------#---------#---------#---------#---------#---------#--
-###-#-----###-#-----###-#-----###-#-----###-#-----###-#-----###-#-----###-#-----###-#-----###-#----
----#--#-#----#--#-#----#--#-#----#--#-#----#--#-#----#--#-#----#--#-#----#--#-#----#--#-#----#--#-#
--#----#----#----#----#----#----#----#----#----#----#----#----#----#----#----#----#----#----#----#--
##----#-#-##----#-#-##----#-#-##----#-#-##----#-#-##----#-#-##----#-#-##----#-#-##----#-#-##----#-#-
#--#------#--#------#--#------#--#------#--#------#--#------#--#------#--#------#--#------#--#------
-#---##----#---##----#---##----#---##----#---##----#---##----#---##----#---##----#---##----#---##---
#-#-#-#---#-#-#-#---#-#-#-#---#-#-#-#---#-#-#-#---#-#-#-#---#-#-#-#---#-#-#-#---#-#-#-#---#-#-#-#---
-#---------#---------#---------#---------#---------#---------#---------#---------#---------#--------
---##--------##--------##--------##--------##--------##--------##--------##--------##--------##-----
-------#---------#---------#---------#---------#---------#---------#---------#---------#---------#--
-###-#-----###-#-----###-#-----###-#-----###-#-----###-#-----###-#-----###-#-----###-#-----###-#----
----#--#-#----#--#-#----#--#-#----#--#-#----#--#-#----#--#-#----#--#-#----#--#-#----#--#-#----#--#-#
--#----#----#----#----#----#----#----#----#----#----#----#----#----#----#----#----#----#----#----#--
##----#-#-##----#-#-##----#-#-##----#-#-##----#-#-##----#-#-##----#-#-##----#-#-##----#-#-##----#-#-
#--#------#--#------#--#------#--#------#--#------#--#------#--#------#--#------#--#------#--#------
-#---##----#---##----#---##----#---##----#---##----#---##----#---##----#---##----#---##----#---##---
#-#-#-#---#-#-#-#---#-#-#-#---#-#-#-#---#-#-#-#---#-#-#-#---#-#-#-#---#-#-#-#---#-#-#-#---#-#-#-#---
-#---------#---------#---------#---------#---------#---------#---------#---------#---------#--------
---##--------##--------##--------##--------##--------##--------##--------##--------##--------##-----
-------#---------#---------#---------#---------#---------#---------#---------#---------#---------#--
-###-#-----###-#-----###-#-----###-#-----###-#-----###-#-----###-#-----###-#-----###-#-----###-#----
----#--#-#----#--#-#----#--#-#----#--#-#----#--#-#----#--#-#----#--#-#----#--#-#----#--#-#----#--#-#
--#----#----#----#----#----#----#----#----#----#----#----#----#----#----#----#----#----#----#----#--
##----#-#-##----#-#-##----#-#-##----#-#-##----#-#-##----#-#-##----#-#-##----#-#-##----#-#-##----#-#-
#--#------#--#------#--#------#S-#------#--#------#--#------#--#------#--#------#--#------#--#------
-#---##----#---##----#---##----#---##----#---##----#---##----#---##----#---##----#---##----#---##---
#-#-#-#---#-#-#-#---#-#-#-#---#-#-#-#---#-#-#-#---#-#-#-#---#-#-#-#---#-#-#-#---#-#-#-#---#-#-#-#---
-#---------#---------#---------#---------#---------#---------#---------#---------#---------#--------
---##--------##--------##--------##--------##--------##--------##--------##--------##--------##-----
-------#---------#---------#---------#---------#---------#---------#---------#---------#---------#--
-###-#-----###-#-----###-#-----###-#-----###-#-----###-#-----###-#-----###-#-----###-#-----###-#----
----#--#-#----#--#-#----#--#-#----#--#-#----#--#-#----#--#-#----#--#-#----#--#-#----#--#-#----#--#-#
--#----#----#----#----#----#----#----#----#----#----#----#----#----#----#----#----#----#----#----#--
##----#-#-##----#-#-##----#-#-##----#-#-##----#-#-##----#-#-##----#-#-##----#-#-##----#-#-##----#-#-
#--#------#--#------#--#------#--#------#--#------#--#------#--#------#--#------#--#------#--#------
-#---##----#---##----#---##----#---##----#---##----#---##----#---##----#---##----#---##----#---##---
#-#-#-#---#-#-#-#---#-#-#-#---#-#-#-#---#-#-#-#---#-#-#-#---#-#-#-#---#-#-#-#---#-#-#-#---#-#-#-#---
-#---------#---------#---------#---------#---------#---------#---------#---------#---------#--------
---##--------##--------##--------##--------##--------##--------##--------##--------##--------##-----
-------#---------#---------#---------#---------#---------#---------#---------#---------#---------#--
-###-#-----###-#-----###-#-----###-#-----###-#-----###-#-----###-#-----###-#-----###-#-----###-#----
----#--#-#----#--#-#----#--#-#----#--#-#----#--#-#----#--#-#----#--#-#----#--#-#----#--#-#----#--#-#
--#----#----#----#----#----#----#----#----#----#----#----#----#----#----#----#----#----#----#----#--
##----#-#-##----#-#-##----#-#-##----#-#-##----#-#-##----#-#-##----#-#-##----#-#-##----#-#-##----#-#-
#--#------#--#------#--#------#--#------#--#------#--#------#--#------#--#------#--#------#--#------
-#---##----#---##----#---##----#---##----#---##----#---##----#---##----#---##----#---##----#---##---
#-#-#-#---#-#-#-#---#-#-#-#---#-#-#-#---#-#-#-#---#-#-#-#---#-#-#-#---#-#-#-#---#-#-#-#---#-#-#-#---
-#---------#---------#---------#---------#---------#---------#---------#---------#---------#--------
---##--------##--------##--------##--------##--------##--------##--------##--------##--------##-----
-------#---------#---------#---------#---------#---------#---------#---------#---------#---------#--
-###-#-----###-#-----###-#-----###-#-----###-#-----###-#-----###-#-----###-#-----###-#-----###-#----
----#--#-#----#--#-#----#--#-#----#--#-#----#--#-#----#--#-#----#--#-#----#--#-#----#--#-#----#--#-#
--#----#----#----#----#----#----#----#----#----#----#----#----#----#----#----#----#----#----#----#--
##----#-#-##----#-#-##----#-#-##----#-#-##----#-#-##----#-#-##----#-#-##----#-#-##----#-#-##----#-#-
#--#------#--#------#--#------#--#------#--#------#--#------#--#------#--#------#--#------#--#------
-#---##----#---##----#---##----#---##----#---##----#---##----#---##----#---##----#---##----#---##---
#-#-#-#---#-#-#-#---#-#-#-#---#-#-#-#---#-#-#-#---#-#-#-#---#-#-#-#---#-#-#-#---#-#-#-#---#-#-#-#---
-#---------#---------#---------#---------#---------#---------#---------#---------#---------#--------
---##--------##--------##--------##--------##--------##--------##--------##--------##--------##-----
-------#---------#---------#---------#---------#---------#---------#---------#---------#---------#--
-###-#-----###-#-----###-#-----###-#-----###-#-----###-#-----###-#-----###-#-----###-#-----###-#----
----#--#-#----#--#-#----#--#-#----#--#-#----#--#-#----#--#-#----#--#-#----#--#-#----#--#-#----#--#-#
--#----#----#----#----#----#----#----#----#----#----#----#----#----#----#----#----#----#----#----#--
##----#-#-##----#-#-##----#-#-##----#-#-##----#-#-##----#-#-##----#-#-##----#-#-##----#-#-##----#-#-
#--#------#--#------#--#------#--#------#--#------#--#------#--#------#--#------#--#------#--#------
-#---##----#---##----#---##----#---##----#---##----#---##----#---##----#---##----#---##----#---##---
#-#-#-#---#-#-#-#---#-#-#-#---#-#-#-#---#-#-#-#---#-#-#-#---#-#-#-#---#-#-#-#---#-#-#-#---#-#-#-#---
-#---------#---------#---------#---------#---------#---------#---------#---------#---------#--------
---##--------##--------##--------##--------##--------##--------##--------##--------##--------##-----
-------#---------#---------#---------#---------#---------#---------#---------#---------#---------#--
-###-#-----###-#-----###-#-----###-#-----###-#-----###-#-----###-#-----###-#-----###-#-----###-#----
----#--#-#----#--#-#----#--#-#----#--#-#----#--#-#----#--#-#----#--#-#----#--#-#----#--#-#----#--#-#
--#----#----#----#----#----#----#----#----#----#----#----#----#----#----#----#----#----#----#----#--
