--#-#--##---#-#--##---#-#--##---#-#--##---#-#--##---#-#--##---#-#--##---#-#--##---#-#--##---#-#--##-
-##-#---#--##-#---#--##-#---#--##-#---#--##-#---#--##-#---#--##-#---#--##-#---#--##-#---#--##-#---#-
--#--#-#----#--#-#----#--#-#----#--#-#----#--#-#----#--#-#----#--#-#----#--#-#----#--#-#----#--#-#--
--##-#--#---##-#--#---##-#--#---##-#--#---##-#--#---##-#--#---##-#--#---##-#--#---##-#--#---##-#--#-
-##-#------##-#------##-#------##-#------##-#------##-#------##-#------##-#------##-#------##-#-----
-###---#---###---#---###---#---###---#---###---#---###---#---###---#---###---#---###---#---###---#--
----------------------------------------------------------------------------------------------------
---##--------##--------##--------##--------##--------##--------##--------##--------##--------##-----
----------------------------------------------------------------------------------------------------
-#---#--#--#---#--#--#---#--#--#---#--#--#---#--#--#---#--#--#---#--#--#---#--#--#---#--#--#---#--#-
--#-#--##---#-#--##---#-#--##---#-#--##---#-#--##---#-#--##---#-#--##---#-#--##---#-#--##---#-#--##-
-##-#---#--##-#---#--##-#---#--##-#---#--##-#---#--##-#---#--##-#---#--##-#---#--##-#---#--##-#---#-
--#--#-#----#--#-#----#--#-#----#--#-#----#--#-#----#--#-#----#--#-#----#--#-#----#--#-#----#--#-#--
--##-#--#---##-#--#---##-#--#---##-#--#---##-#--#---##-#--#---##-#--#---##-#--#---##-#--#---##-#--#-
-##-#------##-#------##-#------##-#------##-#------##-#------##-#------##-#------##-#------##-#-----
-###---#---###---#---###---#---###---#---###---#---###---#---###---#---###---#---###---#---###---#--
----------------------------------------------------------------------------------------------------
---##--------##--------##--------##--------##--------##--------##--------##--------##--------##-----
----------------------------------------------------------------------------------------------------
-#---#--#--#---#--#--#---#--#--#---#--#--#---#--#--#---#--#--#---#--#--#---#--#--#---#--#--#---#--#-
--#-#--##---#-#--##---#-#--##---#-#--##---#-#--##---#-#--##---#-#--##---#-#--##---#-#--##---#-#--##-
-##-#---#--##-#---#--##-#---#--##-#---#--##-#---#--##-#---#--##-#---#--##-#---#--##-#---#--##-#---#-
--#--#-#----#--#-#----#--#-#----#--#-#----#--#-#----#--#-#----#--#-#----#--#-#----#--#-#----#--#-#--
--##-#--#---##-#--#---##-#--#---##-#--#---##-#--#---##-#--#---##-#--#---##-#--#---##-#--#---##-#--#-
-##-#------##-#------##-#------##-#------##-#------##-#------##-#------##-#------##-#------##-#-----
-###---#---###---#---###---#---###---#---###---#---###---#---###---#---###---#---###---#---###---#--
----------------------------------------------------------------------------------------------------
---##--------##--------##--------##--------##--------##--------##--------##--------##--------##-----
----------------------------------------------------------------------------------------------------
-#---#--#--#---#--#--#---#--#--#---#--#--#---#--#--#---#--#--#---#--#--#---#--#--#---#--#--#---#--#-
--#-#--##---#-#--##---#-#--##---#-#--##---#-#--##---#-#--##---#-#--##---#-#--##---#-#--##---#-#--##-
-##-#---#--##-#---#--##-#---#--##-#---#--##-#---#--##-#---#--##-#---#--##-#---#--##-#---#--##-#---#-
--#--#-#----#--#-#----#--#-#----#--#-#----#--#-#----#--#-#----#--#-#----#--#-#----#--#-#----#--#-#--
--##-#--#---##-#--#---##-#--#---##-#--#---##-#--#---##-#--#---##-#--#---##-#--#---##-#--#---##-#--#-
-##-#------##-#------##-#------##-#------##-#------##-#------##-#------##-#------##-#------##-#-----
-###---#---###---#---###---#---###---#---###---#---###---#---###---#---###---#---###---#---###---#--
----------------------------------------------------------------------------------------------------
---##--------##--------##--------##--------##--------##--------##--------##--------##--------##-----
----------------------------------------------------------------------------------------------------
-#---#--#--#---#--#--#---#--#--#---#--#--#---#--#--#---#--#--#---#--#--#---#--#--#---#--#--#---#--#-
--#-#--##---#-#--##---#-#--##---#-#--##---#-#--##---#-#--##---#-#--##---#-#--##---#-#--##---#-#--##-
-##-#---#--##-#---#--##-#---#--##-#---#--##-#---#--##-#---#--##-#---#--##-#---#--##-#---#--##-#---#-
--#--#-#----#--#-#----#--#-#----#--#-#----#--#-#----#--#-#----#--#-#----#--#-#----#--#-#----#--#-#--
--##-#--#---##-#--#---##-#--#---##-#--#---##-#--#---##-#--#---##-#--#---##-#--#---##-#--#---##-#--#-
-##-#------##-#------##-#------##-#------##-#------##-#------##-#------##-#------##-#------##-#-----
-###---#---###---#---###---#---###---#---###---#---###---#---###---#---###---#---###---#---###---#--
----------------------------------------------------------------------------------------------------
---##--------##--------##--------##--------##--------##--------##--------##--------##--------##-----
----------------------------------------------------------------------------------------------------
-#---#--#--#---#--#--#---#--#--#---#--#--#---#--#--#---#--#--#---#--#--#---#--#--#---#--#--#---#--#-
--#-#--##---#-#--##---#-#--##---#-#--##---#-#--##---#-#--##---#-#--##---#-#--##---#-#--##---#-#--##-
-##-#---#--##-#---#--##-#---#--##-#---#--##-#---#--##-#---#--##-#---#--##-#---#--##-#---#--##-#---#-
--#--#-#----#--#-#----#--#-#----#--#-#----#--#-#----#--#-#----#--#-#----#--#-#----#--#-#----#--#-#--
--##-#--#---##-#--#---##-#--#---##-#--#---##-#--#---##-#--#---##-#--#---##-#--#---##-#--#---##-#--#-
-##-#------##-#------##-#------##-#------##-#------##-#------##-#------##-#------##-#------##-#-----
-###---#---###---#---###---#---###---#---###---#---###---#---###---#---###---#---###---#---###---#--
----------------------------------------------------------------------------------------------------
---##--------##--------##--------##--------##--------##--------##--------##--------##--------##-----
----------------------------------------------------------------------------------------------------
-#---#--#--#---#--#--#---#--#--#---#--#--#---#--#--#---#--#--#---#--#--#---#--#--#---#--#--#---#--#-
--#-#--##---#-#--##---#-#--##---#-#--##---#-#--##---#-#--##---#-#--##---#-#--##---#-#--##---#-#--##-
-##-#---#--##-#---#--##-#---#--##-#---#--##-#---#--##-#---#--##-#---#--##-#---#--##-#---#--##-#---#-
--#--#-#----#--#-#----#--#-#----#--#-#----#--#-#----#--#-#----#--#-#----#--#-#----#--#-#----#--#-#--
--##-#--#---##-#--#---##-#--#---##-#--#---##-#--#---##-#--#---##-#--#---##-#--#---##-#--#---##-#--#-
-##-#------##-#------##-#------##-#------##-#------##-#------##-#------##-#------##-#------##-#-----
-###---#---###---#---###---#---###---#---###---#---###---#---###---#---###---#---###---#---###---#--
----------------------------------------------------------------------------------------------------
---##--------##--------##--------##--------##--------##--------##--------##--------##--------##-----
----------------------------------------------------------------------------------------------------
-#---#--#--#---#--#--#---#--#--#---#--#--#---#--#--#---#--#--#---#--#--#---#--#--#---#--#--#---#--#-
--#-#--##---#-#--##---#-#--##---#-#--##---#-#--##---#-#--##---#-#--##---#-#--##---#-#--##---#-#--##-
-##-#---#--##-#---#--##-#---#--##-#---#--##-#---#--##-#---#--##-#---#--##-#---#--##-#---#--##-#---#-
--#--#-#----#--#-#----#--#-#----#--#-#----#--#-#----#--#-#----#--#-#----#--#-#----#--#-#----#--#-#--
--##-#--#---##-#--#---##-#--#---##-#--#---##-#--#---##-#--#---##-#--#---##-#--#---##-#--#---##-#--#-
-##-#------##-#------##-#------##-#------##-#------##-#------##-#------##-#------##-#------##-#-----
-###---#---###---#---###---#---###---#---###---#---###---#---###---#---###---#---###---#---###---#--
----------------------------------------------------------------------------------------------------
---##--------##--------##--------##--------##--------##--------##--------##--------##--------##-----
----------------------------------------------------------------------------------------------------
-#---#--#--#---#--#--#---#--#--#---#--#--#---#--#--#---#--#--#---#--#--#---#--#--#---#--#--#---#--#-
--#-#--##---#-#--##---#-#--##---#-#--##---#-#--##---#-#--##---#-#--##---#-#--##---#-#--##---#-#--##-
-##-#---#--##-#---#--##-#---#--##-#---#--##-#---#--##-#---#--##-#---#--##-#---#--##-#---#--##-#---#-
--#--#-#----#--#-#----#--#-#----#--#-#----#--#-#----#--#-#----#--#-#----#--#-#----#--#-#----#--#-#--
--##-#--#---##-#--#---##-#--#---##-#--#---##-#--#---##-#--#---##-#--#---##-#--#---##-#--#---##-#--#-
-##-#------##-#E-----##-#------##-#------##-#------##-#------##-#------##-#------##-#------##-#-----
-###---#---###---#---###---#---###---#---###---#---###---#---###---#---###---#---###---#---###---#--
----------------------------------------------------------------------------------------------------
---##--S-----##--------##--------##--------##--------##--------##--------##--------##--------##-----
----------------------------------------------------------------------------------------------------
-#---#--#--#---#--#--#---#--#--#---#--#--#---#--#--#---#--#--#---#--#--#---#--#--#---#--#--#---#--#-
--#-#--##---#-#--##---#-#--##---#-#--##---#-#--##---#-#--##---#-#--##---#-#--##---#-#--##---#-#--##-
-##-#---#--##-#---#--##-#---#--##-#---#--##-#---#--##-#---#--##-#---#--##-#---#--##-#---#--##-#---#-
--#--#-#----#--#-#----#--#-#----#--#-#----#--#-#----#--#-#----#--#-#----#--#-#----#--#-#----#--#-#--
--##-#--#---##-#--#---##-#--#---##-#--#---##-#--#---##-#--#---##-#--#---##-#--#---##-#--#---##-#--#-
-##-#------##-#------##-#------##-#------##-#------##-#------##-#------##-#------##-#------##-#-----
-###---#---###---#---###---#---###---#---###---#---###---#---###---#---###---#---###---#---###---#--
----------------------------------------------------------------------------------------------------
---##--------##--------##--------##--------##--------##--------##--------##--------##--------##-----
----------------------------------------------------------------------------------------------------
-#---#--#--#---#--#--#---#--#--#---#--#--#---#--#--#---#--#--#---#--#--#---#--#--#---#--#--#---#--#-
