----#-#--#----#-#--#----#-#--#----#-#--#----#-#--#----#-#--#----#-#--#----#-#--#----#-#--#----#-#--#
-----##--------##--------##--------##--------##--------##--------##--------##--------##--------##---
-----#--#------#--#------#--#------#--#------#--#------#--#------#--#------#--#------#--#------#--#-
--###--##---###--##---###--##---###--##---###--##---###--##---###--##---###--##---###--##---###--##-
#-#---#--##-#---#--##-#---#--##-#---#--##-#---#--##-#---#--##-#---#--##-#---#--##-#---#--##-#---#--#
----------------------------------------------------------------------------------------------------
##-#---#-###-#---#-###-#---#-###-#---#-###-#---#-###-#---#-###-#---#-###-#---#-###-#---#-###-#---#-#
##--------##--------##--------##--------##--------##--------##--------##--------##--------##--------
--#--###----#--###----#--###----#--###----#--###----#--###----#--###----#--###----#--###----#--###--
--#-----#---#-----#---#-----#---#-----#---#-----#---#-----#---#-----#---#-----#---#-----#---#-----#-
----#-#--#----#-#--#----#-#--#----#-#--#----#-#--#----#-#--#----#-#--#----#-#--#----#-#--#----#-#--#
-----##--------##--------##--------##--------##--------##--------##--------##--------##--------##---
-----#--#------#--#------#--#------#--#------#--#------#--#------#--#------#--#------#--#------#--#-
--###--##---###--##---###--##---###--##---###--##---###--##---###--##---###--##---###--##---###--##-
#-#---#--##-#---#--##-#---#--##-#---#--##-#---#--##-#---#--##-#---#--##-#---#--##-#---#--##-#---#--#
----------------------------------------------------------------------------------------------------
##-#---#-###-#---#-###-#---#-###-#---#-###-#---#-###-#---#-###-#---#-###-#---#-###-#---#-###-#---#-#
##--------##--------##--------##--------##--------##--------##--------##--------##--------##--------
--#--###----#--###----#--###----#--###----#--###----#--###----#--###----#--###----#--###----#--###--
--#-----#---#-----#---#-----#---#-----#---#-----#---#-----#---#-----#---#-----#---#-----#---#-----#-
----#-#--#----#-#--#----#-#--#----#-#--#----#-#--#----#-#--#----#-#--#----#-#--#----#-#--#----#-#--#
-----##--------##--------##--------##--------##--------##--------##--------##--------##--------##---
-----#--#------#--#------#--#------#--#------#--#------#--#------#--#------#--#------#--#------#--#-
--###--##---###--##---###--##---###--##---###--##---###--##---###--##---###--##---###--##---###--##-
#-#---#--##-#---#--##-#---#--##-#---#--##-#---#--##-#---#--##-#---#--##-#---#--##-#---#--##-#---#--#
----------------------------------------------------------------------------------------------------
##-#---#-###-#---#-###-#---#-###-#---#-###-#---#-###-#---#-###-#---#-###-#---#-###-#---#-###-#-S-#-#
##--------##--------##--------##--------##--------##--------##--------##--------##--------##--------
--#--###----#--###----#--###----#--###----#--###----#--###----#--###----#--###----#--###----#--###--
--#-----#---#-----#---#-----#---#-----#---#-----#---#-----#---#-----#---#-----#---#-----#---#-----#-
----#-#--#----#-#--#----#-#--#----#-#--#----#-#--#----#-#--#----#-#--#----#-#--#----#-#--#----#-#--#
-----##--------##--------##--------##--------##--------##--------##--------##--------##--------##---
-----#--#------#--#------#--#------#--#------#--#------#--#------#--#------#--#------#--#------#--#-
--###--##---###--##---###--##---###--##---###--##---###--##---###--##---###--##---###--##---###--##-
#-#---#--##-#---#--##-#---#--##-#---#--##-#---#--##-#---#--##-#---#--##-#---#--##-#---#--##-#---#--#
----------------------------------------------------------------------------------------------------
##-#---#-###-#---#-###-#---#-###-#---#-###-#---#-###-#---#-###-#---#-###-#---#-###-#---#-###-#---#-#
##--------##--------##--------##--------##--------##--------##--------##--------##--------##--------
--#--###----#--###----#--###----#--###----#--###----#--###----#--###----#--###----#--###----#--###--
--#-----#---#-----#---#-----#---#-----#---#-----#---#-----#---#-----#---#-----#---#-----#---#-----#-
----#-#--#----#-#--#----#-#--#----#-#--#----#-#--#----#-#--#----#-#--#----#-#--#----#-#--#----#-#--#
-----##--------##--------##--------##--------##--------##--------##--------##--------##--------##---
-----#--#------#--#------#--#------#--#------#--#------#--#------#--#------#--#------#--#------#--#-
--###--##---###--##---###--##---###--##---###--##---###--##---###--##---###--##---###--##---###--##-
#-#---#--##-#---#--##-#---#--##-#---#--##-#---#--##-#---#--##-#---#--##-#---#--##-#---#--##-#---#--#
----------------------------------------------------------------------------------------------------
##-#---#-###-#---#-###-#---#-###-#---#-###-#---#-###-#---#-###-#---#-###-#---#-###-#---#-###-#---#-#
##--------##--------##--------##--------##--------##--------##--------##--------##--------##--------
--#--###----#--###----#--###----#--###----#--###----#--###----#--###----#--###----#--###----#--###--
--#-----#---#-----#---#-----#---#-----#---#-----#---#-----#---#-----#---#-----#---#-----#---#-----#-
----#-#--#----#-#--#----#-#--#----#-#--#----#-#--#----#-#--#----#-#--#----#-#--#----#-#--#----#-#--#
-----##--------##--------##--------##--------##--------##--------##--------##--------##--------##---
-----#--#------#--#------#--#------#--#------#--#------#--#------#--#------#--#------#--#------#--#-
--###--##---###--##---###--##---###--##---###--##---###--##---###--##---###--##---###--##---###--##-
#-#---#--##-#---#--##-#---#--##-#---#--##-#---#--##-#---#--##-#---#--##-#---#--##-#---#--##-#---#--#
----------------------------------------------------------------------------------------------------
##-#---#-###-#---#-###-#---#-###-#---#-###-#---#-###-#---#-###-#---#-###-#---#-###-#---#-###-#---#-#
##--------##--------##--------##--------##--------##--------##--------##--------##--------##--------
--#--###----#--###----#--###----#--###----#--###----#--###----#--###----#--###----#--###----#--###--
--#-----#---#-----#---#-----#---#-----#---#-----#---#-----#---#-----#---#-----#---#-----#---#-----#-
----#-#--#----#-#--#----#-#--#----#-#--#----#-#--#----#-#--#----#-#--#----#-#--#----#-#--#----#-#--#
-----##-------E##--------##--------##--------##--------##--------##--------##--------##--------##---
-----#--#------#--#------#--#------#--#------#--#------#--#------#--#------#--#------#--#------#--#-
--###--##---###--##---###--##---###--##---###--##---###--##---###--##---###--##---###--##---###--##-
#-#---#--##-#---#--##-#---#--##-#---#--##-#---#--##-#---#--##-#---#--##-#---#--##-#---#--##-#---#--#
----------------------------------------------------------------------------------------------------
##-#---#-###-#---#-###-#---#-###-#---#-###-#---#-###-#---#-###-#---#-###-#---#-###-#---#-###-#---#-#
##--------##--------##--------##--------##--------##--------##--------##--------##--------##--------
--#--###----#--###----#--###----#--###----#--###----#--###----#--###----#--###----#--###----#--###--
--#-----#---#-----#---#-----#---#-----#---#-----#---#-----#---#-----#---#-----#---#-----#---#-----#-
----#-#--#----#-#--#----#-#--#----#-#--#----#-#--#----#-#--#----#-#--#----#-#--#----#-#--#----#-#--#
-----##--------##--------##--------##--------##--------##--------##--------##--------##--------##---
-----#--#------#--#------#--#------#--#------#--#------#--#------#--#------#--#------#--#------#--#-
--###--##---###--##---###--##---###--##---###--##---###--##---###--##---###--##---###--##---###--##-
#-#---#--##-#---#--##-#---#--##-#---#--##-#---#--##-#---#--##-#---#--##-#---#--##-#---#--##-#---#--#
----------------------------------------------------------------------------------------------------
##-#---#-###-#---#-###-#---#-###-#---#-###-#---#-###-#---#-###-#---#-###-#---#-###-#---#-###-#---#-#
##--------##--------##--------##--------##--------##--------##--------##--------##--------##--------
--#--###----#--###----#--###----#--###----#--###----#--###----#--###----#--###----#--###----#--###--
--#-----#---#-----#---#-----#---#-----#---#-----#---#-----#---#-----#---#-----#---#-----#---#-----#-
----#-#--#----#-#--#----#-#--#----#-#--#----#-#--#----#-#--#----#-#--#----#-#--#----#-#--#----#-#--#
-----##--------##--------##--------##--------##--------##--------##--------##--------##--------##---
-----#--#------#--#------#--#------#--#------#--#------#--#------#--#------#--#------#--#------#--#-
--###--##---###--##---###--##---###--##---###--##---###--##---###--##---###--##---###--##---###--##-
#-#---#--##-#---#--##-#---#--##-#---#--##-#---#--##-#---#--##-#---#--##-#---#--##-#---#--##-#---#--#
----------------------------------------------------------------------------------------------------
##-#---#-###-#---#-###-#---#-###-#---#-###-#---#-###-#---#-###-#---#-###-#---#-###-#---#-###-#---#-#
##--------##--------##--------##--------##--------##--------##--------##--------##--------##--------
--#--###----#--###----#--###----#--###----#--###----#--###----#--###----#--###----#--###----#--###--
--#-----#---#-----#---#-----#---#-----#---#-----#---#-----#---#-----#---#-----#---#-----#---#-----#-
----#-#--#----#-#--#----#-#--#----#-#--#----#-#--#----#-#--#----#-#--#----#-#--#----#-#--#----#-#--#
-----##--------##--------##--------##--------##--------##--------##--------##--------##--------##---
-----#--#------#--#------#--#------#--#------#--#------#--#------#--#------#--#------#--#------#--#-
--###--##---###--##---###--##---###--##---###--##---###--##---###--##---###--##---###--##---###--##-
#-#---#--##-#---#--##-#---#--##-#---#--##-#---#--##-#---#--##-#---#--##-#---#--##-#---#--##-#---#--#
----------------------------------------------------------------------------------------------------
##-#---#-###-#---#-###-#---#-###-#---#-###-#---#-###-#---#-###-#---#-###-#---#-###-#---#-###-#---#-#
##--------##--------##--------##--------##--------##--------##--------##--------##--------##--------
--#--###----#--###----#--###----#--###----#--###----#--###----#--###----#--###----#--###----#--###--
--#-----#---#-----#---#-----#---#-----#---#-----#---#-----#---#-----#---#-----#---#-----#---#-----#-
