-##--------##--------##--------##--------##--------##--------##--------##--------##--------##-------
---#----##---#----##---#----##---#----##---#----##---#----##---#----##---#----##---#----##---#----##
------#---------#---------#---------#---------#---------#---------#---------#---------#---------#---
-------##--------##--------##--------##--------##--------##--------##--------##--------##--------##-
--------#---------#---------#---------#---------#---------#---------#---------#---------#---------#-
-#-#----#--#-#----#--#-#----#--#-#----#--#-#----#--#-#----#--#-#----#--#-#----#--#-#----#--#-#----#-
--#-#-##----#-#-##----#-#-##----#-#-##----#-#-##----#-#-##----#-#-##----#-#-##----#-#-##----#-#-##--
-##----#---##----#---##----#---##----#---##----#---##----#---##----#---##----#---##----#---##----#--
-#-#----#--#-#----#--#-#----#--#-#----#--#-#----#--#-#----#--#-#----#--#-#----#--#-#----#--#-#----#-
-----#-###-----#-###-----#-###-----#-###-----#-###-----#-###-----#-###-----#-###-----#-###-----#-###
-##--------##--------##--------##--------##--------##--------##--------##--------##--------##-------
---#----##---#----##---#----##---#----##---#----##---#----##---#----##---#----##---#----##---#----##
------#---------#---------#---------#---------#---------#---------#---------#---------#---------#---
-------##--------##--------##--------##--------##--------##--------##--------##--------##--------##-
--------#---------#---------#---------#---------#---------#---------#---------#---------#---------#-
-#-#----#--#-#----#--#-#----#--#-#----#--#-#----#--#-#----#--#-#----#--#-#----#--#-#----#--#-#----#-
--#-#-##----#-#-##----#-#-##----#-#-##----#-#-##----#-#-##----#-#-##----#-#-##----#-#-##----#-#-##--
-##----#---##----#---##----#---##----#---##----#---##----#---##----#---##----#---##----#---##----#--
-#-#----#--#-#----#--#-#----#--#-#----#--#-#----#--#-#----#--#-#----#--#-#----#--#-#----#--#-#----#-
-----#-###-----#-###-----#-###-----#-###-----#-###-----#-###-----#-###-----#-###-----#-###-----#-###
-##--------##--------##--------##--------##--------##--------##--------##--------##--------##-------
---#----##---#----##---#----##---#----##---#----##---#----##---#----##---#----##---#----##---#----##
------#---------#---------#---------#---------#---------#---------#---------#---------#---------#---
-------##--------##--------##--------##--------##--------##--------##--------##--------##--------##-
--------#---------#---------#---------#---------#---------#-----E---#---------#---------#---------#-
-#-#----#--#-#----#--#-#----#--#-#----#--#-#----#--#-#----#--#-#----#--#-#----#--#-#----#--#-#----#-
--#-#-##----#-#-##----#-#-##----#-#-##----#-#-##----#-#-##----#-#-##----#-#-##----#-#-##----#-#-##--
-##----#---##----#---##----#---##----#---##----#---##----#---##----#---##----#---##----#---##----#--
-#-#----#--#-#----#--#-#----#--#-#----#--#-#----#--#-#----#--#-#----#--#-#----#--#-#----#--#-#----#-
-----#-###-----#-###-----#-###-----#-###-----#-###-----#-###-----#-###-----#-###-----#-###-----#-###
-##--------##--------##--------##--------##--------##--------##--------##--------##--------##-------
---#----##---#----##---#----##---#----##---#----##---#----##---#----##---#----##---#----##---#----##
------#---------#---------#---------#---------#---------#---------#---------#---------#---------#---
-------##--------##--------##--------##--------##--------##--------##--------##--------##--------##-
--------#---------#---------#---------#---------#---------#---------#---------#---------#---------#-
-#-#----#--#-#----#--#-#----#--#-#----#--#-#----#--#-#----#--#-#----#--#-#----#--#-#----#--#-#----#-
--#-#-##----#-#-##----#-#-##----#-#-##----#-#-##----#-#-##----#-#-##----#-#-##----#-#-##----#-#-##--
-##----#---##----#---##----#---##----#---##----#---##----#---##----#---##----#---##----#---##----#--
-#-#----#--#-#----#--#-#----#--#-#----#--#-#----#--#-#----#--#-#----#--#-#----#--#-#----#--#-#----#-
-----#-###-----#-###-----#-###-----#-###-----#-###-----#-###-----#-###-----#-###-----#-###-----#-###
-##--------##-------S##--------##--------##--------##--------##--------##--------##--------##-------
---#----##---#----##---#----##---#----##---#----##---#----##---#----##---#----##---#----##---#----##
------#---------#---------#---------#---------#---------#---------#---------#---------#---------#---
-------##--------##--------##--------##--------##--------##--------##--------##--------##--------##-
--------#---------#---------#---------#---------#---------#---------#---------#---------#---------#-
-#-#----#--#-#----#--#-#----#--#-#----#--#-#----#--#-#----#--#-#----#--#-#----#--#-#----#--#-#----#-
--#-#-##----#-#-##----#-#-##----#-#-##----#-#-##----#-#-##----#-#-##----#-#-##----#-#-##----#-#-##--
-##----#---##----#---##----#---##----#---##----#---##----#---##----#---##----#---##----#---##----#--
-#-#----#--#-#----#--#-#----#--#-#----#--#-#----#--#-#----#--#-#----#--#-#----#--#-#----#--#-#----#-
-----#-###-----#-###-----#-###-----#-###-----#-###-----#-###-----#-###-----#-###-----#-###-----#-###
-##--------##--------##--------##--------##--------##--------##--------##--------##--------##-------
---#----##---#----##---#----##---#----##---#----##---#----##---#----##---#----##---#----##---#----##
------#---------#---------#---------#---------#---------#---------#---------#---------#---------#---
-------##--------##--------##--------##--------##--------##--------##--------##--------##--------##-
--------#---------#---------#---------#---------#---------#---------#---------#---------#---------#-
-#-#----#--#-#----#--#-#----#--#-#----#--#-#----#--#-#----#--#-#----#--#-#----#--#-#----#--#-#----#-
--#-#-##----#-#-##----#-#-##----#-#-##----#-#-##----#-#-##----#-#-##----#-#-##----#-#-##----#-#-##--
-##----#---##----#---##----#---##----#---##----#---##----#---##----#---##----#---##----#---##----#--
-#-#----#--#-#----#--#-#----#--#-#----#--#-#----#--#-#----#--#-#----#--#-#----#--#-#----#--#-#----#-
-----#-###-----#-###-----#-###-----#-###-----#-###-----#-###-----#-###-----#-###-----#-###-----#-###
-##--------##--------##--------##--------##--------##--------##--------##--------##--------##-------
---#----##---#----##---#----##---#----##---#----##---#----##---#----##---#----##---#----##---#----##
------#---------#---------#---------#---------#---------#---------#---------#---------#---------#---
-------##--------##--------##--------##--------##--------##--------##--------##--------##--------##-
--------#---------#---------#---------#---------#---------#---------#---------#---------#---------#-
-#-#----#--#-#----#--#-#----#--#-#----#--#-#----#--#-#----#--#-#----#--#-#----#--#-#----#--#-#----#-
--#-#-##----#-#-##----#-#-##----#-#-##----#-#-##----#-#-##----#-#-##----#-#-##----#-#-##----#-#-##--
-##----#---##----#---##----#---##----#---##----#---##----#---##----#---##----#---##----#---##----#--
-#-#----#--#-#----#--#-#----#--#-#----#--#-#----#--#-#----#--#-#----#--#-#----#--#-#----#--#-#----#-
-----#-###-----#-###-----#-###-----#-###-----#-###-----#-###-----#-###-----#-###-----#-###-----#-###
-##--------##--------##--------##--------##--------##--------##--------##--------##--------##-------
---#----##---#----##---#----##---#----##---#----##---#----##---#----##---#----##---#----##---#----##
------#---------#---------#---------#---------#---------#---------#---------#---------#---------#---
-------##--------##--------##--------##--------##--------##--------##--------##--------##--------##-
--------#---------#---------#---------#---------#---------#---------#---------#---------#---------#-
-#-#----#--#-#----#--#-#----#--#-#----#--#-#----#--#-#----#--#-#----#--#-#----#--#-#----#--#-#----#-
--#-#-##----#-#-##----#-#-##----#-#-##----#-#-##----#-#-##----#-#-##----#-#-##----#-#-##----#-#-##--
-##----#---##----#---##----#---##----#---##----#---##----#---##----#---##----#---##----#---##----#--
-#-#----#--#-#----#--#-#----#--#-#----#--#-#----#--#-#----#--#-#----#--#-#----#--#-#----#--#-#----#-
-----#-###-----#-###-----#-###-----#-###-----#-###-----#-###-----#-###-----#-###-----#-###-----#-###
-##--------##--------##--------##--------##--------##--------##--------##--------##--------##-------
---#----##---#----##---#----##---#----##---#----##---#----##---#----##---#----##---#----##---#----##
------#---------#---------#---------#---------#---------#---------#---------#---------#---------#---
-------##--------##--------##--------##--------##--------##--------##--------##--------##--------##-
--------#---------#---------#---------#---------#---------#---------#---------#---------#---------#-
-#-#----#--#-#----#--#-#----#--#-#----#--#-#----#--#-#----#--#-#----#--#-#----#--#-#----#--#-#----#-
--#-#-##----#-#-##----#-#-##----#-#-##----#-#-##----#-#-##----#-#-##----#-#-##----#-#-##----#-#-##--
-##----#---##----#---##----#---##----#---##----#---##----#---##----#---##----#---##----#---##----#--
-#-#----#--#-#----#--#-#----#--#-#----#--#-#----#--#-#----#--#-#----#--#-#----#--#-#----#--#-#----#-
-----#-###-----#-###-----#-###-----#-###-----#-###-----#-###-----#-###-----#-###-----#-###-----#-###
-##--------##--------##--------##--------##--------##--------##--------##--------##--------##-------
---#----##---#----##---#----##---#----##---#----##---#----##---#----##---#----##---#----##---#----##
------#---------#---------#---------#---------#---------#---------#---------#---------#---------#---
-------##--------##--------##--------##--------##--------##--------##--------##--------##--------##-
--------#---------#---------#---------#---------#---------#---------#---------#---------#---------#-
-#-#----#--#-#----#--#-#----#--#-#----#--#-#----#--#-#----#--#-#----#--#-#----#--#-#----#--#-#----#-
--#-#-##----#-#-##----#-#-##----#-#-##----#-#-##----#-#-##----#-#-##----#-#-##----#-#-##----#-#-##--
-##----#---##----#---##----#---##----#---##----#---##----#---##----#---##----#---##----#---##----#--
-#-#----#--#-#----#--#-#----#--#-#----#--#-#----#--#-#----#--#-#----#--#-#----#--#-#----#--#-#----#-
-----#-###-----#-###-----#-###-----#-###-----#-###-----#-###-----#-###-----#-###-----#-###-----#-###
