-#-#----##-#-#----##-#-#----##-#-#----##-#-#----##-#-#----##-#-#----##-#-#----##-#-#----##-#-#----##
#--------##--------##--------##--------##--------##--------##--------##--------##--------##--------#
#--##--#-##--##--#-##--##--#-##--##--#-##--##--#-##--##--#-##--##--#-##--##--#-##--##--#-##--##--#-#
-------#---------#---------#---------#---------#---------#---------#---------#---------#---------#--
-#-#-#-----#-#-#-----#-#-#-----#-#-#-----#-#-#-----#-#-#-----#-#-#-----#-#-#-----#-#-#-----#-#-#----
-#-------#-#-------#-#-------#-#-------#-#-------#-#-------#-#-------#-#-------#-#-------#-#-------#
---##--------##--------##--------##--------##--------##--------##--------##--------##--------##-----
#------#--#------#--#------#--#------#--#------#--#------#--#------#--#------#--#------#--#------#--
---------#---------#---------#---------#---------#---------#---------#---------#---------#---------#
###--##--####--##--####--##--####--##--####--##--####--##--####--##--####--##--####--##--####--##--#
-#-#----##-#-#----##-#-#----##-#-#----##-#-#----##-#-#----##-#-#----##-#-#----##-#-#----##-#-#----##
#--------##--------##--------##--------##--------##--------##--------##--------##--------##--------#
#--##--#-##--##--#-##--##--#-##--##--#-##--##--#-##--##--#-##--##--#-##--##--#-##--##--#-##--##--#-#
-------#---------#---------#---------#---------#---------#---------#---------#---------#---------#--
-#-#-#-----#-#-#-----#-#-#-----#-#-#-----#-#-#-----#-#-#-----#-#-#-----#-#-#-----#-#-#-----#-#-#----
-#-------#-#-------#-#-------#-#-------#-#-------#-#-------#-#-------#-#-------#-#-------#-#-------#
---##--------##--------##--------##--------##--------##--------##--------##--------##--------##-----
#------#--#------#--#------#--#------#--#------#--#------#--#------#--#------#--#------#--#------#--
---------#---------#---------#---------#---------#---------#---------#---------#---------#---------#
###--##--####--##--####--##--####--##--####--##--####--##--####--##--####--##--####--##--####--##--#
-#-#----##-#-#----##-#-#----##-#-#----##-#-#----##-#-#----##-#-#----##-#-#----##-#-#----##-#-#----##
#--------##--------##--------##--------##--------##--------##--------##--------##--------##--------#
#--##--#-##--##--#-##--##--#-##--##--#-##--##--#-##--##--#-##--##--#-##--##--#-##--##--#-##--##--#-#
-------#---------#---------#---------#---------#---------#---------#---------#---------#---------#--
-#-#-#-----#-#-#-----#-#-#-----#-#-#-----#-#-#-----#-#-#-----#-#-#-----#-#-#-----#-#-#-----#-#-#----
-#-------#-#-------#-#-------#-#-------#-#-------#-#-------#-#-------#-#-------#-#-------#-#-------#
---##--------##--------##--------##--------##--------##--------##--------##--------##--------##-----
#------#--#------#--#------#--#------#--#------#--#------#--#------#--#------#--#------#--#------#--
---------#---------#---------#---------#---------#---------#---------#---------#---------#---------#
###--##--####--##--####--##--####--##--####--##--####--##--####--##--####--##--####--##--####--##--#
-#-#----##-#-#----##-#-#----##-#-#----##-#-#----##-#-#----##-#-#----##-#-#----##-#-#----##-#-#----##
#--------##--------##--------##--------##--------##--------##--------##--------##--------##--------#
#--##--#-##--##--#-##--##--#-##--##--#-##--##-E#-##--##--#-##--##--#-##--##--#-##--##--#-##--##--#-#
-------#---------#---------#---------#---------#---------#---------#---------#---------#---------#--
-#-#-#-----#-#-#-----#-#-#-----#-#-#-----#-#-#-----#-#-#-----#-#-#-----#-#-#-----#-#-#-----#-#-#----
-#-------#-#-------#-#-------#-#-------#-#-------#-#-------#-#-------#-#-------#-#-------#-#-------#
---##--------##--------##--------##--------##--------##--------##--------##--------##--------##-----
#------#--#------#--#------#--#------#--#------#--#------#--#------#--#------#--#------#--#------#--
---------#---------#---------#---------#---------#---------#---------#---------#---------#---------#
###--##--####--##--####--##--####--##--####--##--####--##--####--##--####--##--####--##--####--##--#
-#-#----##-#-#----##-#-#----##-#-#----##-#-#----##-#-#----##-#-#----##-#-#----##-#-#----##-#-#----##
#--------##--------##--------##--------##--------##--------##--------##--------##--------##--------#
#--##--#-##--##--#-##--##--#-##--##--#-##--##--#-##--##--#-##--##--#-##--##--#-##--##--#-##--##--#-#
-------#---------#---------#---------#---------#---------#---------#---------#---------#---------#--
-#-#-#-----#-#-#-----#-#-#-----#-#-#-----#-#-#-----#-#-#-----#-#-#-----#-#-#-----#-#-#-----#-#-#----
-#-------#-#-------#-#-------#-#-------#-#-------#-#-------#-#-------#-#-------#-#-------#-#-------#
---##--------##--------##--------##--------##--------##--------##--------##--------##--------##-----
#------#--#------#--#------#--#------#--#------#--#------#--#------#--#------#--#------#--#------#--
---------#---------#---------#---------#---------#---------#---------#---------#---------#---------#
###--##--####--##--####--##--####--##--####--##--####--##--####--##--####--##--####--##--####--##--#
-#-#----##-#-#----##-#-#----##-#-#----##-#-#----##-#-#----##-#-#----##-#-#----##-#-#----##-#-#----##
#--------##--------##--------##--------##--------##--------##--------##--------##--------##--------#
#--##--#-##--##--#-##--##--#-##--##--#-##--##--#-##--##--#-##--##--#-##--##--#-##--##--#-##--##--#-#
-------#---------#---------#---------#---------#---------#---------#---------#---------#---------#--
-#-#-#-----#-#-#-----#-#-#-----#-#-#-----#-#-#-----#-#-#-----#-#-#-----#-#-#-----#-#-#-----#-#-#----
-#-------#-#-------#-#-------#-#-------#-#-------#-#-------#-#-------#-#-------#-#-------#-#-------#
---##--------##--------##--------##--------##--------##--------##--------##--------##--------##-----
#------#--#------#--#------#--#------#--#------#--#------#--#------#--#------#--#------#--#------#--
---------#---------#---------#---------#---------#---------#---------#---------#---------#---------#
###--##--####--##--####--##--####--##--####--##--####--##--####--##--####--##--####--##--####--##--#
-#-#----##-#-#----##-#-#----##-#-#----##-#-#----##-#-#----##-#-#----##-#-#----##-#-#----##-#-#----##
#--------##--------##--------##--------##--------##--------##--------##--------##--------##--------#
#--##--#-##--##--#-##--##--#-##--##--#-##--##--#-##--##--#-##--##--#-##--##--#-##--##--#-##--##--#-#
-------#---------#---------#---------#---------#---------#---------#---------#---------#---------#--
-#-#-#-----#-#-#-----#-#-#-----#-#-#-----#-#-#-----#-#-#-----#-#-#-----#-#-#-----#-#-#-----#-#-#----
-#-------#-#-------#-#-------#-#-------#-#-------#-#-------#-#-------#-#-------#-#-------#-#-------#
---##--------##--------##--------##--------##--------##--------##--------##--------##--------##-----
#------#--#------#--#------#--#------#--#------#--#------#--#------#--#------#--#------#--#------#--
---------#---------#---------#---------#---------#---------#---------#---------#---------#---------#
###--##--####--##--####--##--####--##--####--##--####--##--####--##--####--##--####--##--####--##--#
-#-#----##-#-#----##-#-#----##-#-#----##-#-#----##-#-#----##-#-#----##-#-#----##-#-#----##-#-#----##
#--------##--------##--------##--------##--------##--------##--------##--------##--------##--------#
#--##--#-##--##--#-##--##--#-##--##--#-##--##--#-##--##--#-##--##--#-##--##--#-##--##--#-##--##--#-#
-------#---------#---------#---------#---------#---------#---------#---------#---------#---------#--
-#-#-#-----#-#-#-----#-#-#-----#-#-#-----#-#-#-----#-#-#-----#-#-#-----#-#-#-----#-#-#-----#-#-#----
-#-------#-#-------#-#-------#-#-------#-#-------#-#-------#-#-------#-#-------#-#-------#-#-------#
---##--------##--------##--------##--------##--------##--------##--------##--------##--------##-----
#------#--#------#--#------#--#------#--#------#--#------#--#------#--#------#--#------#--#------#--
---------#---------#---------#---------#---------#---------#---------#---------#---------#---------#
###--##--####--##--####--##--####--##--####--##--####--##--####--##--####--##--####--##--####--##--#
-#-#----##-#-#----##-#-#----##-#-#----##-#-#----##-#-#----##-#-#----##-#-#----##-#-#----##-#-#----##
#--------##--------##--------##--------##--------##--------##--------##--------##--------##--------#
#--##--#-##--##--#-##--##--#-##--##--#-##--##--#-##--##--#-##--##--#-##--##--#-##--##--#-##--##--#-#
-------#---------#---------#---------#---------#---------#---------#---------#---------#---------#--
-#-#-#-----#-#-#-----#-#-#-----#-#-#-----#-#-#-----#-#-#-----#-#-#-----#-#-#-----#-#-#-----#-#-#----
-#-------#-#-------#-#-------#-#-------#-#-------#-#-------#-#-------#-#-------#-#-------#-#-------#
---##--------##--------##--------##--------##--------##--------##--------##--------##--------##-----
#------#--#------#--#------#--#------#--#------#--#------#--#------#--#------#--#------#--#------#--
---------#---------#---------#------S--#---------#---------#---------#---------#---------#---------#
###--##--####--##--####--##--####--##--####--##--####--##--####--##--####--##--####--##--####--##--#
-#-#----##-#-#----##-#-#----##-#-#----##-#-#----##-#-#----##-#-#----##-#-#----##-#-#----##-#-#----##
#--------##--------##--------##--------##--------##--------##--------##--------##--------##--------#
#--##--#-##--##--#-##--##--#-##--##--#-##--##--#-##--##--#-##--##--#-##--##--#-##--##--#-##--##--#-#
-------#---------#---------#---------#---------#---------#---------#---------#---------#---------#--
-#-#-#-----#-#-#-----#-#-#-----#-#-#-----#-#-#-----#-#-#-----#-#-#-----#-#-#-----#-#-#-----#-#-#----
-#-------#-#-------#-#-------#-#-------#-#-------#-#-------#-#-------#-#-------#-#-------#-#-------#
---##--------##--------##--------##--------##--------##--------##--------##--------##--------##-----
#------#--#------#--#------#--#------#--#------#--#------#--#------#--#------#--#------#--#------#--
---------#---------#---------#---------#---------#---------#---------#---------#---------#---------#
###--##--####--##--####--##--####--##--####--##--####--##--####--##--####--##--####--##--####--##--#
