--#-----#---#-----#---#-----#---#-----#---#-----#---#-----#---#-----#---#-----#---#-----#---#-----#-
--#------#--#------#--#------#--#------#--#------#--#------#--#------#--#------#--#------#--#------#
-------##--------##--------##--------##--------##--------##--------##--------##--------##--------##-
-#----#----#----#----#----#----#----#----#----#----#----#----#----#----#----#----#----#----#----#---
--###-------###-------###-------###-------###-------###-------###-------###-------###-------###-----
----#-##-#----#-##-#----#-##-#----#-##-#----#-##-#----#-##-#----#-##-#----#-##-#----#-##-#----#-##-#
-#-#-#--#--#-#-#--#--#-#-#--#--#-#-#--#--#-#-#--#--#-#-#--#--#-#-#--#--#-#-#--#--#-#-#--#--#-#-#--#-
---------#---------#---------#---------#---------#---------#---------#---------#---------#---------#
-#----#----#----#----#----#----#----#----#----#----#----#----#----#----#----#----#----#----#----#---
#--------##--------##--------##--------##--------##--------##--------##--------##--------##--------#
--#-----#---#-----#---#-----#---#-----#---#-----#---#-----#---#-----#---#-----#---#-----#---#-----#-
--#------#--#------#--#------#--#------#--#------#--#------#--#------#--#------#--#------#--#------#
-------##--------##--------##--------##--------##--------##--------##--------##--------##--------##-
-#----#----#----#----#----#----#----#----#----#----#----#-S--#----#----#----#----#----#----#----#---
--###-------###-------###-------###-------###-------###-------###-------###-------###-------###-----
----#-##-#----#-##-#----#-##-#----#-##-#----#-##-#----#-##-#----#-##-#----#-##-#----#-##-#----#-##-#
-#-#-#--#--#-#-#--#--#-#-#--#--#-#-#--#--#-#-#--#--#-#-#--#--#-#-#--#--#-#-#--#--#-#-#--#--#-#-#--#-
---------#---------#---------#---------#---------#---------#---------#---------#---------#---------#
-#----#----#----#----#----#----#----#----#----#----#----#----#----#----#----#----#----#----#----#---
#--------##--------##--------##--------##--------##--------##--------##--------##--------##--------#
--#-----#---#-----#---#-----#---#-----#---#-----#---#-----#---#-----#---#-----#---#-----#---#-----#-
--#------#--#------#--#------#--#------#--#------#--#------#--#------#--#------#--#------#--#------#
-------##--------##--------##--------##--------##--------##--------##--------##--------##--------##-
-#----#----#----#----#----#----#----#----#----#----#----#----#----#----#----#----#----#----#----#---
--###-------###-------###-------###-------###-------###-------###-------###-------###-------###-----
----#-##-#----#-##-#----#-##-#----#-##-#----#-##-#----#-##-#----#-##-#----#-##-#----#-##-#----#-##-#
-#-#-#--#--#-#-#--#--#-#-#--#--#-#-#--#--#-#-#--#--#-#-#--#--#-#-#--#--#-#-#--#--#-#-#--#--#-#-#--#-
---------#---------#---------#---------#---------#---------#---------#---------#---------#---------#
-#----#----#----#----#----#----#----#----#----#----#----#----#----#----#----#----#----#----#----#---
#--------##--------##--------##--------##--------##--------##--------##--------##--------##--------#
--#-----#---#-----#---#-----#---#-----#---#-----#---#-----#---#-----#---#-----#---#-----#---#-----#-
--#------#--#------#--#------#--#------#--#------#--#------#--#------#--#------#--#------#--#------#
-------##--------##--------##--------##--------##--------##--------##--------##--------##--------##-
-#----#----#----#----#----#----#----#----#----#----#----#----#----#----#----#----#----#----#----#---
--###-------###-------###-------###-------###-------###-------###-------###-------###-------###-----
----#-##-#----#-##-#----#-##-#----#-##-#----#-##-#----#-##-#----#-##-#----#-##-#----#-##-#----#-##-#
-#-#-#--#--#-#-#--#--#-#-#--#--#-#-#--#--#-#-#--#--#-#-#--#--#-#-#--#--#-#-#--#--#-#-#--#--#-#-#--#-
---------#---------#---------#---------#---------#---------#---------#---------#---------#---------#
-#----#----#----#----#----#----#----#----#----#----#----#----#----#----#----#----#----#----#----#---
#--------##--------##--------##--------##--------##--------##--------##--------##--------##--------#
--#-----#---#-----#---#-----#---#-----#---#-----#---#-----#---#-----#---#-----#---#-----#---#-----#-
--#------#--#------#--#------#--#------#--#------#--#------#--#------#--#------#--#------#--#------#
-------##--------##--------##--------##--------##--------##--------##--------##--------##--------##-
-#----#----#----#----#----#----#----#----#----#----#----#----#----#----#----#----#----#----#----#---
--###-------###-------###-------###-------###-------###-------###-------###-------###-------###-----
----#-##-#----#-##-#----#-##-#----#-##-#----#-##-#----#-##-#----#-##-#----#-##-#----#-##-#----#-##-#
-#-#-#--#--#-#-#--#--#-#-#--#--#-#-#--#--#-#-#--#--#-#-#--#--#-#-#--#--#-#-#--#--#-#-#--#--#-#-#--#-
---------#---------#---------#---------#---------#---------#---------#---------#---------#---------#
-#----#----#----#----#----#----#----#----#----#----#----#----#----#----#----#----#----#----#----#---
#--------##--------##--------##--------##--------##--------##--------##--------##--------##--------#
--#-----#---#-----#---#-----#---#-----#---#-----#---#-----#---#-----#---#-----#---#-----#---#-----#-
--#------#--#------#--#------#--#------#--#------#--#------#--#------#--#------#--#------#--#------#
-------##--------##--------##--------##--------##--------##--------##--------##--------##--------##-
-#----#----#----#----#----#----#----#----#----#----#----#----#----#----#----#----#----#----#----#---
--###-------###-------###-------###-------###-------###-------###-------###-------###-------###-----
----#-##-#----#-##-#----#-##-#----#-##-#----#-##-#----#-##-#----#-##-#----#-##-#----#-##-#----#-##-#
-#-#-#--#--#-#-#--#--#-#-#--#--#-#-#--#--#-#-#--#--#-#-#--#--#-#-#--#--#-#-#--#--#-#-#--#--#-#-#--#-
---------#---------#---------#---------#---------#---------#---------#---------#---------#---------#
-#----#----#----#----#----#----#----#----#----#----#----#----#----#----#----#----#----#----#----#---
#--------##--------##--------##--------##--------##--------##--------##--------##--------##--------#
--#-----#---#-----#---#-----#---#-----#---#-----#---#-----#---#-----#---#-----#---#-----#---#-----#-
--#------#--#------#--#------#--#------#--#------#--#------#--#------#--#------#--#------#--#------#
-------##--------##--------##--------##--------##--------##--------##--------##--------##--------##-
-#----#----#----#----#----#----#----#----#----#----#----#----#----#----#----#----#----#----#----#---
--###-------###-------###-------###-------###-------###-------###-------###-------###-------###-----
----#-##-#----#-##-#----#-##-#----#-##-#----#-##-#----#-##-#----#-##-#----#-##-#----#-##-#----#-##-#
-#-#-#--#--#-#-#--#--#-#-#--#--#-#-#--#--#-#-#--#--#-#-#--#--#-#-#--#--#-#E#--#--#-#-#--#--#-#-#--#-
---------#---------#---------#---------#---------#---------#---------#---------#---------#---------#
-#----#----#----#----#----#----#----#----#----#----#----#----#----#----#----#----#----#----#----#---
#--------##--------##--------##--------##--------##--------##--------##--------##--------##--------#
--#-----#---#-----#---#-----#---#-----#---#-----#---#-----#---#-----#---#-----#---#-----#---#-----#-
--#------#--#------#--#------#--#------#--#------#--#------#--#------#--#------#--#------#--#------#
-------##--------##--------##--------##--------##--------##--------##--------##--------##--------##-
-#----#----#----#----#----#----#----#----#----#----#----#----#----#----#----#----#----#----#----#---
--###-------###-------###-------###-------###-------###-------###-------###-------###-------###-----
----#-##-#----#-##-#----#-##-#----#-##-#----#-##-#----#-##-#----#-##-#----#-##-#----#-##-#----#-##-#
-#-#-#--#--#-#-#--#--#-#-#--#--#-#-#--#--#-#-#--#--#-#-#--#--#-#-#--#--#-#-#--#--#-#-#--#--#-#-#--#-
---------#---------#---------#---------#---------#---------#---------#---------#---------#---------#
-#----#----#----#----#----#----#----#----#----#----#----#----#----#----#----#----#----#----#----#---
#--------##--------##--------##--------##--------##--------##--------##--------##--------##--------#
--#-----#---#-----#---#-----#---#-----#---#-----#---#-----#---#-----#---#-----#---#-----#---#-----#-
--#------#--#------#--#------#--#------#--#------#--#------#--#------#--#------#--#------#--#------#
-------##--------##--------##--------##--------##--------##--------##--------##--------##--------##-
-#----#----#----#----#----#----#----#----#----#----#----#----#----#----#----#----#----#----#----#---
--###-------###-------###-------###-------###-------###-------###-------###-------###-------###-----
----#-##-#----#-##-#----#-##-#----#-##-#----#-##-#----#-##-#----#-##-#----#-##-#----#-##-#----#-##-#
-#-#-#--#--#-#-#--#--#-#-#--#--#-#-#--#--#-#-#--#--#-#-#--#--#-#-#--#--#-#-#--#--#-#-#--#--#-#-#--#-
---------#---------#---------#---------#---------#---------#---------#---------#---------#---------#
-#----#----#----#----#----#----#----#----#----#----#----#----#----#----#----#----#----#----#----#---
#--------##--------##--------##--------##--------##--------##--------##--------##--------##--------#
--#-----#---#-----#---#-----#---#-----#---#-----#---#-----#---#-----#---#-----#---#-----#---#-----#-
--#------#--#------#--#------#--#------#--#------#--#------#--#------#--#------#--#------#--#------#
-------##--------##--------##--------##--------##--------##--------##--------##--------##--------##-
-#----#----#----#----#----#----#----#----#----#----#----#----#----#----#----#----#----#----#----#---
--###-------###-------###-------###-------###-------###-------###-------###-------###-------###-----
----#-##-#----#-##-#----#-##-#----#-##-#----#-##-#----#-##-#----#-##-#----#-##-#----#-##-#----#-##-#
-#-#-#--#--#-#-#--#--#-#-#--#--#-#-#--#--#-#-#--#--#-#-#--#--#-#-#--#--#-#-#--#--#-#-#--#--#-#-#--#-
---------#---------#---------#---------#---------#---------#---------#---------#---------#---------#
-#----#----#----#----#----#----#----#----#----#----#----#----#----#----#----#----#----#----#----#---
#--------##--------##--------##--------##--------##--------##--------##--------##--------##--------#
