--#---------#---------#---------#---------#---------#---------#---------#---------#---------#-------
--#--#------#--#------#--#------#--#------#--#------#--#------#--#------#--#------#--#------#--#----
-------#-#-------#-#-------#-#-------#-#-------#-#-------#-#-------#-#-------#-#-------#-#-------#-#
--##----#---##----#---##----#---##----#---##----#---##----#---##----#---##----#---##----#---##----#-
#--------##--------##--------##--------##--------##--------##--------##--------##--------##--------#
##--###---##--###---##--###---##--###---##--###---##--###---##--###---##--###---##--###---##--###---
##----##--##----##--##----##--##----##--##----##--##----##--##----##--##----##--##----##--##----##--
---#---#-#---#---#-#---#---#-#---#---#-#---#---#-#---#---#-#---#---#-#---#---#-#---#---#-#---#---#-#
-###---#---###---#---###---#---###---#---###---#---###---#---###---#---###---#---###---#---###---#--
#---------#---------#---------#---------#---------#---------#---------#---------#---------#---------
--#---------#---------#---------#---------#---------#---------#---------#---------#---------#-------
--#--#------#--#------#--#------#--#------#--#------#--#------#--#------#--#------#--#------#--#----
-------#-#-------#-#-------#-#-------#-#-------#-#-------#-#-------#-#-------#-#-------#-#-------#-#
--##----#---##----#---##----#---##----#---##----#---##----#---##----#---##----#---##----#---##----#-
#--------##--------##--------##--------##--------##--------##--------##--------##--------##--------#
##--###---##--###---##--###---##--###---##--###---##--###---##--###---##--###---##--###---##--###---
##----##--##----##--##----##--##----##--##----##--##----##--##----##--##----##--##----##--##----##--
---#---#-#---#---#-#---#---#-#---#---#-#---#---#-#---#---#-#---#---#-#---#---#-#---#---#-#---#---#-#
-###---#---###---#---###---#---###---#---###---#---###---#---###---#---###---#---###---#---###---#--
#---------#---------#---------#---------#---------#---------#---------#---------#---------#---------
--#---------#---------#---------#---------#---------#---------#---------#---------#---------#-------
--#--#------#--#------#--#------#--#------#--#------#--#------#--#------#--#------#--#------#--#----
-------#-#-------#-#-------#-#-------#-#-------#-#-------#-#-------#-#-------#-#-------#-#-------#-#
--##----#---##----#---##----#---##----#---##----#---##----#---##----#---##----#---##----#---##----#-
#--------##--------##--------##--------##--------##--------##--------##--------##--------##--------#
##--###---##--###---##--###---##--###---##--###---##--###---##--###---##--###---##--###---##--###---
##----##--##----##--##----##--##----##--##----##--##----##--##----##--##----##--##----##--##----##--
---#---#-#---#---#-#---#---#-#---#---#-#---#---#-#---#---#-#---#---#-#---#---#-#---#---#-#---#---#-#
-###---#---###---#---###---#---###---#---###---#---###---#---###---#---###---#---###---#---###---#--
#---------#---------#---------#---------#---------#---------#---------#---------#---------#---------
--#---------#---------#---------#---------#---------#---------#---------#---------#---------#-------
--#--#------#--#------#--#------#--#------#--#------#--#------#--#------#--#------#--#------#--#----
-------#-#-------#-#-------#-#-------#-#-------#-#-------#-#-------#-#-------#-#-------#-#-------#-#
--##----#---##----#---##----#---##----#---##----#---##----#---##----#---##----#---##----#---##----#-
#--------##--------##--------##--------##--------##--------##--------##--------##--------##--------#
##--###---##--###---##--###---##--###---##--###---##--###---##--###---##--###---##--###---##--###---
##----##--##----##--##----##--##----##--##----##--##----##--##----##--##----##--##----##--##----##--
---#---#-#---#---#-#---#---#-#---#---#-#---#---#-#---#---#-#---#---#-#---#---#-#---#---#-#---#---#-#
-###---#---###---#---###---#---###---#---###---#---###---#---###---#---###---#---###---#---###---#--
#---------#---------#---------#---------#---------#---------#---------#---------#---------#---------
--#---------#---------#---------#---------#---------#---------#---------#---------#---------#-------
--#--#------#--#------#--#------#--#------#--#------#--#------#--#------#--#------#--#------#--#----
-------#-#-------#-#-------#-#-------#-#-------#-#-------#-#-------#-#-------#-#-------#-#-------#-#
--##----#---##----#---##----#---##----#---##----#---##----#---##----#---##----#---##----#---##----#-
#--------##--------##--------##--------##--------##--------##--------##--------##--------##--------#
##--###---##--###---##--###---##--###---##--###---##--###---##--###---##--###---##--###---##--###---
##----##--##----##--##----##--##----##--##----##--##----##--##----##--##----##--##----##--##----##--
---#---#-#---#---#-#---#---#-#---#---#-#---#---#-#---#---#-#---#---#-#---#---#-#---#---#-#---#---#-#
-###---#---###---#---###---#---###---#---###---#---###---#---###---#---###---#---###---#---###---#--
#---------#---------#---------#---------#---------#---------#---------#---------#---------#---------
--#---------#---------#---------#---------#---------#---------#---------#---------#---------#-------
--#--#------#--#------#--#------#--#------#--#------#--#------#--#------#--#------#--#------#--#----
-------#-#-------#-#-------#-#-------#-#-------#-#-------#-#-------#-#-------#-#-------#-#-------#-#
--##----#---##----#---##----#---##----#---##----#---##----#---##----#---##----#---##----#---##----#-
#--------##--------##--------##--------##--------##--------##--------##--------##--------##--------#
##--###---##--###---##--###---##--###---##--###---##--###---##--###---##--###---##--###---##--###---
##----##--##----##--##----##--##----##--##----##--##----##--##----##--##----##--##----##--##----##--
---#---#-#---#---#-#---#---#-#---#---#-#---#---#-#---#---#-#---#---#-#---#---#-#---#---#-#---#---#-#
-###---#---###---#---###---#---###---#---###---#---###---#---###---#---###---#---###---#---###---#--
#---------#---------#---------#---------#---------#---------#---------#---------#---------#---------
--#---------#---------#---------#---------#---------#---------#---------#---------#---------#-------
--#--#------#--#------#--#------#--#------#--#------#--#------#--#------#--#------#--#------#--#----
-------#-#-------#-#-------#-#-------#-#-------#-#-------#-#-------#-#-------#-#------E#-#-------#-#
--##----#---##----#---##----#---##----#---##----#---##----#---##----#---##----#---##----#---##----#-
#--------##--------##--------##--------##--------##--------##--------##--------##--------##--------#
##--###---##--###---##--###---##--###---##--###---##--###---##--###---##--###---##--###---##--###---
##----##--##----##--##----##--##----##--##----##--##----##--##----##--##----##--##----##--##----##--
---#---#-#---#---#-#---#---#-#---#---#-#---#---#-#---#---#-#---#---#-#---#---#-#---#---#-#---#---#-#
-###---#---###---#---###---#---###---#---###---#---###---#---###---#---###---#---###---#---###---#--
#---------#---------#---------#---------#---------#---------#---------#---------#---------#---------
--#---------#---------#---------#---------#---------#---------#---------#---------#---------#-------
--#--#------#--#------#--#------#--#------#--#------#--#------#--#------#--#------#--#------#--#----
-------#-#-------#-#-------#-#-------#-#-------#-#-------#-#-------#-#-------#-#-------#-#-------#-#
--##----#---##----#---##----#---##----#---##----#---##----#---##----#---##----#---##----#---##----#-
#--------##--------##--------##--------##--------##--------##--------##--------##--------##--------#
##--###---##--###---##--###---##--###---##--###---##--###---##--###---##--###---##--###---##--###---
##----##--##----##--##----##--##----##--##----##--##----##--##----##--##----##--##----##--##----##--
---#---#-#---#---#-#---#---#-#---#---#-#---#---#-#---#---#-#---#---#-#---#---#-#---#---#-#---#---#-#
-###---#---###---#---###---#---###---#---###---#---###---#---###---#---###---#---###--S#---###---#--
#---------#---------#---------#---------#---------#---------#---------#---------#---------#---------
--#---------#---------#---------#---------#---------#---------#---------#---------#---------#-------
--#--#------#--#------#--#------#--#------#--#------#--#------#--#------#--#------#--#------#--#----
-------#-#-------#-#-------#-#-------#-#-------#-#-------#-#-------#-#-------#-#-------#-#-------#-#
--##----#---##----#---##----#---##----#---##----#---##----#---##----#---##----#---##----#---##----#-
#--------##--------##--------##--------##--------##--------##--------##--------##--------##--------#
##--###---##--###---##--###---##--###---##--###---##--###---##--###---##--###---##--###---##--###---
##----##--##----##--##----##--##----##--##----##--##----##--##----##--##----##--##----##--##----##--
---#---#-#---#---#-#---#---#-#---#---#-#---#---#-#---#---#-#---#---#-#---#---#-#---#---#-#---#---#-#
-###---#---###---#---###---#---###---#---###---#---###---#---###---#---###---#---###---#---###---#--
#---------#---------#---------#---------#---------#---------#---------#---------#---------#---------
--#---------#---------#---------#---------#---------#---------#---------#---------#---------#-------
--#--#------#--#------#--#------#--#------#--#------#--#------#--#------#--#------#--#------#--#----
-------#-#-------#-#-------#-#-------#-#-------#-#-------#-#-------#-#-------#-#-------#-#-------#-#
--##----#---##----#---##----#---##----#---##----#---##----#---##----#---##----#---##----#---##----#-
#--------##--------##--------##--------##--------##--------##--------##--------##--------##--------#
##--###---##--###---##--###---##--###---##--###---##--###---##--###---##--###---##--###---##--###---
##----##--##----##--##----##--##----##--##----##--##----##--##----##--##----##--##----##--##----##--
---#---#-#---#---#-#---#---#-#---#---#-#---#---#-#---#---#-#---#---#-#---#---#-#---#---#-#---#---#-#
-###---#---###---#---###---#---###---#---###---#---###---#---###---#---###---#---###---#---###---#--
#---------#---------#---------#---------#---------#---------#---------#---------#---------#---------
