#-###---###-###---###-###---###-###---###-###---###-###---###-###---###-###---###-###---###-###---##
--###---#---###---#---###---#---###---#---###---#---###---#---###---#---###---#---###---#---###---#-
--#--#------#--#------#--#------#--#------#--#------#--#------#--#------#--#------#--#------#--#----
---------#---------#---------#---------#---------#---------#---------#---------#---------#---------#
-#-------#-#-------#-#-------#-#-------#-#-------#-#-------#-#-------#-#-------#-#-------#-#-------#
------#---------#---------#---------#---------#---------#---------#---------#---------#---------#---
#---#----##---#----##---#----##---#----##---#----##---#----##---#----##---#S---##---#----##---#----#
----###--#----###--#----###--#----###--#----###--#----###--#----###--#----###--#----###--#----###--#
----#---------#---------#---------#---------#---------#---------#---------#---------#---------#-----
----#---------#---------#---------#---------#---------#---------#---------#---------#---------#-----
#-###---###-###---###-###---###-###---###-###---###-###---###-###---###-###---###-###---###-###---##
--###---#---###---#---###---#---###---#---###---#---###---#---###---#---###---#---###---#---###---#-
--#--#------#--#------#--#------#--#------#--#------#--#------#--#------#--#------#--#------#--#----
---------#---------#---------#---------#---------#---------#---------#---------#---------#---------#
-#-------#-#-------#-#-------#-#-------#-#-------#-#-------#-#-------#-#-------#-#-------#-#-------#
------#---------#---------#---------#---------#---------#---------#---------#---------#---------#---
#---#----##---#----##---#----##---#----##---#----##---#----##---#----##---#----##---#----##---#----#
----###--#----###--#----###--#----###--#----###--#----###--#----###--#----###--#----###--#----###--#
----#---------#---------#---------#---------#---------#---------#---------#---------#---------#-----
----#---------#---------#---------#---------#---------#---------#---------#---------#---------#-----
#-###---###-###---###-###---###-###---###-###---###-###---###-###---###-###---###-###---###-###---##
--###---#---###---#---###---#---###---#---###---#---###---#---###---#---###---#---###---#---###---#-
--#--#------#--#------#--#------#--#------#--#------#--#------#--#------#--#------#--#------#--#----
---------#---------#---------#---------#---------#---------#---------#---------#---------#---------#
-#-------#-#-------#-#-------#-#-------#-#-------#-#-------#-#-------#-#-------#-#-------#-#-------#
------#---------#---------#---------#---------#---------#---------#---------#---------#---------#---
#---#----##---#----##---#----##---#----##---#----##---#----##---#----##---#----##---#----##---#----#
----###--#----###--#----###--#----###--#----###--#----###--#----###--#----###--#----###--#----###--#
----#---------#---------#---------#---------#---------#---------#---------#---------#---------#-----
----#---------#---------#---------#---------#---------#---------#---------#---------#---------#-----
#-###---###-###---###-###---###-###---###-###---###-###---###-###---###-###---###-###---###-###---##
--###---#---###---#---###---#---###---#---###---#---###---#---###---#---###---#---###---#---###---#-
--#--#------#--#------#--#------#--#------#--#------#--#------#--#------#--#------#--#------#--#----
---------#---------#---------#---------#---------#---------#---------#---------#---------#---------#
-#-------#-#-------#-#-------#-#-------#-#-------#-#-------#-#-------#-#-------#-#-------#-#-------#
------#---------#---------#---------#---------#---------#---------#---------#---------#---------#---
#---#----##---#----##---#----##---#----##---#----##---#----##---#----##---#----##---#----##---#----#
----###--#----###--#----###--#----###--#----###--#----###--#----###--#----###--#----###--#----###--#
----#---------#---------#---------#---------#---------#---------#---------#---------#---------#-----
----#---------#---------#---------#---------#---------#---------#---------#---------#---------#-----
#-###---###-###---###-###---###-###---###-###---###-###---###-###---###-###---###-###---###-###---##
--###---#---###---#---###---#---###---#---###---#---###---#---###---#---###---#---###---#---###---#-
--#--#------#--#------#--#------#--#------#--#------#--#------#--#------#--#------#--#------#--#----
---------#---------#---------#---------#---------#---------#---------#---------#---------#---------#
-#-------#-#-------#-#-------#-#-------#-#-------#-#-------#-#-------#-#-------#-#-------#-#-------#
------#---------#---------#---------#---------#---------#---------#---------#---------#---------#---
#---#----##---#----##---#----##---#----##---#----##---#----##---#----##---#----##---#----##---#----#
----###--#----###--#----###--#----###--#----###--#----###--#----###--#----###--#----###--#----###--#
----#---------#---------#---------#---------#---------#---------#---------#---------#---------#-----
----#---------#---------#---------#---------#---------#---------#---------#---------#---------#-----
#-###---###-###---###-###---###-###---###-###---###-###---###-###---###-###---###-###---###-###---##
--###---#---###---#---###---#---###---#---###---#---###---#---###---#---###---#---###---#---###---#-
--#--#------#--#------#--#------#--#------#--#------#--#------#--#------#--#------#--#------#--#----
---------#---------#---------#---------#---------#---------#---------#---------#---------#---------#
-#-------#-#-------#-#-------#-#-------#-#-------#-#-------#-#-------#-#-------#-#-------#-#-------#
------#---------#---------#---------#---------#---------#---------#---------#---------#---------#---
#---#----##---#----##---#----##---#----##---#----##---#----##---#----##---#----##---#----##---#----#
----###--#----###--#----###--#----###--#----###--#----###--#----###--#----###--#----###--#----###--#
----#---------#---------#---------#---------#---------#---------#---------#---------#---------#-----
----#---------#---------#---------#---------#---------#---------#---------#---------#---------#-----
#-###---###-###---###-###---###-###---###-###---###-###---###-###---###-###---###-###---###-###---##
--###---#---###---#---###---#---###---#---###---#---###---#---###---#---###---#---###---#---###---#-
--#--#------#--#------#--#------#--#------#--#------#--#------#--#------#--#------#--#------#--#----
---------#---------#---------#---------#---------#---------#---------#---------#---------#---------#
-#-------#-#-------#-#-------#-#-------#-#-------#-#-------#-#-------#-#-------#-#-------#-#-------#
------#---------#---------#---------#---------#---------#---------#---------#---------#---------#---
#---#----##---#----##---#----##---#----##---#----##---#----##---#----##---#----##---#----##---#----#
----###--#----###--#----###--#----###--#----###--#----###--#----###--#----###--#----###--#----###--#
----#---------#---------#---------#---------#---------#---------#---------#---------#---------#-----
----#---------#---------#---------#---------#---------#---------#---------#---------#---------#-----
#-###---###-###---###-###---###-###---###-###---###-###---###-###---###-###---###-###---###-###---##
--###---#---###---#---###---#---###---#---###---#---###---#---###---#---###---#---###---#---###---#-
--#--#------#--#------#--#------#--#------#--#------#--#------#--#------#--#------#--#------#--#----
---------#---------#---------#---------#---------#---------#---------#---------#---------#---------#
-#-------#-#-------#-#-------#-#-------#-#-------#-#-------#-#-------#-#-------#-#-------#-#-------#
------#---------#---------#---------#---------#---------#---------#---------#---------#---------#---
#---#----##---#----##---#----##---#----##---#----##---#----##---#----##---#----##---#----##---#----#
----###--#----###--#----###--#----###--#----###--#----###--#----###--#----###--#----###--#----###--#
----#---------#---------#---------#---------#---------#---------#---------#---------#---------#-----
----#---------#---------#---------#---------#---------#---------#---------#---------#---------#-----
#-###---###-###---###-###---###-###---###-###---###-###---###-###---###-###---###-###---###-###---##
--###---#---###---#---###---#---###---#---###---#---###---#---###---#---###---#---###---#---###---#-
--#--#------#--#------#--#------#--#------#--#------#--#------#--#------#--#------#--#------#--#----
---------#---------#---------#---------#---------#---------#---------#---------#---------#---------#
-#-------#-#-------#-#-------#-#-------#-#-------#-#-------#-#-------#-#-------#-#-------#-#-------#
------#---------#---------#---------#---------#---------#---------#---------#---------#---------#---
#---#----##---#----##---#----##---#----##---#----##---#----##---#----##---#----##---#----##---#----#
----###--#----###--#----###--#----###--#----###--#----###--#----###--#----###--#----###--#----###--#
----#---------#---------#---------#---------#---------#---------#---------#---------#---------#-----
----#---------#---------#---------#---------#---------#---------#---------#---------#---------#-----
#-###---###-###---###-###---###-###---###-###---###-###---###-###---###-###---###-###---###-###---##
--###---#---###---#---###---#---###---#---###---#---###---#---###---#---###---#---###---#---###---#-
--#--#------#--#------#--#------#--#------#--#------#--#------#--#------#--#------#--#------#--#----
---------#---------#---------#---------#---------#---------#---------#---------#---------#---------#
-#-------#-#-------#-#-------#-#-------#-#-------#-#-------#-#-------#-#-------#-#-------#-#-------#
------#---------#---------#---------#---------#---------#---------#---------#---------#---------#---
#---#----##---#----##---#----##---#----##---#----##---#----##---#----##---#----##---#----##---#----#
----###--#----###--#----###--#----###--#----###--#----###--#----###--#----###--#----###--#----###--#
----#---------#---------#---------#---------#---------#---------#---------#---------#----E----#-----
----#---------#---------#---------#---------#---------#---------#---------#---------#---------#-----
