---#---------#---------#---------#---------#---------#---------#---------#---------#---------#------
-#-#----#--#-#----#--#-#----#--#-#----#--#-#----#--#-#----#--#-#----#--#-#----#--#-#----#--#-#----#-
----#-#-------#-#-------#-#-------#-#-------#-#-------#-#-------#-#-------#-#-------#-#-------#-#---
-#--#---#--#--#---#--#--#---#--#--#---#--#--#---#--#--#---#--#--#---#--#--#---#--#--#---#--#--#---#-
--#-#-#-----#-#-#-----#-#-#-----#-#-#-----#-#-#-----#-#-#-----#-#-#-----#-#-#-----#-#-#-----#-#-#---
------##-#------##-#------##-#------##-#------##-#------##-#------##-#------##-#------##-#------##-#
##--#-##--##--#-##--##--#-##--##--#-##--##--#-##--##--#-##--##--#-##--##--#-##--##--#-##--##--#-##--
--#----#-#--#----#-#--#----#-#--#----#-#--#----#-#E-#----#-#--#----#-#--#----#-#--#----#-#--#----#-#
-#----#-#--#----#-#--#----#-#--#----#-#--#----#-#--#----#-#--#----#-#--#----#-#--#----#-#--#----#-#-
##----#---##----#---##----#---##----#---##----#---##----#---##----#---##----#---##----#---##----#---
---#---------#---------#---------#---------#---------#---------#---------#---------#---------#------
-#-#----#--#-#----#--#-#----#--#-#----#--#-#----#--#-#----#--#-#----#--#-#----#--#-#----#--#-#----#-
----#-#-------#-#-------#-#-------#-#-------#-#-------#-#-------#-#-------#-#-------#-#-------#-#---
-#--#---#--#--#---#--#--#---#--#--#---#--#--#---#--#--#---#--#--#---#--#--#---#--#--#---#--#--#---#-
--#-#-#-----#-#-#-----#-#-#-----#-#-#-----#-#-#-----#-#-#-----#-#-#-----#-#-#-----#-#-#-----#-#-#---
------##-#------##-#------##-#------##-#------##-#------##-#------##-#------##-#------##-#------##-#
##--#-##--##--#-##--##--#-##--##--#-##--##--#-##--##--#-##--##--#-##--##--#-##-S##--#-##--##--#-##--
--#----#-#--#----#-#--#----#-#--#----#-#--#----#-#--#----#-#--#----#-#--#----#-#--#----#-#--#----#-#
-#----#-#--#----#-#--#----#-#--#----#-#--#----#-#--#----#-#--#----#-#--#----#-#--#----#-#--#----#-#-
##----#---##----#---##----#---##----#---##----#---##----#---##----#---##----#---##----#---##----#---
---#---------#---------#---------#---------#---------#---------#---------#---------#---------#------
-#-#----#--#-#----#--#-#----#--#-#----#--#-#----#--#-#----#--#-#----#--#-#----#--#-#----#--#-#----#-
----#-#-------#-#-------#-#-------#-#-------#-#-------#-#-------#-#-------#-#-------#-#-------#-#---
-#--#---#--#--#---#--#--#---#--#--#---#--#--#---#--#--#---#--#--#---#--#--#---#--#--#---#--#--#---#-
--#-#-#-----#-#-#-----#-#-#-----#-#-#-----#-#-#-----#-#-#-----#-#-#-----#-#-#-----#-#-#-----#-#-#---
------##-#------##-#------##-#------##-#------##-#------##-#------##-#------##-#------##-#------##-#
##--#-##--##--#-##--##--#-##--##--#-##--##--#-##--##--#-##--##--#-##--##--#-##--##--#-##--##--#-##--
--#----#-#--#----#-#--#----#-#--#----#-#--#----#-#--#----#-#--#----#-#--#----#-#--#----#-#--#----#-#
-#----#-#--#----#-#--#----#-#--#----#-#--#----#-#--#----#-#--#----#-#--#----#-#--#----#-#--#----#-#-
##----#---##----#---##----#---##----#---##----#---##----#---##----#---##----#---##----#---##----#---
---#---------#---------#---------#---------#---------#---------#---------#---------#---------#------
-#-#----#--#-#----#--#-#----#--#-#----#--#-#----#--#-#----#--#-#----#--#-#----#--#-#----#--#-#----#-
----#-#-------#-#-------#-#-------#-#-------#-#-------#-#-------#-#-------#-#-------#-#-------#-#---
-#--#---#--#--#---#--#--#---#--#--#---#--#--#---#--#--#---#--#--#---#--#--#---#--#--#---#--#--#---#-
--#-#-#-----#-#-#-----#-#-#-----#-#-#-----#-#-#-----#-#-#-----#-#-#-----#-#-#-----#-#-#-----#-#-#---
------##-#------##-#------##-#------##-#------##-#------##-#------##-#------##-#------##-#------##-#
##--#-##--##--#-##--##--#-##--##--#-##--##--#-##--##--#-##--##--#-##--##--#-##--##--#-##--##--#-##--
--#----#-#--#----#-#--#----#-#--#----#-#--#----#-#--#----#-#--#----#-#--#----#-#--#----#-#--#----#-#
-#----#-#--#----#-#--#----#-#--#----#-#--#----#-#--#----#-#--#----#-#--#----#-#--#----#-#--#----#-#-
##----#---##----#---##----#---##----#---##----#---##----#---##----#---##----#---##----#---##----#---
---#---------#---------#---------#---------#---------#---------#---------#---------#---------#------
-#-#----#--#-#----#--#-#----#--#-#----#--#-#----#--#-#----#--#-#----#--#-#----#--#-#----#--#-#----#-
----#-#-------#-#-------#-#-------#-#-------#-#-------#-#-------#-#-------#-#-------#-#-------#-#---
-#--#---#--#--#---#--#--#---#--#--#---#--#--#---#--#--#---#--#--#---#--#--#---#--#--#---#--#--#---#-
--#-#-#-----#-#-#-----#-#-#-----#-#-#-----#-#-#-----#-#-#-----#-#-#-----#-#-#-----#-#-#-----#-#-#---
------##-#------##-#------##-#------##-#------##-#------##-#------##-#------##-#------##-#------##-#
##--#-##--##--#-##--##--#-##--##--#-##--##--#-##--##--#-##--##--#-##--##--#-##--##--#-##--##--#-##--
--#----#-#--#----#-#--#----#-#--#----#-#--#----#-#--#----#-#--#----#-#--#----#-#--#----#-#--#----#-#
-#----#-#--#----#-#--#----#-#--#----#-#--#----#-#--#----#-#--#----#-#--#----#-#--#----#-#--#----#-#-
##----#---##----#---##----#---##----#---##----#---##----#---##----#---##----#---##----#---##----#---
---#---------#---------#---------#---------#---------#---------#---------#---------#---------#------
-#-#----#--#-#----#--#-#----#--#-#----#--#-#----#--#-#----#--#-#----#--#-#----#--#-#----#--#-#----#-
----#-#-------#-#-------#-#-------#-#-------#-#-------#-#-------#-#-------#-#-------#-#-------#-#---
-#--#---#--#--#---#--#--#---#--#--#---#--#--#---#--#--#---#--#--#---#--#--#---#--#--#---#--#--#---#-
--#-#-#-----#-#-#-----#-#-#-----#-#-#-----#-#-#-----#-#-#-----#-#-#-----#-#-#-----#-#-#-----#-#-#---
------##-#------##-#------##-#------##-#------##-#------##-#------##-#------##-#------##-#------##-#
##--#-##--##--#-##--##--#-##--##--#-##--##--#-##--##--#-##--##--#-##--##--#-##--##--#-##--##--#-##--
--#----#-#--#----#-#--#----#-#--#----#-#--#----#-#--#----#-#--#----#-#--#----#-#--#----#-#--#----#-#
-#----#-#--#----#-#--#----#-#--#----#-#--#----#-#--#----#-#--#----#-#--#----#-#--#----#-#--#----#-#-
##----#---##----#---##----#---##----#---##----#---##----#---##----#---##----#---##----#---##----#---
---#---------#---------#---------#---------#---------#---------#---------#---------#---------#------
-#-#----#--#-#----#--#-#----#--#-#----#--#-#----#--#-#----#--#-#----#--#-#----#--#-#----#--#-#----#-
----#-#-------#-#-------#-#-------#-#-------#-#-------#-#-------#-#-------#-#-------#-#-------#-#---
-#--#---#--#--#---#--#--#---#--#--#---#--#--#---#--#--#---#--#--#---#--#--#---#--#--#---#--#--#---#-
--#-#-#-----#-#-#-----#-#-#-----#-#-#-----#-#-#-----#-#-#-----#-#-#-----#-#-#-----#-#-#-----#-#-#---
------##-#------##-#------##-#------##-#------##-#------##-#------##-#------##-#------##-#------##-#
##--#-##--##--#-##--##--#-##--##--#-##--##--#-##--##--#-##--##--#-##--##--#-##--##--#-##--##--#-##--
--#----#-#--#----#-#--#----#-#--#----#-#--#----#-#--#----#-#--#----#-#--#----#-#--#----#-#--#----#-#
-#----#-#--#----#-#--#----#-#--#----#-#--#----#-#--#----#-#--#----#-#--#----#-#--#----#-#--#----#-#-
##----#---##----#---##----#---##----#---##----#---##----#---##----#---##----#---##----#---##----#---
---#---------#---------#---------#---------#---------#---------#---------#---------#---------#------
-#-#----#--#-#----#--#-#----#--#-#----#--#-#----#--#-#----#--#-#----#--#-#----#--#-#----#--#-#----#-
----#-#-------#-#-------#-#-------#-#-------#-#-------#-#-------#-#-------#-#-------#-#-------#-#---
-#--#---#--#--#---#--#--#---#--#--#---#--#--#---#--#--#---#--#--#---#--#--#---#--#--#---#--#--#---#-
--#-#-#-----#-#-#-----#-#-#-----#-#-#-----#-#-#-----#-#-#-----#-#-#-----#-#-#-----#-#-#-----#-#-#---
------##-#------##-#------##-#------##-#------##-#------##-#------##-#------##-#------##-#------##-#
##--#-##--##--#-##--##--#-##--##--#-##--##--#-##--##--#-##--##--#-##--##--#-##--##--#-##--##--#-##--
--#----#-#--#----#-#--#----#-#--#----#-#--#----#-#--#----#-#--#----#-#--#----#-#--#----#-#--#----#-#
-#----#-#--#----#-#--#----#-#--#----#-#--#----#-#--#----#-#--#----#-#--#----#-#--#----#-#--#----#-#-
##----#---##----#---##----#---##----#---##----#---##----#---##----#---##----#---##----#---##----#---
---#---------#---------#---------#---------#---------#---------#---------#---------#---------#------
-#-#----#--#-#----#--#-#----#--#-#----#--#-#----#--#-#----#--#-#----#--#-#----#--#-#----#--#-#----#-
----#-#-------#-#-------#-#-------#-#-------#-#-------#-#-------#-#-------#-#-------#-#-------#-#---
-#--#---#--#--#---#--#--#---#--#--#---#--#--#---#--#--#---#--#--#---#--#--#---#--#--#---#--#--#---#-
--#-#-#-----#-#-#-----#-#-#-----#-#-#-----#-#-#-----#-#-#-----#-#-#-----#-#-#-----#-#-#-----#-#-#---
------##-#------##-#------##-#------##-#------##-#------##-#------##-#------##-#------##-#------##-#
##--#-##--##--#-##--##--#-##--##--#-##--##--#-##--##--#-##--##--#-##--##--#-##--##--#-##--##--#-##--
--#----#-#--#----#-#--#----#-#--#----#-#--#----#-#--#----#-#--#----#-#--#----#-#--#----#-#--#----#-#
-#----#-#--#----#-#--#----#-#--#----#-#--#----#-#--#----#-#--#----#-#--#----#-#--#----#-#--#----#-#-
##----#---##----#---##----#---##----#---##----#---##----#---##----#---##----#---##----#---##----#---
---#---------#---------#---------#---------#---------#---------#---------#---------#---------#------
-#-#----#--#-#----#--#-#----#--#-#----#--#-#----#--#-#----#--#-#----#--#-#----#--#-#----#--#-#----#-
----#-#-------#-#-------#-#-------#-#-------#-#-------#-#-------#-#-------#-#-------#-#-------#-#---
-#--#---#--#--#---#--#--#---#--#--#---#--#--#---#--#--#---#--#--#---#--#--#---#--#--#---#--#--#---#-
--#-#-#-----#-#-#-----#-#-#-----#-#-#-----#-#-#-----#-#-#-----#-#-#-----#-#-#-----#-#-#-----#-#-#---
------##-#------##-#------##-#------##-#------##-#------##-#------##-#------##-#------##-#------##-#
##--#-##--##--#-##--##--#-##--##--#-##--##--#-##--##--#-##--##--#-##--##--#-##--##--#-##--##--#-##--
--#----#-#--#----#-#--#----#-#--#----#-#--#----#-#--#----#-#--#----#-#--#----#-#--#----#-#--#----#-#
-#----#-#--#----#-#--#----#-#--#----#-#--#----#-#--#----#-#--#----#-#--#----#-#--#----#-#--#----#-#-
##----#---##----#---##----#---##----#---##----#---##----#---##----#---##----#---##----#---##----#---
