--###-------###-------###-------###-------###-------###-------###-------###-------###-------###-----
---##--##----##--##----##--##----##--##----##--##----##--##----##--##----##--##----##--##----##--##-
--#---------#---------#---------#---------#---------#---------#---------#---------#---------#-------
#---#--#-##---#--#-##---#--#-##---#--#-##---#--#-##---#--#-##---#--#-##---#--#E##---#--#-##---#--#-#
#---#-----#---#-----#---#-----#---#-----#---#-----#---#-----#---#-----#---#-----#---#-----#---#-----
---#-#-#-----#-#-#-----#-#-#-----#-#-#-----#-#-#-----#-#-#-----#-#-#-----#-#-#-----#-#-#-----#-#-#--
#-----#---#-----#---#-----#---#-----#---#-----#---#-----#---#-----#---#-----#---#-----#---#-----#---
-----#--#------#--#------#--#------#--#------#--#------#--#------#--#------#--#------#--#------#--#-
-#---#-----#---#-----#---#-----#---#-----#---#-----#---#-----#---#-----#---#-----#---#-----#---#----
---#-#-------#-#-------#-#-------#-#-------#-#-------#-#-------#-#-------#-#-------#-#-------#-#----
--###-------###-------###-------###-------###-------###-------###-------###-------###-------###-----
---##--##----##--##----##--##----##--##----##--##----##--##----##--##----##--##----##--##----##--##-
--#---------#---------#---------#---------#---------#---------#---------#---------#---------#-------
#---#--#-##---#--#-##---#--#-##---#--#-##---#--#-##---#--#-##---#--#-##---#--#-##---#--#-##---#--#-#
#---#-----#---#-----#---#-----#---#-----#---#-----#---#-----#---#-----#---#-----#---#-----#---#-----
---#-#-#-----#-#-#-----#-#-#-----#-#-#-----#-#-#-----#-#-#-----#-#-#-----#-#-#-----#-#-#-----#-#-#--
#-----#---#-----#---#-----#---#-----#---#-----#---#-----#---#-----#---#-----#---#-----#---#-----#---
-----#--#------#--#------#--#------#--#------#--#------#--#------#--#------#--#------#--#------#--#-
-#---#-----#---#-----#---#-----#---#-----#---#-----#---#-----#---#-----#---#-----#---#-----#---#----
---#-#-------#-#-------#-#-------#-#-------#-#-------#-#-------#-#-------#-#-------#-#-------#-#----
--###-------###-------###-------###-------###-------###-------###-------###-------###-------###-----
---##--##----##--##----##--##----##--##----##--##----##--##----##--##----##--##----##--##----##--##-
--#---------#---------#---------#---------#---------#---------#---------#---------#---------#-------
#---#--#-##---#--#-##---#--#-##---#--#-##---#--#-##---#--#-##---#--#-##---#--#-##---#--#-##---#--#-#
#---#-----#---#-----#---#-----#---#-----#---#-----#---#-----#---#-----#---#-----#---#-----#---#-----
---#-#-#-----#-#-#-----#-#-#-----#-#-#-----#-#-#-----#-#-#-----#-#-#-----#-#-#-----#-#-#-----#-#-#--
#-----#---#-----#---#-----#---#-----#---#-----#---#-----#---#-----#---#-----#---#-----#---#-----#---
-----#--#------#--#------#--#------#--#------#--#------#--#------#--#------#--#------#--#------#--#-
-#---#-----#---#-----#---#-----#---#-----#---#-----#---#-----#---#-----#---#-----#---#-----#---#----
---#-#-------#-#-------#-#-------#-#-------#-#-------#-#-------#-#-------#-#-------#-#-------#-#----
--###-------###-------###-------###-------###-------###-------###-------###-------###-------###-----
---##--##----##--##----##--##----##--##----##--##----##--##----##--##----##--##----##--##----##--##-
--#---------#---------#---------#---------#---------#---------#---------#---------#---------#-------
#---#--#-##---#--#-##---#--#-##---#--#-##---#--#-##---#--#-##---#--#-##---#--#-##---#--#-##---#--#-#
#---#-----#---#-----#---#-----#---#-----#---#-----#---#-----#---#-----#---#-----#---#-----#---#-----
---#-#-#-----#-#-#-----#-#-#-----#-#-#-----#-#-#-----#-#-#-----#-#-#-----#-#-#-----#-#-#-----#-#-#--
#-----#---#-----#---#-----#---#-----#---#-----#---#-----#---#-----#---#-----#---#-----#---#-----#---
-----#--#------#--#------#--#------#--#------#--#------#--#------#--#------#--#------#--#------#--#-
-#---#-----#---#-----#---#-----#---#-----#---#-----#---#-----#---#-----#---#-----#---#-----#---#----
---#-#-------#-#-------#-#-------#S#-------#-#-------#-#-------#-#-------#-#-------#-#-------#-#----
--###-------###-------###-------###-------###-------###-------###-------###-------###-------###-----
---##--##----##--##----##--##----##--##----##--##----##--##----##--##----##--##----##--##----##--##-
--#---------#---------#---------#---------#---------#---------#---------#---------#---------#-------
#---#--#-##---#--#-##---#--#-##---#--#-##---#--#-##---#--#-##---#--#-##---#--#-##---#--#-##---#--#-#
#---#-----#---#-----#---#-----#---#-----#---#-----#---#-----#---#-----#---#-----#---#-----#---#-----
---#-#-#-----#-#-#-----#-#-#-----#-#-#-----#-#-#-----#-#-#-----#-#-#-----#-#-#-----#-#-#-----#-#-#--
#-----#---#-----#---#-----#---#-----#---#-----#---#-----#---#-----#---#-----#---#-----#---#-----#---
-----#--#------#--#------#--#------#--#------#--#------#--#------#--#------#--#------#--#------#--#-
-#---#-----#---#-----#---#-----#---#-----#---#-----#---#-----#---#-----#---#-----#---#-----#---#----
---#-#-------#-#-------#-#-------#-#-------#-#-------#-#-------#-#-------#-#-------#-#-------#-#----
--###-------###-------###-------###-------###-------###-------###-------###-------###-------###-----
---##--##----##--##----##--##----##--##----##--##----##--##----##--##----##--##----##--##----##--##-
--#---------#---------#---------#---------#---------#---------#---------#---------#---------#-------
#---#--#-##---#--#-##---#--#-##---#--#-##---#--#-##---#--#-##---#--#-##---#--#-##---#--#-##---#--#-#
#---#-----#---#-----#---#-----#---#-----#---#-----#---#-----#---#-----#---#-----#---#-----#---#-----
---#-#-#-----#-#-#-----#-#-#-----#-#-#-----#-#-#-----#-#-#-----#-#-#-----#-#-#-----#-#-#-----#-#-#--
#-----#---#-----#---#-----#---#-----#---#-----#---#-----#---#-----#---#-----#---#-----#---#-----#---
-----#--#------#--#------#--#------#--#------#--#------#--#------#--#------#--#------#--#------#--#-
-#---#-----#---#-----#---#-----#---#-----#---#-----#---#-----#---#-----#---#-----#---#-----#---#----
---#-#-------#-#-------#-#-------#-#-------#-#-------#-#-------#-#-------#-#-------#-#-------#-#----
--###-------###-------###-------###-------###-------###-------###-------###-------###-------###-----
---##--##----##--##----##--##----##--##----##--##----##--##----##--##----##--##----##--##----##--##-
--#---------#---------#---------#---------#---------#---------#---------#---------#---------#-------
#---#--#-##---#--#-##---#--#-##---#--#-##---#--#-##---#--#-##---#--#-##---#--#-##---#--#-##---#--#-#
#---#-----#---#-----#---#-----#---#-----#---#-----#---#-----#---#-----#---#-----#---#-----#---#-----
---#-#-#-----#-#-#-----#-#-#-----#-#-#-----#-#-#-----#-#-#-----#-#-#-----#-#-#-----#-#-#-----#-#-#--
#-----#---#-----#---#-----#---#-----#---#-----#---#-----#---#-----#---#-----#---#-----#---#-----#---
-----#--#------#--#------#--#------#--#------#--#------#--#------#--#------#--#------#--#------#--#-
-#---#-----#---#-----#---#-----#---#-----#---#-----#---#-----#---#-----#---#-----#---#-----#---#----
---#-#-------#-#-------#-#-------#-#-------#-#-------#-#-------#-#-------#-#-------#-#-------#-#----
--###-------###-------###-------###-------###-------###-------###-------###-------###-------###-----
---##--##----##--##----##--##----##--##----##--##----##--##----##--##----##--##----##--##----##--##-
--#---------#---------#---------#---------#---------#---------#---------#---------#---------#-------
#---#--#-##---#--#-##---#--#-##---#--#-##---#--#-##---#--#-##---#--#-##---#--#-##---#--#-##---#--#-#
#---#-----#---#-----#---#-----#---#-----#---#-----#---#-----#---#-----#---#-----#---#-----#---#-----
---#-#-#-----#-#-#-----#-#-#-----#-#-#-----#-#-#-----#-#-#-----#-#-#-----#-#-#-----#-#-#-----#-#-#--
#-----#---#-----#---#-----#---#-----#---#-----#---#-----#---#-----#---#-----#---#-----#---#-----#---
-----#--#------#--#------#--#------#--#------#--#------#--#------#--#------#--#------#--#------#--#-
-#---#-----#---#-----#---#-----#---#-----#---#-----#---#-----#---#-----#---#-----#---#-----#---#----
---#-#-------#-#-------#-#-------#-#-------#-#-------#-#-------#-#-------#-#-------#-#-------#-#----
--###-------###-------###-------###-------###-------###-------###-------###-------###-------###-----
---##--##----##--##----##--##----##--##----##--##----##--##----##--##----##--##----##--##----##--##-
--#---------#---------#---------#---------#---------#---------#---------#---------#---------#-------
#---#--#-##---#--#-##---#--#-##---#--#-##---#--#-##---#--#-##---#--#-##---#--#-##---#--#-##---#--#-#
#---#-----#---#-----#---#-----#---#-----#---#-----#---#-----#---#-----#---#-----#---#-----#---#-----
---#-#-#-----#-#-#-----#-#-#-----#-#-#-----#-#-#-----#-#-#-----#-#-#-----#-#-#-----#-#-#-----#-#-#--
#-----#---#-----#---#-----#---#-----#---#-----#---#-----#---#-----#---#-----#---#-----#---#-----#---
-----#--#------#--#------#--#------#--#------#--#------#--#------#--#------#--#------#--#------#--#-
-#---#-----#---#-----#---#-----#---#-----#---#-----#---#-----#---#-----#---#-----#---#-----#---#----
---#-#-------#-#-------#-#-------#-#-------#-#-------#-#-------#-#-------#-#-------#-#-------#-#----
--###-------###-------###-------###-------###-------###-------###-------###-------###-------###-----
---##--##----##--##----##--##----##--##----##--##----##--##----##--##----##--##----##--##----##--##-
--#---------#---------#---------#---------#---------#---------#---------#---------#---------#-------
#---#--#-##---#--#-##---#--#-##---#--#-##---#--#-##---#--#-##---#--#-##---#--#-##---#--#-##---#--#-#
#---#-----#---#-----#---#-----#---#-----#---#-----#---#-----#---#-----#---#-----#---#-----#---#-----
---#-#-#-----#-#-#-----#-#-#-----#-#-#-----#-#-#-----#-#-#-----#-#-#-----#-#-#-----#-#-#-----#-#-#--
#-----#---#-----#---#-----#---#-----#---#-----#---#-----#---#-----#---#-----#---#-----#---#-----#---
-----#--#------#--#------#--#------#--#------#--#------#--#------#--#------#--#------#--#------#--#-
-#---#-----#---#-----#---#-----#---#-----#---#-----#---#-----#---#-----#---#-----#---#-----#---#----
---#-#-------#-#-------#-#-------#-#-------#-#-------#-#-------#-#-------#-#-------#-#-------#-#----
