--###----#--###----#--###----#--###----#--###----#--###----#--###----#--###----#--###----#--###----#
#--#------#--#------#--#------#--#------#--#------#--#------#--#------#--#------#--#------#--#------
-###---#---###---#---###---#---###---#---###---#---###---#---###---#---###---#---###---#---###---#--
-##---#----##---#----##---#----##---#----##---#----##---#----##---#----##---#----##---#----##---#---
----#-#-#-----#-#-#-----#-#-#-----#-#-#-----#-#-#-----#-#-#-----#-#-#-----#-#-#-----#-#-#-----#-#-#-
-------#---------#---------#---------#---------#---------#---------#---------#---------#---------#--
-#---#-#---#---#-#---#---#-#---#---#-#---#---#-#---#---#-#---#---#-#---#---#-#---#---#-#---#---#-#--
----------------------------------------------------------------------------------------------------
----##--#-----##--#-----##--#-----##--#-----##--#-----##--#-----##--#-----##--#-----##--#-----##--#-
-#-------#-#-------#-#-------#-#-------#-#-------#-#-------#-#-------#-#-------#-#-------#-#-------#
--###----#--###----#--###----#--###----#--###----#--###----#--###----#--###----#--###----#--###----#
#--#------#--#------#--#------#--#------#--#------#--#------#--#------#--#------#--#------#--#------
-###---#---###---#---###---#---###---#---###---#---###---#---###---#---###---#---###---#---###---#--
-##---#----##---#----##---#----##---#----##---#----##---#----##---#----##---#----##---#----##---#---
----#-#-#-----#-#-#-----#-#-#-----#-#-#-----#-#-#-----#-#-#-----#-#-#-----#-#-#-----#-#-#-----#-#-#-
-------#---------#---------#---------#---------#---------#---------#---------#---------#---------#--
-#---#-#---#---#-#---#---#-#---#---#-#---#---#-#---#---#-#---#---#-#---#---#-#---#---#-#---#---#-#--
----------------------------------------------------------------------------------------------------
----##--#-----##--#-----##--#-----##--#-----##--#-----##--#-----##--#-----##--#-----##--#-----##--#-
-#-------#-#-------#-#-------#-#-------#-#-------#-#-------#-#-------#-#-------#-#-------#-#-------#
--###----#--###----#--###----#--###----#--###----#--###----#--###----#--###----#--###----#--###----#
#--#------#--#------#--#------#--#------#--#------#--#------#--#------#--#------#--#------#--#------
-###---#---###---#---###---#---###---#---###---#---###---#---###---#---###---#---###---#---###---#--
-##---#----##---#----##---#----##---#----##---#----##---#----##---#----##---#----##---#----##---#---
----#-#-#-----#-#-#-----#-#-#-----#-#-#-----#-#-#-----#-#-#-----#-#-#-----#-#-#-----#-#-#-----#-#-#-
-------#---------#---------#---------#---------#---------#---------#---------#---------#---------#--
-#---#-#---#---#-#---#---#-#---#---#-#---#---#-#---#---#E#---#---#-#---#---#-#---#---#-#---#---#-#--
----------------------------------------------------------------------------------------------------
----##--#-----##--#-----##--#-----##--#-----##--#-----##--#-----##--#-----##--#-----##--#-----##--#-
-#-------#-#-------#-#-------#-#-------#-#-------#-#-------#-#-------#-#-------#-#-------#-#-------#
--###----#--###----#--###----#--###----#--###----#--###----#--###----#--###----#--###----#--###----#
#--#------#--#------#--#------#--#------#--#------#--#------#--#------#--#------#--#------#--#------
-###---#---###---#---###---#---###---#---###---#---###---#---###---#---###---#---###---#---###---#--
-##---#----##---#----##---#----##---#----##---#----##---#----##---#----##---#----##---#----##---#---
----#-#-#-----#-#-#-----#-#-#-----#-#-#-----#-#-#-----#-#-#-----#-#-#-----#-#-#-----#-#-#-----#-#-#-
-------#---------#---------#---------#---------#---------#---------#---------#---------#---------#--
-#---#-#---#---#-#---#---#-#---#---#-#---#---#-#---#---#-#---#---#-#---#---#-#---#---#-#---#---#-#--
----------------------------------------------------------------------------------------------------
----##--#-----##--#---S-##--#-----##--#-----##--#-----##--#-----##--#-----##--#-----##--#-----##--#-
-#-------#-#-------#-#-------#-#-------#-#-------#-#-------#-#-------#-#-------#-#-------#-#-------#
--###----#--###----#--###----#--###----#--###----#--###----#--###----#--###----#--###----#--###----#
#--#------#--#------#--#------#--#------#--#------#--#------#--#------#--#------#--#------#--#------
-###---#---###---#---###---#---###---#---###---#---###---#---###---#---###---#---###---#---###---#--
-##---#----##---#----##---#----##---#----##---#----##---#----##---#----##---#----##---#----##---#---
----#-#-#-----#-#-#-----#-#-#-----#-#-#-----#-#-#-----#-#-#-----#-#-#-----#-#-#-----#-#-#-----#-#-#-
-------#---------#---------#---------#---------#---------#---------#---------#---------#---------#--
-#---#-#---#---#-#---#---#-#---#---#-#---#---#-#---#---#-#---#---#-#---#---#-#---#---#-#---#---#-#--
----------------------------------------------------------------------------------------------------
----##--#-----##--#-----##--#-----##--#-----##--#-----##--#-----##--#-----##--#-----##--#-----##--#-
-#-------#-#-------#-#-------#-#-------#-#-------#-#-------#-#-------#-#-------#-#-------#-#-------#
--###----#--###----#--###----#--###----#--###----#--###----#--###----#--###----#--###----#--###----#
#--#------#--#------#--#------#--#------#--#------#--#------#--#------#--#------#--#------#--#------
-###---#---###---#---###---#---###---#---###---#---###---#---###---#---###---#---###---#---###---#--
-##---#----##---#----##---#----##---#----##---#----##---#----##---#----##---#----##---#----##---#---
----#-#-#-----#-#-#-----#-#-#-----#-#-#-----#-#-#-----#-#-#-----#-#-#-----#-#-#-----#-#-#-----#-#-#-
-------#---------#---------#---------#---------#---------#---------#---------#---------#---------#--
-#---#-#---#---#-#---#---#-#---#---#-#---#---#-#---#---#-#---#---#-#---#---#-#---#---#-#---#---#-#--
----------------------------------------------------------------------------------------------------
----##--#-----##--#-----##--#-----##--#-----##--#-----##--#-----##--#-----##--#-----##--#-----##--#-
-#-------#-#-------#-#-------#-#-------#-#-------#-#-------#-#-------#-#-------#-#-------#-#-------#
--###----#--###----#--###----#--###----#--###----#--###----#--###----#--###----#--###----#--###----#
#--#------#--#------#--#------#--#------#--#------#--#------#--#------#--#------#--#------#--#------
-###---#---###---#---###---#---###---#---###---#---###---#---###---#---###---#---###---#---###---#--
-##---#----##---#----##---#----##---#----##---#----##---#----##---#----##---#----##---#----##---#---
----#-#-#-----#-#-#-----#-#-#-----#-#-#-----#-#-#-----#-#-#-----#-#-#-----#-#-#-----#-#-#-----#-#-#-
-------#---------#---------#---------#---------#---------#---------#---------#---------#---------#--
-#---#-#---#---#-#---#---#-#---#---#-#---#---#-#---#---#-#---#---#-#---#---#-#---#---#-#---#---#-#--
----------------------------------------------------------------------------------------------------
----##--#-----##--#-----##--#-----##--#-----##--#-----##--#-----##--#-----##--#-----##--#-----##--#-
-#-------#-#-------#-#-------#-#-------#-#-------#-#-------#-#-------#-#-------#-#-------#-#-------#
--###----#--###----#--###----#--###----#--###----#--###----#--###----#--###----#--###----#--###----#
#--#------#--#------#--#------#--#------#--#------#--#------#--#------#--#------#--#------#--#------
-###---#---###---#---###---#---###---#---###---#---###---#---###---#---###---#---###---#---###---#--
-##---#----##---#----##---#----##---#----##---#----##---#----##---#----##---#----##---#----##---#---
----#-#-#-----#-#-#-----#-#-#-----#-#-#-----#-#-#-----#-#-#-----#-#-#-----#-#-#-----#-#-#-----#-#-#-
-------#---------#---------#---------#---------#---------#---------#---------#---------#---------#--
-#---#-#---#---#-#---#---#-#---#---#-#---#---#-#---#---#-#---#---#-#---#---#-#---#---#-#---#---#-#--
----------------------------------------------------------------------------------------------------
----##--#-----##--#-----##--#-----##--#-----##--#-----##--#-----##--#-----##--#-----##--#-----##--#-
-#-------#-#-------#-#-------#-#-------#-#-------#-#-------#-#-------#-#-------#-#-------#-#-------#
--###----#--###----#--###----#--###----#--###----#--###----#--###----#--###----#--###----#--###----#
#--#------#--#------#--#------#--#------#--#------#--#------#--#------#--#------#--#------#--#------
-###---#---###---#---###---#---###---#---###---#---###---#---###---#---###---#---###---#---###---#--
-##---#----##---#----##---#----##---#----##---#----##---#----##---#----##---#----##---#----##---#---
----#-#-#-----#-#-#-----#-#-#-----#-#-#-----#-#-#-----#-#-#-----#-#-#-----#-#-#-----#-#-#-----#-#-#-
-------#---------#---------#---------#---------#---------#---------#---------#---------#---------#--
-#---#-#---#---#-#---#---#-#---#---#-#---#---#-#---#---#-#---#---#-#---#---#-#---#---#-#---#---#-#--
----------------------------------------------------------------------------------------------------
----##--#-----##--#-----##--#-----##--#-----##--#-----##--#-----##--#-----##--#-----##--#-----##--#-
-#-------#-#-------#-#-------#-#-------#-#-------#-#-------#-#-------#-#-------#-#-------#-#-------#
--###----#--###----#--###----#--###----#--###----#--###----#--###----#--###----#--###----#--###----#
#--#------#--#------#--#------#--#------#--#------#--#------#--#------#--#------#--#------#--#------
-###---#---###---#---###---#---###---#---###---#---###---#---###---#---###---#---###---#---###---#--
-##---#----##---#----##---#----##---#----##---#----##---#----##---#----##---#----##---#----##---#---
----#-#-#-----#-#-#-----#-#-#-----#-#-#-----#-#-#-----#-#-#-----#-#-#-----#-#-#-----#-#-#-----#-#-#-
-------#---------#---------#---------#---------#---------#---------#---------#---------#---------#--
-#---#-#---#---#-#---#---#-#---#---#-#---#---#-#---#---#-#---#---#-#---#---#-#---#---#-#---#---#-#--
----------------------------------------------------------------------------------------------------
----##--#-----##--#-----##--#-----##--#-----##--#-----##--#-----##--#-----##--#-----##--#-----##--#-
-#-------#-#-------#-#-------#-#-------#-#-------#-#-------#-#-------#-#-------#-#-------#-#-------#
