#----#----#----#----#----#----#----#----#----#----#----#----#----#----#----#----#----#----#----#----
------#-#-------#-#-------#-#-------#-#-------#-#-------#-#-------#-#-------#-#-------#-#-------#-#-
--------#---------#---------#---------#---------#---------#---------#---------#---------#---------#-
-#--#-#-#--#--#-#-#--#--#-#-#--#--#-#-#--#--#-#-#--#--#-#-#--#--#-#-#--#--#-#-#--#--#-#-#--#--#-#-#-
-----#---------#---------#---------#---------#---------#---------#---------#---------#---------#----
#-#---#---#-#---#---#-#---#---#-#---#---#-#---#---#-#---#---#-#---#---#-#---#---#-#---#---#-#---#---
#-##----#-#-##----#-#-##----#-#-##----#-#-##----#-#-##----#-#-##----#-#-##----#-#-##----#-#-##----#-
#---#----##---#----##---#----##---#----##---#----##---#----##---#----##---#----##---#----##---#----#
#---#-----#---#-----#---#-----#---#-----#---#-----#---#-----#---#-----#---#-----#---#-----#---#-----
--#---#-----#---#-----#---#-----#---#-----#---#-----#---#-----#---#-----#---#-----#---#-----#---#---
#----#----#----#----#----#----#----#----#----#----#----#----#----#----#----#----#----#----#----#----
------#-#-------#-#-------#-#-------#-#-------#-#-------#-#-------#-#-------#-#-------#-#-------#-#-
--------#---------#---------#---------#---------#---------#---------#---------#---------#---------#-
-#--#-#-#--#--#-#-#--#--#-#-#--#--#-#-#--#--#-#-#--#--#-#-#--#--#-#-#--#--#-#-#--#--#-#-#--#--#-#-#-
-----#---------#---------#---------#---------#---------#---------#---------#---------#---------#----
#-#---#---#-#---#---#-#---#---#-#---#---#-#---#---#-#---#---#-#---#---#-#---#---#-#---#---#-#---#---
#-##----#-#-##----#-#-##----#-#-##----#-#-##----#-#-##----#-#-##----#-#-##----#-#-##----#-#-##----#-
#---#----##---#----##---#----##---#----##---#----##---#----##---#----##---#----##---#----##---#----#
#---#-----#---#-----#---#-----#---#-----#---#-----#---#-----#---#-----#---#-----#---#-----#---#-----
--#---#-----#---#-----#---#-----#---#-----#---#-----#---#-----#---#-----#---#-----#---#-----#---#---
#----#----#----#----#----#----#----#----#----#----#----#----#----#----#----#----#----#----#----#----
------#-#-------#-#-------#-#-------#-#-------#-#-------#-#-------#-#-------#-#-------#-#-------#-#-
--------#---------#---------#---------#---------#---------#---------#---------#---------#---------#-
-#--#-#-#--#--#-#-#--#--#-#-#--#--#-#-#--#--#-#-#--#--#-#-#--#--#-#-#--#--#-#-#--#--#-#-#--#--#-#-#-
-----#---------#---------#---------#---------#---------#---------#---------#---------#---------#----
#-#---#---#-#---#---#-#---#---#-#---#---#-#---#---#-#---#---#-#---#---#-#---#---#-#---#---#-#---#---
#-##----#-#-##----#-#-##----#-#-##----#-#-##----#-#-##----#-#-##----#-#-##----#-#-##----#-#-##----#-
#---#----##---#----##---#----##---#----##---#----##---#----##---#----##---#----##---#----##---#----#
#---#-----#---#-----#---#-----#---#-----#---#-----#---#-----#---#-----#---#-----#---#-----#---#-----
--#---#-----#---#-----#---#-----#---#-----#---#-----#---#-----#---#-----#---#-----#---#-----#---#---
#----#----#----#----#----#----#----#----#----#----#----#----#----#----#----#----#----#----#----#----
------#-#-------#-#-------#-#-------#-#-------#-#-------#-#-------#-#-------#-#-------#-#-------#-#-
--------#---------#---------#---------#---------#---------#---------#---------#---------#---------#-
-#--#-#-#--#--#-#-#--#--#-#-#--#--#-#-#--#--#-#-#--#--#-#-#--#--#-#-#--#--#-#-#--#--#-#-#--#--#-#-#-
-----#---------#---------#---------#---------#---------#---------#---------#---------#---------#----
#-#---#---#-#---#---#-#---#---#-#---#---#-#---#---#-#---#---#-#---#---#-#---#---#-#---#---#-#---#---
#-##----#-#-##----#-#-##----#-#-##----#-#-##----#-#-##----#-#-##----#-#-##----#-#-##----#-#-##----#-
#---#----##---#----##---#----##---#----##---#----##---#----##---#----##---#----##---#----##---#----#
#---#-----#---#-----#---#-----#---#--E--#---#-----#---#-----#---#-----#---#-----#---#-----#---#-----
--#---#-----#---#-----#---#-----#---#-----#---#-----#---#-----#---#-----#---#-----#---#-----#---#---
#----#----#----#----#----#----#----#----#----#----#----#----#----#----#----#----#----#----#----#----
------#-#-------#-#-------#-#-------#-#-------#-#-------#-#-------#-#-------#-#-------#-#-------#-#-
--------#---------#---------#---------#---------#---------#---------#---------#---------#---------#-
-#--#-#-#--#--#-#-#--#--#-#-#--#--#-#-#--#--#-#-#--#--#-#-#--#--#-#-#--#--#-#-#--#--#-#-#--#--#-#-#-
-----#---------#---------#---------#---------#---------#---------#---------#---------#---------#----
#-#---#---#-#---#---#-#---#---#-#---#---#-#---#---#-#---#---#-#---#---#-#---#---#-#---#---#-#---#---
#-##----#-#-##----#-#-##----#-#-##----#-#-##----#-#-##----#-#-##----#-#-##----#-#-##----#-#-##----#-
#---#----##---#----##---#----##---#----##---#----##---#----##---#----##---#----##---#----##---#----#
#---#-----#---#-----#---#-----#---#-----#---#-----#---#-----#---#-----#---#-----#---#-----#---#-----
--#---#-----#---#-----#---#-----#---#-----#---#-----#---#-----#---#-----#---#-----#---#-----#---#---
#----#----#----#----#----#----#----#----#----#----#----#----#----#----#----#----#----#----#----#----
------#-#-------#-#-------#-#-------#-#-------#-#-------#-#-------#-#-------#-#-------#-#-------#-#-
--------#---------#---------#---------#---------#---------#---------#---------#---------#---------#-
-#--#-#-#--#--#-#-#--#--#-#-#--#--#-#-#--#--#-#-#--#--#-#-#--#--#-#-#--#--#-#-#--#--#-#-#--#--#-#-#-
-----#---------#---------#---------#---------#---------#---------#---------#---------#---------#----
#-#---#---#-#---#---#-#---#---#-#---#---#-#---#---#-#---#---#-#---#---#-#---#---#-#---#---#-#---#---
#-##----#-#-##----#-#-##----#-#-##----#-#-##----#-#-##----#-#-##----#-#-##----#-#-##----#-#-##----#-
#---#----##---#----##---#----##---#----##---#----##---#----##---#----##---#----##---#----##---#----#
#---#-----#---#-----#---#-----#---#-----#---#-----#---#-----#---#-----#---#-----#---#-----#---#-----
--#---#-----#---#-----#---#-----#---#-----#---#-----#---#-----#---#-----#---#-----#---#-----#---#---
#----#----#----#----#----#----#----#----#----#----#----#----#----#----#----#----#----#----#----#----
------#-#-------#-#-------#-#-------#-#-------#-#-------#-#-------#-#-------#-#-------#-#-------#-#-
--------#---------#---------#---------#---------#---------#---------#---------#---------#---------#-
-#--#-#-#--#--#-#-#--#--#-#-#--#--#-#-#--#--#-#-#--#--#-#-#--#--#-#-#--#--#-#-#--#--#-#-#--#--#-#-#-
-----#---------#---------#---------#---------#---------#---------#---------#---------#---------#----
#-#---#---#-#---#---#-#---#---#-#---#---#-#---#---#-#---#---#-#---#---#-#---#---#-#---#---#-#---#---
#-##----#-#-##----#-#-##----#-#-##----#-#-##----#-#-##----#-#-##----#-#-##----#-#-##----#-#-##----#-
#---#----##---#----##---#----##---#----##---#----##---#----##---#----##---#----##---#----##---#----#
#---#-----#---#-----#---#-----#---#-----#---#-----#---#-----#---#-----#---#-----#---#-----#---#-----
--#---#-----#---#-----#---#-----#---#-----#---#-----#---#-----#---#-----#---#-----#---#-----#---#---
#----#----#----#----#----#----#----#----#----#----#----#----#----#----#----#----#----#----#----#----
------#-#-------#-#-------#-#-------#-#-------#-#-------#-#-------#-#-------#-#-------#-#-------#-#-
--------#---------#---------#---------#---------#---------#---------#---------#---------#---------#-
-#--#-#-#--#--#-#-#--#--#-#-#--#--#-#-#--#--#-#-#--#--#-#-#--#--#-#-#--#--#-#-#--#--#-#-#--#--#-#-#-
-----#---------#---------#---------#---------#---------#---------#---------#---------#---------#----
#-#---#---#-#---#---#-#---#---#-#---#---#-#---#---#-#---#---#-#---#---#-#---#---#-#---#---#-#---#---
#-##----#-#-##----#-#-##----#-#-##----#-#-##----#-#-##----#-#-##----#-#-##----#-#-##----#-#-##----#-
#---#----##---#----##---#----##---#----##---#----##---#----##---#----##---#----##---#----##---#----#
#---#-----#---#-----#---#-----#---#-----#---#-----#---#-----#---#-----#---#-----#---#-----#---#-----
--#---#-----#---#-----#---#-----#---#-----#---#-----#---#-----#---#-----#---#-----#---#-----#---#---
#----#----#----#----#----#----#----#----#----#----#----#----#----#----#----#----#----#----#----#----
------#-#-------#-#-------#-#S------#-#-------#-#-------#-#-------#-#-------#-#-------#-#-------#-#-
--------#---------#---------#---------#---------#---------#---------#---------#---------#---------#-
-#--#-#-#--#--#-#-#--#--#-#-#--#--#-#-#--#--#-#-#--#--#-#-#--#--#-#-#--#--#-#-#--#--#-#-#--#--#-#-#-
-----#---------#---------#---------#---------#---------#---------#---------#---------#---------#----
#-#---#---#-#---#---#-#---#---#-#---#---#-#---#---#-#---#---#-#---#---#-#---#---#-#---#---#-#---#---
#-##----#-#-##----#-#-##----#-#-##----#-#-##----#-#-##----#-#-##----#-#-##----#-#-##----#-#-##----#-
#---#----##---#----##---#----##---#----##---#----##---#----##---#----##---#----##---#----##---#----#
#---#-----#---#-----#---#-----#---#-----#---#-----#---#-----#---#-----#---#-----#---#-----#---#-----
--#---#-----#---#-----#---#-----#---#-----#---#-----#---#-----#---#-----#---#-----#---#-----#---#---
#----#----#----#----#----#----#----#----#----#----#----#----#----#----#----#----#----#----#----#----
------#-#-------#-#-------#-#-------#-#-------#-#-------#-#-------#-#-------#-#-------#-#-------#-#-
--------#---------#---------#---------#---------#---------#---------#---------#---------#---------#-
-#--#-#-#--#--#-#-#--#--#-#-#--#--#-#-#--#--#-#-#--#--#-#-#--#--#-#-#--#--#-#-#--#--#-#-#--#--#-#-#-
-----#---------#---------#---------#---------#---------#---------#---------#---------#---------#----
#-#---#---#-#---#---#-#---#---#-#---#---#-#---#---#-#---#---#-#---#---#-#---#---#-#---#---#-#---#---
#-##----#-#-##----#-#-##----#-#-##----#-#-##----#-#-##----#-#-##----#-#-##----#-#-##----#-#-##----#-
#---#----##---#----##---#----##---#----##---#----##---#----##---#----##---#----##---#----##---#----#
#---#-----#---#-----#---#-----#---#-----#---#-----#---#-----#---#-----#---#-----#---#-----#---#-----
--#---#-----#---#-----#---#-----#---#-----#---#-----#---#-----#---#-----#---#-----#---#-----#---#---
