----##--------##--------##--------##--------##--------##--------##--------##--------##--------##----
-###----#--###----#--###----#--###----#--###----#--###----#--###----#--###----#--###----#--###----#-
#-#-------#-#-------#-#-------#-#-------#-#-------#-#-------#-#-------#-#-------#-#-------#-#-------
#--#-----##--#-----##--#-----##--#-----##--#-----##--#-----##--#-----##--#-----##--#-----##--#-----#
#----##---#----##---#----##---#----##---#----##---#----##---#----##---#----##---#----##---#----##---
#-#-------#-#-------#-#-------#-#-------#-#-------#-#-------#-#-------#-#-------#-#-------#-#-------
---#-----#---#-----#---#-----#---#-----#---#-----#---#-----#---#-----#---#-----#---#-----#---#-----#
-###----##-###----##-###----##-###----##-###----##-###----##-###----##-###----##-###----##-###----##
-#---------#---------#---------#---------#---------#---------#---------#---------#---------#--------
---#----##---#----##---#----##---#----##---#----##---#----##---#----##---#----##---#----##---#----##
----##--------##--------##--------##--------##--------##--------##--------##--------##--------##----
-###----#--###----#--###----#--###----#--###----#--###----#--###----#--###----#--###----#--###----#-
#-#-------#-#-------#-#-------#-#-------#-#-------#-#-------#-#-------#-#-------#-#-------#-#-------
#--#-----##--#-----##--#-----##--#-----##--#-----##--#-----##--#-----##--#-----##--#-----##--#-----#
#----##---#----##---#----##---#----##---#----##---#----##---#----##---#----##---#----##---#----##---
#-#-------#-#-------#-#-------#-#-------#-#-------#-#-------#-#-------#-#-------#-#-------#-#-------
---#-----#---#-----#---#-----#---#-----#---#-----#---#-----#---#-----#---#-----#---#-----#---#-----#
-###----##-###----##-###----##-###----##-###----##-###----##-###----##-###----##E###----##-###----##
-#---------#---------#---------#---------#---------#---------#---------#---------#---------#--------
---#----##---#----##---#----##---#----##---#----##---#----##---#----##---#----##---#----##---#----##
----##--------##--------##--------##--------##--------##--------##--------##--------##--------##----
-###----#--###----#--###----#--###----#--###----#--###----#--###----#--###----#--###----#--###----#-
#-#-------#-#-------#-#-------#-#-------#-#-------#-#-------#-#-------#-#-------#-#-------#-#-------
#--#-----##--#-----##--#-----##--#-----##--#-----##--#-----##--#-----##--#-----##--#-----##--#-----#
#----##---#----##---#----##---#----##---#----##---#----##---#----##---#----##---#----##---#----##---
#-#-------#-#-------#-#-------#-#-------#-#-------#-#-------#-#-------#-#-------#-#-------#-#-------
---#-----#---#-----#---#-----#---#-----#---#-----#---#-----#---#-----#---#-----#---#-----#---#-----#
-###----##-###----##-###----##-###----##-###----##-###----##-###----##-###----##-###----##-###----##
-#---------#---------#---------#---------#---------#---------#---------#---------#---------#--------
---#----##---#----##---#----##---#----##---#----##---#----##---#----##---#----##---#----##---#----##
----##--------##--------##--------##--------##--------##--------##--------##--------##--------##----
-###----#--###----#--###----#--###----#--###----#--###----#--###----#--###----#--###----#--###----#-
#-#-------#-#-------#-#-------#-#-------#-#-------#-#-------#-#-------#-#-------#-#-------#-#-------
#--#-----##--#-----##--#-----##--#-----##--#-----##--#-----##--#-----##--#-----##--#-----##--#-----#
#----##---#----##---#----##---#----##---#----##---#----##---#----##---#----##---#----##---#----##---
#-#-------#-#-------#-#-------#-#-------#-#-------#-#-------#-#-------#-#-------#-#-------#-#-------
---#-----#---#-----#---#-----#---#-----#---#-----#---#-----#---#-----#---#-----#---#-----#---#-----#
-###----##-###----##-###----##-###----##-###----##-###----##-###----##-###----##-###----##-###----##
-#---------#---------#---------#---------#---------#---------#---------#---------#---------#--------
---#----##---#----##---#----##---#----##---#----##---#----##---#----##---#----##---#----##---#----##
----##--------##--------##--------##--------##--------##--------##--------##--------##--------##----
-###----#--###----#--###----#--###----#--###----#--###----#--###----#--###----#--###----#--###----#-
#-#-------#-#-------#-#-------#-#-------#-#-------#-#-------#-#-------#-#-------#-#-------#-#-------
#--#-----##--#-----##--#-----##--#-----##--#-----##--#-----##--#-----##--#-----##--#-----##--#-----#
#----##---#----##---#----##---#----##---#----##---#----##---#----##---#----##---#----##---#----##---
#-#-------#-#-------#-#-------#-#-------#-#-------#-#-------#-#-------#-#-------#-#-------#-#-------
---#-----#---#-----#---#-----#---#-----#---#-----#---#-----#---#-----#---#-----#---#-----#---#-----#
-###----##-###----##-###----##-###----##-###----##-###----##-###----##-###----##-###----##-###----##
-#---------#---------#---------#---------#---------#---------#---------#---------#---------#--------
---#----##---#----##---#----##---#----##---#----##---#----##---#----##---#----##---#----##---#----##
----##--------##--------##--------##--------##--------##--------##--------##--------##--------##----
-###----#--###----#--###----#--###----#--###----#--###----#--###----#--###----#--###----#--###----#-
#-#-------#-#-------#-#-------#-#-------#-#-------#-#-------#-#-------#-#-------#-#-------#-#-------
#--#-----##--#-----##--#-----##--#-----##--#-----##--#-----##--#-----##--#-----##--#-----##--#-----#
#----##---#----##---#----##---#----##---#----##---#----##---#----##---#----##---#----##---#----##---
#-#-------#-#-------#-#-------#-#-------#-#-------#-#-------#-#-------#-#-------#-#-------#-#-------
---#-----#---#-----#---#-----#---#-----#---#-----#---#-----#---#-----#---#-----#---#-----#---#-----#
-###----##-###----##-###----##-###----##-###----##-###----##-###----##-###----##-###----##-###----##
-#---------#---------#---------#---------#---------#---------#---------#---------#---------#--------
---#----##---#----##---#----##---#----##---#----##---#----##---#----##---#----##---#----##---#----##
----##--------##--------##--------##--------##--------##--------##--------##--------##--------##----
-###----#--###----#--###----#--###----#--###----#--###----#--###----#--###----#--###----#--###----#-
#-#-------#-#-------#-#-------#-#-------#-#-------#-#-------#-#-------#-#-------#-#-------#-#-------
#--#-----##--#-----##--#-----##--#-----##--#-----##--#-----##--#-----##--#-----##--#-----##--#-----#
#----##---#----##---#----##---#----##---#----##---#----##---#----##---#----##---#----##---#----##---
#-#-------#-#-------#-#-------#-#-------#-#-------#-#-------#-#-------#-#-------#-#-------#-#-------
---#-----#---#-----#---#-----#---#-----#---#-----#---#-----#---#S----#---#-----#---#-----#---#-----#
-###----##-###----##-###----##-###----##-###----##-###----##-###----##-###----##-###----##-###----##
-#---------#---------#---------#---------#---------#---------#---------#---------#---------#--------
---#----##---#----##---#----##---#----##---#----##---#----##---#----##---#----##---#----##---#----##
----##--------##--------##--------##--------##--------##--------##--------##--------##--------##----
-###----#--###----#--###----#--###----#--###----#--###----#--###----#--###----#--###----#--###----#-
#-#-------#-#-------#-#-------#-#-------#-#-------#-#-------#-#-------#-#-------#-#-------#-#-------
#--#-----##--#-----##--#-----##--#-----##--#-----##--#-----##--#-----##--#-----##--#-----##--#-----#
#----##---#----##---#----##---#----##---#----##---#----##---#----##---#----##---#----##---#----##---
#-#-------#-#-------#-#-------#-#-------#-#-------#-#-------#-#-------#-#-------#-#-------#-#-------
---#-----#---#-----#---#-----#---#-----#---#-----#---#-----#---#-----#---#-----#---#-----#---#-----#
-###----##-###----##-###----##-###----##-###----##-###----##-###----##-###----##-###----##-###----##
-#---------#---------#---------#---------#---------#---------#---------#---------#---------#--------
---#----##---#----##---#----##---#----##---#----##---#----##---#----##---#----##---#----##---#----##
----##--------##--------##--------##--------##--------##--------##--------##--------##--------##----
-###----#--###----#--###----#--###----#--###----#--###----#--###----#--###----#--###----#--###----#-
#-#-------#-#-------#-#-------#-#-------#-#-------#-#-------#-#-------#-#-------#-#-------#-#-------
#--#-----##--#-----##--#-----##--#-----##--#-----##--#-----##--#-----##--#-----##--#-----##--#-----#
#----##---#----##---#----##---#----##---#----##---#----##---#----##---#----##---#----##---#----##---
#-#-------#-#-------#-#-------#-#-------#-#-------#-#-------#-#-------#-#-------#-#-------#-#-------
---#-----#---#-----#---#-----#---#-----#---#-----#---#-----#---#-----#---#-----#---#-----#---#-----#
-###----##-###----##-###----##-###----##-###----##-###----##-###----##-###----##-###----##-###----##
-#---------#---------#---------#---------#---------#---------#---------#---------#---------#--------
---#----##---#----##---#----##---#----##---#----##---#----##---#----##---#----##---#----##---#----##
----##--------##--------##--------##--------##--------##--------##--------##--------##--------##----
-###----#--###----#--###----#--###----#--###----#--###----#--###----#--###----#--###----#--###----#-
#-#-------#-#-------#-#-------#-#-------#-#-------#-#-------#-#-------#-#-------#-#-------#-#-------
#--#-----##--#-----##--#-----##--#-----##--#-----##--#-----##--#-----##--#-----##--#-----##--#-----#
#----##---#----##---#----##---#----##---#----##---#----##---#----##---#----##---#----##---#----##---
#-#-------#-#-------#-#-------#-#-------#-#-------#-#-------#-#-------#-#-------#-#-------#-#-------
---#-----#---#-----#---#-----#---#-----#---#-----#---#-----#---#-----#---#-----#---#-----#---#-----#
-###----##-###----##-###----##-###----##-###----##-###----##-###----##-###----##-###----##-###----##
-#---------#---------#---------#---------#---------#---------#---------#---------#---------#--------
---#----##---#----##---#----##---#----##---#----##---#----##---#----##---#----##---#----##---#----##
