----------------------------------------------------------------------------------------------------
-#---##----#---##----#---##----#---##----#---##----#---##----#---##----#---##----#---##----#---##---
#------#--#------#--#------#--#------#--#------#--#------#--#------#--#------#--#------#--#------#--
----###-#-----###-#-----###-#-----###-#-----###-#-----###-#-----###-#-----###-#-----###-#-----###-#-
--#-#-#-#---#-#-#-#---#-#-#-#---#-#-#-#---#-#-#-#---#-#-#-#---#-#-#-#---#-#-#-#---#-#-#-#---#-#-#-#-
##-#----#-##-#----#-##-#----#-##-#----#-##-#----#-##-#----#-##-#----#-##-#----#-##-#----#-##-#----#-
----#---------#---------#---------#---------#---------#---------#---------#---------#---------#-----
-#--#------#--#------#--#------#--#------#--#------#--#------#--#------#--#------#--#------#--#-----
-##--------##--------##--------##--------##--------##--------##--------##--------##--------##-------
-#-####--#-#-####--#-#-####--#-#-####--#-#-####--#-#-####--#-#-####--#-#-####--#-#-####--#-#-####--#
----------------------------------------------------------------------------------------------------
-#---##----#---##----#---##----#---##----#---##----#---##----#---##----#---##----#---##----#---##---
#------#--#------#--#------#--#------#--#------#--#------#--#------#--#------#--#------#--#------#--
----###-#-----###-#-----###-#-----###-#-----###-#-----###-#-----###-#-----###-#-----###-#-----###-#-
--#-#-#-#---#-#-#-#---#-#-#-#---#-#-#-#---#-#-#-#---#-#-#-#---#-#-#-#---#-#-#-#---#-#-#-#---#-#-#-#-
##-#----#-##-#----#-##-#----#-##-#----#-##-#----#-##-#----#-##-#----#-##-#----#-##-#----#-##-#----#-
----#---------#---------#---------#---------#---------#---------#---------#---------#---------#-----
-#--#------#--#------#--#------#--#------#--#------#--#------#--#------#--#------#--#------#--#-----
-##--------##--------##--------##--------##--------##--------##--------##--------##--------##-------
-#-####--#-#-####--#-#-####--#-#-####--#-#-####--#-#-####--#-#-####--#-#-####--#-#-####--#-#-####--#
----------------------------------------------------------------------------------------------------
-#---##----#---##----#---##----#---##----#---##----#---##----#---##----#---##----#---##----#---##---
#------#--#------#--#------#--#------#--#------#--#------#--#------#--#------#--#------#--#------#--
----###-#-----###-#-----###-#-----###-#-----###-#-----###-#-----###-#-----###-#-----###-#-----###-#-
--#-#-#-#---#-#-#-#---#-#-#-#---#-#-#-#---#-#-#-#---#-#-#-#---#-#-#-#---#-#-#-#---#-#-#-#---#-#-#-#-
##-#----#-##-#----#-##-#----#-##-#----#-##-#----#-##-#----#-##-#----#-##-#----#-##-#----#-##-#----#-
----#---------#---------#---------#---------#---------#---------#---------#---------#---------#-----
-#--#------#--#------#--#------#--#------#--#------#--#------#--#------#S-#------#--#------#--#-----
-##--------##--------##--------##--------##--------##--------##--------##--------##--------##-------
-#-####--#-#-####--#-#-####--#-#-####--#-#-####--#-#-####--#-#-####--#-#-####--#-#-####--#-#-####--#
----------------------------------------------------------------------------------------------------
-#---##----#---##----#---##----#---##----#---##----#---##----#---##----#---##----#---##----#---##---
#------#--#------#--#------#--#------#--#------#--#------#--#------#--#------#--#------#--#------#--
----###-#-----###-#-----###-#-----###-#-----###-#-----###-#-----###-#-----###-#-----###-#-----###-#-
--#-#-#-#---#-#-#-#---#-#-#-#---#-#-#-#---#-#-#-#---#-#-#-#---#-#-#-#---#-#-#-#---#-#-#-#---#-#-#-#-
##-#----#-##-#----#-##-#----#-##-#----#-##-#----#-##-#----#-##-#----#-##-#----#-##-#----#-##-#----#-
----#---------#---------#---------#---------#---------#---------#---------#---------#---------#-----
-#--#------#--#------#--#------#--#------#--#------#--#------#--#------#--#------#--#------#--#-----
-##--------##--------##--------##--------##--------##--------##--------##--------##--------##-------
-#-####--#-#-####--#-#-####--#-#-####--#-#-####--#-#-####--#-#-####--#-#-####--#-#-####--#-#-####--#
----------------------------------------------------------------------------------------------------
-#---##----#---##----#---##----#---##----#---##----#---##----#---##----#---##----#---##----#---##---
#------#--#------#--#------#--#------#--#------#--#------#--#------#--#------#--#------#--#------#--
----###-#-----###-#-----###-#-----###-#-----###-#-----###-#-----###-#-----###-#-----###-#-----###-#-
--#-#-#-#---#-#-#-#---#-#-#-#---#-#-#-#---#-#-#-#---#-#-#-#---#-#-#-#---#-#-#-#---#-#-#-#---#-#-#-#-
##-#----#-##-#----#-##-#----#-##-#----#-##-#----#-##-#----#-##-#----#-##-#----#-##-#----#-##-#----#-
----#---------#---------#---------#---------#---------#---------#---------#---------#---------#-----
-#--#------#--#------#--#------#--#------#--#------#--#------#--#------#--#------#--#------#--#-----
-##--------##--------##--------##--------##--------##--------##--------##--------##--------##-------
-#-####--#-#-####--#-#-####--#-#-####--#-#-####--#-#-####--#-#-####--#-#-####--#-#-####--#-#-####--#
----------------------------------------------------------------------------------------------------
-#---##----#---##----#---##----#---##----#---##----#---##----#---##----#---##----#---##----#---##---
#------#--#------#--#------#--#------#--#------#--#------#--#------#--#------#--#------#--#------#--
----###-#-----###-#-----###-#-----###-#-----###-#-----###-#-----###-#-----###-#-----###-#-----###-#-
--#-#-#-#---#-#-#-#---#-#-#-#---#-#-#-#---#-#-#-#---#-#-#-#---#-#-#-#---#-#-#-#---#-#-#-#---#-#-#-#-
##-#----#-##-#----#-##-#----#-##-#----#-##-#----#-##-#----#-##-#----#-##-#----#-##-#----#-##-#----#-
----#---------#---------#---------#---------#---------#---------#---------#---------#---------#-----
-#--#------#--#------#--#------#--#------#--#------#--#------#--#------#--#------#--#------#--#-----
-##--------##--------##--------##--------##--------##--------##--------##--------##--------##--E----
-#-####--#-#-####--#-#-####--#-#-####--#-#-####--#-#-####--#-#-####--#-#-####--#-#-####--#-#-####--#
----------------------------------------------------------------------------------------------------
-#---##----#---##----#---##----#---##----#---##----#---##----#---##----#---##----#---##----#---##---
#------#--#------#--#------#--#------#--#------#--#------#--#------#--#------#--#------#--#------#--
----###-#-----###-#-----###-#-----###-#-----###-#-----###-#-----###-#-----###-#-----###-#-----###-#-
--#-#-#-#---#-#-#-#---#-#-#-#---#-#-#-#---#-#-#-#---#-#-#-#---#-#-#-#---#-#-#-#---#-#-#-#---#-#-#-#-
##-#----#-##-#----#-##-#----#-##-#----#-##-#----#-##-#----#-##-#----#-##-#----#-##-#----#-##-#----#-
----#---------#---------#---------#---------#---------#---------#---------#---------#---------#-----
-#--#------#--#------#--#------#--#------#--#------#--#------#--#------#--#------#--#------#--#-----
-##--------##--------##--------##--------##--------##--------##--------##--------##--------##-------
-#-####--#-#-####--#-#-####--#-#-####--#-#-####--#-#-####--#-#-####--#-#-####--#-#-####--#-#-####--#
----------------------------------------------------------------------------------------------------
-#---##----#---##----#---##----#---##----#---##----#---##----#---##----#---##----#---##----#---##---
#------#--#------#--#------#--#------#--#------#--#------#--#------#--#------#--#------#--#------#--
----###-#-----###-#-----###-#-----###-#-----###-#-----###-#-----###-#-----###-#-----###-#-----###-#-
--#-#-#-#---#-#-#-#---#-#-#-#---#-#-#-#---#-#-#-#---#-#-#-#---#-#-#-#---#-#-#-#---#-#-#-#---#-#-#-#-
##-#----#-##-#----#-##-#----#-##-#----#-##-#----#-##-#----#-##-#----#-##-#----#-##-#----#-##-#----#-
----#---------#---------#---------#---------#---------#---------#---------#---------#---------#-----
-#--#------#--#------#--#------#--#------#--#------#--#------#--#------#--#------#--#------#--#-----
-##--------##--------##--------##--------##--------##--------##--------##--------##--------##-------
-#-####--#-#-####--#-#-####--#-#-####--#-#-####--#-#-####--#-#-####--#-#-####--#-#-####--#-#-####--#
----------------------------------------------------------------------------------------------------
-#---##----#---##----#---##----#---##----#---##----#---##----#---##----#---##----#---##----#---##---
#------#--#------#--#------#--#------#--#------#--#------#--#------#--#------#--#------#--#------#--
----###-#-----###-#-----###-#-----###-#-----###-#-----###-#-----###-#-----###-#-----###-#-----###-#-
--#-#-#-#---#-#-#-#---#-#-#-#---#-#-#-#---#-#-#-#---#-#-#-#---#-#-#-#---#-#-#-#---#-#-#-#---#-#-#-#-
##-#----#-##-#----#-##-#----#-##-#----#-##-#----#-##-#----#-##-#----#-##-#----#-##-#----#-##-#----#-
----#---------#---------#---------#---------#---------#---------#---------#---------#---------#-----
-#--#------#--#------#--#------#--#------#--#------#--#------#--#------#--#------#--#------#--#-----
-##--------##--------##--------##--------##--------##--------##--------##--------##--------##-------
-#-####--#-#-####--#-#-####--#-#-####--#-#-####--#-#-####--#-#-####--#-#-####--#-#-####--#-#-####--#
----------------------------------------------------------------------------------------------------
-#---##----#---##----#---##----#---##----#---##----#---##----#---##----#---##----#---##----#---##---
#------#--#------#--#------#--#------#--#------#--#------#--#------#--#------#--#------#--#------#--
----###-#-----###-#-----###-#-----###-#-----###-#-----###-#-----###-#-----###-#-----###-#-----###-#-
--#-#-#-#---#-#-#-#---#-#-#-#---#-#-#-#---#-#-#-#---#-#-#-#---#-#-#-#---#-#-#-#---#-#-#-#---#-#-#-#-
##-#----#-##-#----#-##-#----#-##-#----#-##-#----#-##-#----#-##-#----#-##-#----#-##-#----#-##-#----#-
----#---------#---------#---------#---------#---------#---------#---------#---------#---------#-----
-#--#------#--#------#--#------#--#------#--#------#--#------#--#------#--#------#--#------#--#-----
-##--------##--------##--------##--------##--------##--------##--------##--------##--------##-------
-#-####--#-#-####--#-#-####--#-#-####--#-#-####--#-#-####--#-#-####--#-#-####--#-#-####--#-#-####--#
