#-#--#---##-#--#---##-#--#---##-#--#---##-#--#---##-#--#---##-#--#---##-#--#---##-#--#---##-#--#---#
##--------##--------##--------##--------##--------##--------##--------##--------##--------##--------
--------##--------##--------##--------##--------##--------##--------##--------##--------##--------##
--#--#-#----#--#-#----#--#-#----#--#-#----#--#-#----#--#-#----#--#-#----#--#-#----#--#-#----#--#-#--
-----#-#-------#-#-------#-#-------#-#-------#-#-------#-#-------#-#-------#-#-------#-#-------#-#--
-##--------##--------##--------##--------##--------##--------##--------##--------##--------##-------
-----###-------###-------###-------###-------###-------###-------###-------###-------###-------###--
--#---###---#---###---#---###---#---###---#---###---#---###---#---###---#---###---#---###---#---###-
--##--##----##--##----##--##----##--##----##--##----##--##----##--##----##--##----##--##----##--##--
#---------#---------#---------#---------#---------#---------#---------#---------#---------#---------
#-#--#---##-#--#---##-#--#---##-#--#---##-#--#---##-#--#---##-#--#---##-#--#---##-#--#---##-#--#---#
##--------##--------##--------##--------##--------##--------##--------##--------##--------##--------
--------##--------##--------##--------##--------##--------##--------##--------##--------##--------##
--#--#-#----#--#-#----#--#-#----#--#-#----#--#-#----#--#-#----#--#-#----#--#-#----#--#-#----#--#-#--
-----#-#-------#-#-------#-#-------#-#-------#-#-------#-#-------#-#-------#-#-------#-#-------#-#--
-##--------##--------##--------##--------##--------##--------##--------##--------##--------##-------
-----###-------###-------###-------###-------###-------###-------###-------###-------###-------###--
--#---###---#---###---#---###---#---###---#---###---#---###---#---###---#---###---#---###---#---###-
--##--##----##--##----##--##----##--##----##--##----##--##----##--##----##--##----##--##----##--##--
#---------#---------#---------#---------#---------#---------#---------#---------#---------#---------
#-#--#---##-#--#---##-#--#---##-#--#---##-#--#---##-#--#---##-#--#---##-#--#---##-#--#---##-#--#---#
##--------##--------##--------##--------##--------##--------##--------##--------##--------##--------
--------##--------##--------##--------##--------##--------##--------##--------##--------##--------##
--#--#-#----#--#-#----#-E#-#----#--#-#----#--#-#----#--#-#----#--#-#----#--#-#----#--#-#----#--#-#--
-----#-#-------#-#-------#-#-------#-#-------#-#-------#-#-------#-#-------#-#-------#-#-------#-#--
-##--------##--------##--------##--------##--------##--------##--------##--------##--------##-------
-----###-------###-------###-------###-------###-------###-------###-------###-------###-------###--
--#---###---#---###---#---###---#---###---#---###---#---###---#---###---#---###---#---###---#---###-
--##--##----##--##----##--##----##--##----##--##----##--##----##--##----##--##----##--##----##--##--
#---------#---------#---------#---------#---------#---------#---------#---------#---------#---------
#-#--#---##-#--#---##-#--#---##-#--#---##-#--#---##-#--#---##-#--#---##-#--#---##-#--#---##-#--#---#
##--------##--------##--------##--------##--------##--------##--------##--------##--------##--------
--------##--------##--------##--------##--------##--------##--------##--------##--------##--------##
--#--#-#----#--#-#----#--#-#----#--#-#----#--#-#----#--#-#----#--#-#----#--#-#----#--#-#----#--#-#--
-----#-#-------#-#-------#-#-------#-#-------#-#-------#-#-------#-#-------#-#-------#-#-------#-#--
-##--------##--------##--------##--------##--------##--------##--------##--------##--------##-------
-----###-------###-------###-------###-------###-------###-------###-------###-------###-------###--
--#---###---#---###---#---###---#---###---#---###---#---###---#---###---#---###---#---###---#---###-
--##--##----##--##----##--##----##--##----##--##----##--##----##--##----##--##----##--##----##--##--
#---------#---------#---------#---------#---------#---------#---------#---------#---------#---------
#-#--#---##-#--#---##-#--#---##-#--#---##-#--#---##-#--#---##-#--#---##-#--#---##-#--#---##-#--#---#
##--------##--------##--------##--------##--------##--------##--------##--------##--------##--------
--------##--------##--------##--------##--------##--------##--------##--------##--------##--------##
--#--#-#----#--#-#----#--#-#----#--#-#----#--#-#----#--#-#----#--#-#----#--#-#----#--#-#----#--#-#--
-----#-#-------#-#-------#-#-------#-#-------#-#-------#-#-------#-#-------#-#-------#-#-------#-#--
-##--------##--------##--------##--------##--------##--------##--------##--------##--------##-------
-----###-------###-------###-------###-------###-------###-------###-------###-------###-------###--
--#---###---#---###---#---###---#---###---#---###---#---###---#---###---#---###---#---###---#---###-
--##--##----##--##----##--##----##--##----##--##----##--##----##--##----##--##----##--##----##--##--
#---------#---------#---------#---------#---------#---------#---------#---------#---------#---------
#-#--#---##-#--#---##-#--#---##-#--#---##-#--#---##-#--#---##-#--#---##-#--#---##-#--#---##-#--#---#
##--------##--------##--------##--------##--------##--------##--------##--------##--------##--------
--------##--------##--------##--------##--------##--------##--------##--------##--------##--------##
--#--#-#----#--#-#----#--#-#----#--#-#----#--#-#----#--#-#----#--#-#----#--#-#----#--#-#----#--#-#--
-----#-#-------#-#-------#-#-------#-#-------#-#-------#-#-------#-#-------#-#-------#-#-------#-#--
-##--------##--------##--------##--------##--------##--------##--------##--------##--------##-------
-----###-------###-------###-------###-------###-------###-------###-------###-------###-------###--
--#---###---#---###---#---###---#---###---#---###---#---###---#---###---#---###---#---###---#---###-
--##--##----##--##----##--##----##--##----##--##----##--##----##--##----##--##----##--##----##--##--
#---------#---------#---------#---------#---------#---------#---------#---------#---------#---------
#-#--#---##-#--#---##-#--#---##-#--#---##-#--#---##-#--#---##-#--#---##-#--#---##-#--#---##-#--#---#
##--------##--------##--------##--------##--------##--------##--------##--------##--------##--------
--------##--------##--------##--------##--------##--------##--------##--------##--------##--------##
--#--#-#----#--#-#----#--#-#----#--#-#----#--#-#----#--#-#----#--#-#----#--#-#----#--#-#----#--#-#--
-----#-#-------#-#-------#-#-------#-#-------#-#-------#-#-------#-#-------#-#-------#-#-------#-#--
-##--------##--------##--------##--------##--------##--------##--------##--------##--------##-------
-----###-------###-------###-------###-------###-------###-------###-------###-------###-------###--
--#---###---#---###---#---###---#---###---#---###---#---###---#---###---#---###---#---###---#---###-
--##--##----##--##----##--##----##--##----##--##----##--##----##--##----##--##----##--##----##--##--
#---------#---------#---------#---------#---------#---------#---------#---------#---------#---------
#-#--#---##-#--#---##-#--#---##-#--#---##-#--#---##-#--#---##-#--#---##-#--#---##-#--#---##-#--#---#
##--------##--------##--------##--------##--------##--------##--------##--------##--------##--------
--------##--------##--------##--------##--------##--------##--------##--------##--------##--------##
--#--#-#----#--#-#----#--#-#----#--#-#----#--#-#----#--#-#----#--#-#----#--#-#----#--#-#----#--#-#--
-----#-#-------#-#-------#-#-------#-#-------#-#-------#-#-------#-#-------#-#-------#-#-------#-#--
-##--------##--------##--------##--------##--------##--------##--------##--------##--------##-------
-----###-------###-------###-------###-------###-------###-------###-------###-------###-------###--
--#---###---#---###---#---###---#---###---#---###---#---###---#---###---#---###---#---###---#---###-
--##--##----##--##----##--##----##--##----##--##----##--##----##--##----##--##----##--##----##--##--
#---------#---------#---------#---------#---------#---------#---------#---------#---------#---------
#-#--#---##-#--#---##-#--#---##-#--#---##-#--#---##-#--#---##-#--#---##-#--#---##-#--#---##-#--#---#
##--------##--------##--------##--------##--------##--------##--------##--------##--------##--------
--------##--------##--------##--------##--------##--------##--------##--------##--------##--------##
--#--#-#----#--#-#----#--#-#----#--#-#----#--#-#----#--#-#----#--#-#----#--#-#----#--#-#----#--#-#-S
-----#-#-------#-#-------#-#-------#-#-------#-#-------#-#-------#-#-------#-#-------#-#-------#-#--
-##--------##--------##--------##--------##--------##--------##--------##--------##--------##-------
-----###-------###-------###-------###-------###-------###-------###-------###-------###-------###--
--#---###---#---###---#---###---#---###---#---###---#---###---#---###---#---###---#---###---#---###-
--##--##----##--##----##--##----##--##----##--##----##--##----##--##----##--##----##--##----##--##--
#---------#---------#---------#---------#---------#---------#---------#---------#---------#---------
#-#--#---##-#--#---##-#--#---##-#--#---##-#--#---##-#--#---##-#--#---##-#--#---##-#--#---##-#--#---#
##--------##--------##--------##--------##--------##--------##--------##--------##--------##--------
--------##--------##--------##--------##--------##--------##--------##--------##--------##--------##
--#--#-#----#--#-#----#--#-#----#--#-#----#--#-#----#--#-#----#--#-#----#--#-#----#--#-#----#--#-#--
-----#-#-------#-#-------#-#-------#-#-------#-#-------#-#-------#-#-------#-#-------#-#-------#-#--
-##--------##--------##--------##--------##--------##--------##--------##--------##--------##-------
-----###-------###-------###-------###-------###-------###-------###-------###-------###-------###--
--#---###---#---###---#---###---#---###---#---###---#---###---#---###---#---###---#---###---#---###-
--##--##----##--##----##--##----##--##----##--##----##--##----##--##----##--##----##--##----##--##--
#---------#---------#---------#---------#---------#---------#---------#---------#---------#---------
