#---#-----#---#-----#---#-----#---#-----#---#-----#---#-----#---#-----#---#-----#---#-----#---#-----
----#---------#---------#---------#---------#---------#---------#---------#---------#---------#-----
--##--###---##--###---##--###---##--###---##--###---##--###---##--###---##--###---##--###---##--###-
-#----#-#--#----#-#--#----#-#--#----#-#--#----#-#--#----#-#--#----#-#--#----#-#--#----#-#--#----#-#-
-#-----#---#-----#---#-----#---#-----#---#-----#---#-----#---#-----#---#-----#---#-----#---#-----#--
#-#-------#-#-------#-#-------#-#-------#-#-------#-#-------#-#-------#-#-------#-#-------#-#-------
#-#----##-#-#----##-#-#----##-#-#----##-#-#----##-#-#----##-#-#----##-#-#----##-#-#----##-#-#----##-
#---#-#---#---#-#---#---#-#---#---#-#---#---#-#---#---#-#---#---#-#---#---#-#---#---#-#---#---#-#---
-----#--##-----#--##-----#--##-----#--##-----#--##-----#--##-----#--##-----#--##-----#--##-----#--##
----------------------------------------------------------------------------------------------------
#---#-----#---#-----#---#-----#---#-----#---#-----#---#-----#---#-----#---#-----#---#-----#---#-----
----#---------#---------#---------#---------#---------#---------#---------#---------#---------#-----
--##--###---##--###---##--###---##--###---##--###---##--###---##--###---##--###---##--###---##--###-
-#----#-#--#----#-#--#----#-#--#----#-#--#----#-#--#----#-#--#----#-#--#----#-#--#----#-#--#----#-#-
-#-----#---#-----#---#-----#---#-----#---#-----#---#-----#---#-----#---#-----#---#-----#---#-----#--
#-#-------#-#-------#-#-------#-#-------#-#-------#-#-------#-#-------#-#-------#-#-------#-#-------
#-#----##-#-#----##-#-#----##-#-#----##-#-#----##-#-#----##-#-#----##-#-#----##-#-#----##-#-#----##-
#---#-#---#---#-#---#---#-#---#---#-#---#---#-#---#---#-#---#---#-#-E-#---#-#---#---#-#---#---#-#---
-----#--##-----#--##-----#--##-----#--##-----#--##-----#--##-----#--##-----#--##-----#--##-----#--##
----------------------------------------------------------------------------------------------------
#---#-----#---#-----#---#-----#---#-----#---#-----#---#-----#---#-----#---#-----#---#-----#---#-----
----#---------#---------#---------#---------#---------#---------#---------#---------#---------#-----
--##--###---##--###---##--###---##--###---##--###---##--###---##--###---##--###---##--###---##--###-
-#----#-#--#----#-#--#----#-#--#----#-#--#----#-#--#----#-#--#----#-#--#----#-#--#----#-#--#----#-#-
-#-----#---#-----#---#-----#---#-----#---#-----#---#-----#---#-----#---#-----#---#-----#---#-----#--
#-#-------#-#-------#-#-------#-#-------#-#-------#-#-------#-#-------#-#-------#-#-------#-#-------
#-#----##-#-#----##-#-#----##-#-#----##-#-#----##-#-#----##-#-#----##-#-#----##-#-#----##-#-#----##-
#---#-#---#---#-#---#---#-#---#---#-#---#---#-#---#---#-#---#---#-#---#---#-#---#---#-#---#---#-#---
-----#--##-----#--##-----#--##-----#--##-----#--##-----#--##-----#--##-----#--##-----#--##-----#--##
----------------------------------------------------------------------------------------------------
#---#-----#---#-----#---#-----#---#-----#---#-----#---#-----#---#-----#---#-----#---#-----#---#-----
----#---------#---------#---------#---------#---------#---------#---------#---------#---------#-----
--##--###---##--###---##--###---##--###---##--###---##--###---##--###---##--###---##--###---##--###-
-#----#-#--#----#-#--#----#-#--#----#-#--#----#-#--#----#-#--#----#-#--#----#-#--#----#-#--#----#-#-
-#-----#---#-----#---#-----#---#-----#---#-----#---#-----#---#-----#---#-----#---#-----#---#-----#--
#-#-------#-#-------#-#-------#-#-------#-#-------#-#-------#-#-------#-#-------#-#-------#-#-------
#-#----##-#-#----##-#-#----##-#-#----##-#-#----##-#-#----##-#-#----##-#-#----##-#-#----##-#-#----##-
#---#-#---#---#-#---#---#-#---#---#-#---#---#-#---#---#-#---#---#-#---#---#-#---#---#-#---#---#-#---
-----#--##-----#--##-----#--##-----#--##-----#--##-----#--##-----#--##-----#--##-----#--##-----#--##
----------------------------------------------------------------------------------------------------
#---#-----#---#-----#---#-----#---#-----#---#-----#---#-----#---#-----#---#-----#---#-----#---#-----
----#---------#---------#---------#---------#---------#---------#---------#---------#---------#-----
--##--###---##--###---##--###---##--###---##--###---##--###---##--###---##--###---##--###---##--###-
-#----#-#--#----#-#--#----#-#--#----#-#--#----#-#--#----#-#--#----#-#--#----#-#--#----#-#--#----#-#-
-#-----#---#-----#---#-----#---#-----#---#-----#---#-----#---#-----#---#-----#---#-----#---#-----#--
#-#-------#-#-------#-#-------#-#-------#-#-------#-#-------#-#-------#-#-------#-#-------#-#-------
#-#----##-#-#----##-#-#----##-#-#----##-#-#----##-#-#----##-#-#----##-#-#----##-#-#----##-#-#----##-
#---#-#---#---#-#---#---#-#---#---#-#---#---#-#---#---#-#---#---#-#---#---#-#---#---#-#---#---#-#---
-----#--##-----#--##-----#--##-----#--##-----#--##-----#--##-----#--##-----#--##-----#--##-----#--##
----------------------------------------------------------------------------------------------------
#---#-----#---#-----#---#-----#---#-----#---#-----#---#-----#---#-----#---#-----#---#-----#---#-----
----#---------#---------#---------#---------#---------#---------#---------#---------#---------#-----
--##--###---##--###---##--###---##--###---##--###---##--###---##--###---##--###---##--###---##--###-
-#----#-#--#----#-#--#----#-#--#----#-#--#----#-#--#----#-#--#----#-#--#----#-#--#----#-#--#----#-#-
-#-----#---#-----#---#-----#---#-----#---#-----#---#-----#---#-----#---#-----#---#-----#---#-----#--
#-#-------#-#-------#-#-------#-#-------#-#-------#-#-------#-#-------#-#-------#-#-------#-#-------
#-#----##-#-#----##-#-#----##-#-#----##-#-#----##-#-#----##-#-#----##-#-#----##-#-#----##-#-#----##-
#---#-#---#---#-#---#---#-#---#---#-#---#---#-#---#---#-#---#---#-#---#---#-#---#---#-#---#---#-#---
-----#--##-----#--##-----#--##-----#--##-----#--##-----#--##-----#--##-----#--##-----#--##-----#--##
----------------------------------------------------------------------------------------------------
#---#-----#---#-----#---#-----#---#-----#---#-----#---#-----#---#-----#---#-----#---#-----#---#-----
----#---------#---------#---------#---------#---------#---------#---------#---------#---------#-----
--##--###---##--###---##--###---##--###---##--###---##--###---##--###---##--###---##--###---##--###-
-#----#-#--#----#-#--#----#-#--#----#-#--#----#-#--#----#-#--#----#-#--#----#-#--#----#-#--#----#-#-
-#-----#---#-----#---#-----#---#-----#---#-----#---#-----#---#-----#---#-----#---#-----#---#-----#--
#-#-------#-#-------#-#-------#-#-------#-#-------#-#-------#-#-------#-#-------#-#-------#-#-------
#-#----##-#-#----##-#-#----##-#-#----##-#-#----##-#-#----##-#-#----##-#-#----##-#-#----##-#-#----##-
#---#-#---#---#-#---#---#-#---#---#-#---#---#-#---#---#-#---#---#-#---#---#-#---#---#-#---#---#-#---
-----#--##-----#--##-----#--##-----#--##-----#--##-----#--##-----#--##-----#--##-----#--##-----#--##
----------------------------------------------------------------------------------------------------
#---#-----#---#-----#---#-----#---#-----#---#-----#---#-----#---#-----#---#-----#---#-----#---#-----
----#---------#---------#---------#---------#---------#---------#---------#---------#---------#-----
--##--###---##--###---##--###---##--###---##--###---##--###---##--###---##--###---##--###---##--###-
-#----#-#--#----#-#--#----#-#--#----#-#--#----#-#--#----#-#--#----#-#--#----#-#--#----#-#--#----#-#-
-#-----#---#-----#---#-----#---#-----#---#-----#---#-----#---#-----#---#-----#---#-----#---#-----#--
#-#-------#-#-------#-#-------#-#-------#-#-------#-#-------#-#-------#-#-------#-#-------#-#-------
#-#----##-#-#----##-#-#----##-#-#----##-#-#----##-#-#----##-#-#----##-#-#----##-#-#----##-#-#----##-
#---#-#---#---#-#---#---#-#---#---#-#---#---#-#---#---#-#---#---#-#---#---#-#---#---#-#---#---#-#---
-----#--##-----#--##-----#--##-----#--##-----#--##-----#--##-----#--##-----#--##-----#--##-----#--##
----------------------------------------------------------------------------------------------------
#---#-----#---#-----#---#-----#---#-----#---#-----#---#-----#---#-----#---#-----#---#-----#---#-----
----#---------#---------#---------#---------#---------#---------#---------#---------#---------#-----
--##--###---##--###---##--###---##--###---##--###---##--###---##--###---##--###---##--###---##--###-
-#----#-#--#----#-#--#----#-#--#----#-#--#----#-#--#----#-#--#----#-#--#----#-#--#----#-#--#----#-#-
-#-----#---#-----#---#-----#---#-----#---#-----#---#-----#---#-----#---#-----#---#-----#---#-----#--
#-#-------#-#-------#-#-------#-#-------#-#-------#-#-------#-#-------#-#-------#-#-------#-#-------
#-#----##-#-#----##-#-#----##-#-#----##-#-#----##-#-#----##-#-#----##-#-#----##-#-#----##-#-#----##-
#---#-#---#---#-#---#---#-#---#---#-#---#---#-#---#---#-#---#---#-#---#---#-#---#---#-#---#---#-#---
-----#--##-----#--##-----#--##-----#--##-----#--##-----#--##-----#--##-----#--##-----#--##-----#--##
----------------------------------------------------------------------------------------------------
#---#-----#---#-----#---#-----#---#-----#---#-----#---#-----#---#-----#---#-----#---#-----#---#-----
----#---------#---------#---------#---------#---------#---------#---------#---------#---------#-----
--##--###---##--###---##--###---##--###---##--###---##--###---##--###---##--###---##--###---##--###-
-#----#-#--#----#-#--#----#-#--#----#-#--#----#-#--#----#-#--#----#-#--#----#-#--#----#-#--#----#-#-
-#-----#---#-----#---#-----#---#-----#---#-----#---#-----#---#-----#---#-----#---#-----#---#-----#--
#-#-------#-#-------#-#-------#-#-------#-#-------#-#-------#-#-------#-#-------#-#-------#-#-------
#-#----##-#-#----##-#-#----##-#-#----##-#-#----##-#-#----##-#-#----##-#-#----##-#-#----##-#-#----##-
#---#-#---#---#-#---#---#-#---#---#-#---#---#-#---#---#-#---#---#-#---#---#-#---#---#-#---#---#-#---
-----#--##-----#--##-----#--##-----#--##-----#--##-----#--##-----#--##-----#--##-----#--##-----#--##
-----------S----------------------------------------------------------------------------------------
