------#---------#---------#---------#---------#---------#---------#---------#---------#---------#---
#-#--#--###-#--#--###-#--#--###-#--#--###-#--#--###-#--#--###-#--#--###-#--#--###-#--#--###-#--#--##
--#-#-#--#--#-#-#--#--#-#-#--#--#-#-#--#--#-#-#--#--#-#-#--#--#-#-#--#--#-#-#--#--#-#-#--#--#-#-#--#
#---#----##---#----##---#----##---#----##---#----##---#----##--E#----##---#----##---#----##---#----#
-##--------##--------##--------##--------##--------##--------##--------##--------##--------##-------
-------##--------##--------##--------##--------##--------##--------##--------##--------##--------##-
-----#-#-------#-#-------#-#-------#-#-------#-#-------#-#-------#-#-------#-#-------#-#-------#-#--
--#-##--#---#-##--#---#-##--#---#-##--#---#-##--#---#-##--#---#-##--#---#-##--#---#-##--#---#-##--#-
##----#---##----#---##----#---##----#---##----#---##----#---##----#---##----#---##----#---##----#---
#------#--#------#--#------#--#------#--#------#--#------#--#------#--#------#--#------#--#------#--
------#---------#---------#---------#---------#---------#---------#---------#---------#---------#---
#-#--#--###-#--#--###-#--#--###-#--#--###-#--#--###-#--#--###-#--#--###-#--#--###-#--#--###-#--#--##
--#-#-#--#--#-#-#--#--#-#-#--#--#-#-#--#--#-#-#--#--#-#-#--#--#-#-#--#--#-#-#--#--#-#-#--#--#-#-#--#
#---#----##---#----##---#----##---#----##---#----##---#----##---#----##---#----##---#----##---#----#
-##--------##--------##--------##--------##--------##--------##--------##--------##--------##-------
-------##--------##--------##--------##--------##--------##--------##--------##--------##--------##-
-----#-#-------#-#-------#-#-------#-#-------#-#-------#-#-------#-#-------#-#-------#-#-------#-#--
--#-##--#---#-##--#---#-##--#---#-##--#---#-##--#---#-##--#---#-##--#---#-##--#---#-##--#---#-##--#-
##----#---##----#---##----#---##----#---##----#---##----#---##----#---##----#---##----#---##----#---
#------#--#------#--#------#--#------#--#------#--#------#--#------#--#------#--#------#--#------#--
------#---------#---------#---------#---------#---------#---------#---------#---------#---------#---
#-#--#--###-#--#--###-#--#--###-#--#--###-#--#--###-#--#--###-#--#--###-#--#--###-#--#--###-#--#--##
--#-#-#--#--#-#-#--#--#-#-#--#--#-#-#--#--#-#-#--#--#-#-#--#--#-#-#--#--#-#-#--#--#-#-#--#--#-#-#--#
#---#----##---#----##---#----##---#----##---#----##---#----##---#----##---#----##---#----##---#----#
-##--------##--------##--------##--------##--------##--------##--------##--------##--------##-------
-------##--------##--------##--------##--------##--------##--------##--------##--------##--------##-
-----#-#-------#-#-------#-#-------#-#-------#-#-------#-#-------#-#-------#-#-------#-#-------#-#--
--#-##--#---#-##--#---#-##--#---#-##--#---#-##--#---#-##--#---#-##--#---#-##--#---#-##--#---#-##--#-
##----#---##----#---##----#---##----#---##----#---##----#---##----#---##----#---##----#---##----#---
#------#--#------#--#------#--#------#--#------#--#------#--#------#--#------#--#------#--#------#--
------#---------#---------#---------#---------#---------#---------#---------#---------#---------#---
#-#--#--###-#--#--###-#--#--###-#--#--###-#--#--###-#--#--###-#--#--###-#--#--###-#--#--###-#--#--##
--#-#-#--#--#-#-#--#--#-#-#--#--#-#-#--#--#-#-#--#--#-#-#--#--#-#-#--#--#-#-#--#--#-#-#--#--#-#-#--#
#---#----##---#----##---#----##---#----##---#----##---#----##---#----##---#----##---#----##---#----#
-##--------##--------##--------##--------##--------##--------##--------##--------##--------##-------
-------##--------##--------##--------##--------##--------##--------##--------##--------##--------##-
-----#-#-------#-#-------#-#-------#-#-------#-#-------#-#-------#-#-------#-#-------#-#-------#-#--
--#-##--#---#-##--#---#-##--#---#-##--#---#-##--#---#-##--#---#-##--#---#-##--#---#-##--#---#-##--#-
##----#---##----#---##----#---##----#---##----#---##----#---##----#---##----#---##----#---##----#---
#------#--#------#--#------#--#------#--#------#--#------#--#------#--#------#--#------#--#------#--
------#---------#---------#---------#---------#---------#---------#---------#---------#---------#---
#-#--#--###-#--#--###-#--#--###-#--#--###-#--#--###-#--#--###-#--#--###-#--#--###-#--#--###-#--#--##
--#-#-#--#--#-#-#--#--#-#-#--#--#-#-#--#--#-#-#--#--#-#-#--#--#-#-#--#--#-#-#--#--#-#-#--#--#-#-#--#
#---#----##---#----##---#----##---#----##---#----##---#----##---#----##---#----##---#----##---#----#
-##--------##--------##--------##--------##--------##--------##--------##--------##--------##-------
-------##--------##--------##--------##--------##--------##--------##--------##--------##--------##-
-----#-#-------#-#-------#-#-------#-#-------#-#-------#-#-------#-#-------#-#-------#-#-------#-#--
--#-##--#---#-##--#---#-##--#---#-##--#---#-##--#---#-##--#---#-##--#---#-##--#---#-##--#---#-##--#-
##----#---##----#---##----#---##----#---##----#---##----#---##----#---##----#---##----#---##----#---
#------#--#------#--#------#--#------#--#------#--#------#--#------#--#------#--#------#--#------#--
------#---------#---------#---------#---------#---------#---------#---------#---------#---------#---
#-#--#--###-#--#--###-#--#--###-#--#--###-#--#--###-#--#--###-#--#--###-#--#--###-#--#--###-#--#--##
--#-#-#--#--#-#-#--#--#-#-#--#--#-#-#--#--#-#-#--#--#-#-#--#--#-#-#--#--#-#-#--#--#-#-#--#--#-#-#--#
#---#----##---#----##---#----##---#----##---#----##---#----##---#----##---#----##---#----##---#----#
-##--------##--------##--------##--------##--------##--------##--------##--------##--------##-------
-------##--------##--------##--------##--------##--------##--------##--------##--------##--------##-
-----#-#-------#-#-------#-#-------#-#--S----#-#-------#-#-------#-#-------#-#-------#-#-------#-#--
--#-##--#---#-##--#---#-##--#---#-##--#---#-##--#---#-##--#---#-##--#---#-##--#---#-##--#---#-##--#-
##----#---##----#---##----#---##----#---##----#---##----#---##----#---##----#---##----#---##----#---
#------#--#------#--#------#--#------#--#------#--#------#--#------#--#------#--#------#--#------#--
------#---------#---------#---------#---------#---------#---------#---------#---------#---------#---
#-#--#--###-#--#--###-#--#--###-#--#--###-#--#--###-#--#--###-#--#--###-#--#--###-#--#--###-#--#--##
--#-#-#--#--#-#-#--#--#-#-#--#--#-#-#--#--#-#-#--#--#-#-#--#--#-#-#--#--#-#-#--#--#-#-#--#--#-#-#--#
#---#----##---#----##---#----##---#----##---#----##---#----##---#----##---#----##---#----##---#----#
-##--------##--------##--------##--------##--------##--------##--------##--------##--------##-------
-------##--------##--------##--------##--------##--------##--------##--------##--------##--------##-
-----#-#-------#-#-------#-#-------#-#-------#-#-------#-#-------#-#-------#-#-------#-#-------#-#--
--#-##--#---#-##--#---#-##--#---#-##--#---#-##--#---#-##--#---#-##--#---#-##--#---#-##--#---#-##--#-
##----#---##----#---##----#---##----#---##----#---##----#---##----#---##----#---##----#---##----#---
#------#--#------#--#------#--#------#--#------#--#------#--#------#--#------#--#------#--#------#--
------#---------#---------#---------#---------#---------#---------#---------#---------#---------#---
#-#--#--###-#--#--###-#--#--###-#--#--###-#--#--###-#--#--###-#--#--###-#--#--###-#--#--###-#--#--##
--#-#-#--#--#-#-#--#--#-#-#--#--#-#-#--#--#-#-#--#--#-#-#--#--#-#-#--#--#-#-#--#--#-#-#--#--#-#-#--#
#---#----##---#----##---#----##---#----##---#----##---#----##---#----##---#----##---#----##---#----#
-##--------##--------##--------##--------##--------##--------##--------##--------##--------##-------
-------##--------##--------##--------##--------##--------##--------##--------##--------##--------##-
-----#-#-------#-#-------#-#-------#-#-------#-#-------#-#-------#-#-------#-#-------#-#-------#-#--
--#-##--#---#-##--#---#-##--#---#-##--#---#-##--#---#-##--#---#-##--#---#-##--#---#-##--#---#-##--#-
##----#---##----#---##----#---##----#---##----#---##----#---##----#---##----#---##----#---##----#---
#------#--#------#--#------#--#------#--#------#--#------#--#------#--#------#--#------#--#------#--
------#---------#---------#---------#---------#---------#---------#---------#---------#---------#---
#-#--#--###-#--#--###-#--#--###-#--#--###-#--#--###-#--#--###-#--#--###-#--#--###-#--#--###-#--#--##
--#-#-#--#--#-#-#--#--#-#-#--#--#-#-#--#--#-#-#--#--#-#-#--#--#-#-#--#--#-#-#--#--#-#-#--#--#-#-#--#
#---#----##---#----##---#----##---#----##---#----##---#----##---#----##---#----##---#----##---#----#
-##--------##--------##--------##--------##--------##--------##--------##--------##--------##-------
-------##--------##--------##--------##--------##--------##--------##--------##--------##--------##-
-----#-#-------#-#-------#-#-------#-#-------#-#-------#-#-------#-#-------#-#-------#-#-------#-#--
--#-##--#---#-##--#---#-##--#---#-##--#---#-##--#---#-##--#---#-##--#---#-##--#---#-##--#---#-##--#-
##----#---##----#---##----#---##----#---##----#---##----#---##----#---##----#---##----#---##----#---
#------#--#------#--#------#--#------#--#------#--#------#--#------#--#------#--#------#--#------#--
------#---------#---------#---------#---------#---------#---------#---------#---------#---------#---
#-#--#--###-#--#--###-#--#--###-#--#--###-#--#--###-#--#--###-#--#--###-#--#--###-#--#--###-#--#--##
--#-#-#--#--#-#-#--#--#-#-#--#--#-#-#--#--#-#-#--#--#-#-#--#--#-#-#--#--#-#-#--#--#-#-#--#--#-#-#--#
#---#----##---#----##---#----##---#----##---#----##---#----##---#----##---#----##---#----##---#----#
-##--------##--------##--------##--------##--------##--------##--------##--------##--------##-------
-------##--------##--------##--------##--------##--------##--------##--------##--------##--------##-
-----#-#-------#-#-------#-#-------#-#-------#-#-------#-#-------#-#-------#-#-------#-#-------#-#--
--#-##--#---#-##--#---#-##--#---#-##--#---#-##--#---#-##--#---#-##--#---#-##--#---#-##--#---#-##--#-
##----#---##----#---##----#---##----#---##----#---##----#---##----#---##----#---##----#---##----#---
#------#--#------#--#------#--#------#--#------#--#------#--#------#--#------#--#------#--#------#--
