---##----#---##----#---##----#---##----#---##----#---##----#---##----#---##----#---##----#---##----#
---##--##----##--##----##--##----##--##----##--##----##--##----##--##----##--##----##--##----##--##-
--#------#--#------#--#------#--#------#--#------#--#------#--#------#--#------#--#------#--#------#
###---#---###---#---###---#---###---#---###---#---###---#---###---#---###---#---###---#---###---#---
-#-#####-#-#-#####-#-#-#####-#-#-#####-#-#-#####-#-#-#####-#-#-#####-#-#-#####-#-#-#####-#-#-#####-#
##--------##--------##--------##--------##--------##--------##--------##--------##--------##--------
#---------#---------#---------#---------#---------#---------#---------#---------#---------#---------
--------#---------#---------#---------#---------#---------#---------#---------#---------#---------#-
#-#--#-#--#-#--#-#--#-#--#-#--#-#--#-#--#-#--#-#--#-#--#-#--#-#--#-#--#-#--#-#--#-#--#-#--#-#--#-#--
#---------#---------#---------#---------#---------#---------#---------#---------#---------#---------
---##----#---##----#---##----#---##----#---##----#---##----#---##----#---##----#---##----#---##----#
---##--##----##--##----##--##----##--##----##--##----##--##----##--##----##--##----##--##----##--##-
--#------#--#------#--#------#--#------#--#------#--#------#--#------#--#------#--#------#--#------#
###---#---###---#---###---#---###---#---###---#---###---#---###---#---###---#---###---#---###---#---
-#-#####-#-#-#####-#-#-#####-#-#-#####-#-#-#####-#-#-#####-#-#-#####-#-#-#####-#-#-#####-#-#-#####-#
##--------##--------##--------##--------##--------##--------##--------##--------##--------##--------
#---------#---------#---------#---------#---------#---------#---------#---------#---------#---------
--------#---------#---------#---------#---------#---------#---------#---------#---------#---------#-
#-#--#-#--#-#--#-#--#-#--#-#--#-#--#-#--#-#--#-#--#-#--#-#--#-#--#-#--#-#--#-#--#-#--#-#--#-#--#-#--
#---------#---------#---------#---------#---------#---------#---------#---------#---------#---------
---##----#---##----#---##----#---##----#---##----#---##----#---##----#---##----#---##----#---##----#
---##--##----##--##----##--##----##--##----##--##----##--##----##--##----##--##----##--##----##--##-
--#------#--#------#--#------#--#------#--#------#--#------#--#------#--#------#--#------#--#------#
###---#---###---#---###---#---###---#---###---#---###---#---###---#---###---#---###---#---###---#---
-#-#####-#-#-#####-#-#-#####-#-#-#####-#-#-#####-#-#-#####-#-#-#####-#-#-#####-#-#-#####-#-#-#####-#
##--------##--------##--------##--------##--------##--------##--------##--------##--------##--------
#---------#---------#---------#---------#---------#---------#---------#---------#---------#---------
--------#---------#---------#---------#---------#---------#---------#---------#---------#---------#-
#-#--#-#--#-#--#-#--#-#--#-#--#-#--#-#--#-#--#-#--#-#--#-#--#-#--#-#--#-#--#-#--#-#--#-#--#-#--#-#--
#---------#---------#---------#---------#---------#---------#---------#---------#---------#---------
---##----#---##----#---##----#---##----#---##----#---##----#---##----#---##----#---##----#---##----#
---##--##----##--##----##--##----##--##----##--##----##--##----##--##----##--##----##--##----##--##-
--#------#--#------#--#------#--#------#--#------#--#------#--#------#--#------#--#------#--#------#
###---#---###---#---###---#---###---#---###---#---###---#---###---#---###---#---###---#---###---#---
-#-#####-#-#-#####-#-#-#####-#-#-#####-#-#-#####-#-#-#####-#-#-#####-#-#-#####-#-#-#####-#-#-#####-#
##--------##--------##--------##--------##--------##--------##--------##--------##--------##--------
#---------#---------#---------#---------#---------#---------#---------#---------#---------#---------
--------#---------#---------#---------#S--------#---------#---------#---------#---------#---------#-
#-#--#-#--#-#--#-#--#-#--#-#--#-#--#-#--#-#--#-#--#-#--#-#--#-#--#-#--#-#--#-#--#-#--#-#--#-#--#-#--
#---------#---------#---------#---------#---------#---------#---------#---------#---------#---------
---##----#---##----#---##----#---##----#---##----#---##----#---##----#---##----#---##----#---##----#
---##--##----##--##----##--##----##--##----##--##----##--##----##--##----##--##----##--##----##--##-
--#------#--#------#--#------#--#------#--#------#--#------#--#------#--#------#--#------#--#------#
###---#---###---#---###---#---###---#---###---#---###---#---###---#---###---#---###---#---###---#---
-#-#####-#-#-#####-#-#-#####-#-#-#####-#-#-#####-#-#-#####-#-#-#####-#-#-#####-#-#-#####-#-#-#####-#
##--------##--------##--------##--------##--------##--------##--------##--------##--------##--------
#---------#---------#---------#---------#---------#---------#---------#---------#---------#---------
--------#---------#---------#---------#---------#---------#---------#---------#---------#---------#-
#-#--#-#--#-#--#-#--#-#--#-#--#-#--#-#--#-#--#-#--#-#--#-#--#-#--#-#--#-#--#-#--#-#--#-#--#-#--#-#--
#---------#---------#---------#---------#---------#---------#---------#---------#---------#---------
---##----#---##----#---##----#---##----#---##----#---##----#---##----#---##----#---##----#---##----#
---##--##----##--##----##--##----##--##----##--##----##--##----##--##----##--##----##--##----##--##-
--#------#--#------#--#------#--#------#--#------#--#------#--#------#--#------#--#------#--#------#
###---#---###---#---###---#---###---#---###---#---###---#---###---#---###---#---###---#---###---#---
-#-#####-#-#-#####-#-#-#####-#-#-#####-#-#-#####-#-#-#####-#-#-#####-#-#-#####-#-#-#####-#-#-#####-#
##--------##--------##--------##--------##--------##--------##--------##--------##--------##--------
#---------#---------#---------#---------#---------#---------#---------#---------#---------#---------
--------#---------#---------#---------#---------#---------#---------#---------#---------#---------#-
#-#--#-#--#-#--#-#--#-#--#-#--#-#--#-#--#-#--#-#--#-#--#-#--#-#--#-#--#-#--#-#--#-#--#-#--#-#--#-#--
#---------#---------#---------#---------#---------#---------#---------#---------#---------#---------
---##----#---##----#---##----#---##----#---##----#---##----#---##----#---##----#---##----#---##----#
---##--##----##--##----##--##----##--##----##--##----##--##----##--##----##--##----##--##----##--##-
--#------#--#------#--#------#--#------#--#------#--#------#--#------#--#------#--#------#--#------#
###---#---###---#---###---#---###---#---###---#---###---#---###---#---###---#---###---#---###---#---
-#-#####-#-#-#####-#-#-#####-#-#-#####-#-#-#####-#-#-#####-#-#-#####-#-#-#####-#-#-#####-#-#-#####-#
##--------##--------##--------##--------##--------##--------##--------##--------##--------##--------
#---------#---------#---------#---------#---------#---------#---------#---------#---------#---------
--------#---------#---------#---------#---------#---------#---------#---------#---------#---------#-
#-#--#-#--#-#--#-#--#-#--#-#--#-#--#-#--#-#--#-#--#-#--#-#--#-#--#-#--#-#--#-#--#-#--#-#--#-#--#-#--
#---------#---------#---------#---------#---------#---------#---------#---------#---------#---------
---##----#---##----#---##----#---##----#---##----#---##----#---##----#---##----#---##----#---##----#
---##--##----##--##----##--##----##--##----##--##----##--##----##--##----##--##----##--##----##--##-
--#------#--#------#--#------#--#------#--#------#--#------#--#------#--#------#--#------#--#------#
###---#---###---#---###---#---###---#---###---#---###---#---###---#---###---#---###---#---###---#---
-#-#####-#-#-#####-#-#-#####-#-#-#####-#-#-#####-#-#-#####-#-#-#####-#-#-#####-#-#-#####-#-#-#####-#
##--------##--------##--------##--------##--------##--------##--------##--------##--------##--------
#---------#---------#---------#---------#---------#---------#---------#---------#---------#---------
--------#---------#---------#---------#---------#---------#---------#---------#---------#---------#-
#-#--#-#--#-#--#-#--#-#--#-#--#-#--#-#--#-#--#-#--#-#--#-#--#-#--#-#--#-#--#-#--#-#--#-#--#-#--#-#--
#---------#---------#---------#---------#--E------#---------#---------#---------#---------#---------
---##----#---##----#---##----#---##----#---##----#---##----#---##----#---##----#---##----#---##----#
---##--##----##--##----##--##----##--##----##--##----##--##----##--##----##--##----##--##----##--##-
--#------#--#------#--#------#--#------#--#------#--#------#--#------#--#------#--#------#--#------#
###---#---###---#---###---#---###---#---###---#---###---#---###---#---###---#---###---#---###---#---
-#-#####-#-#-#####-#-#-#####-#-#-#####-#-#-#####-#-#-#####-#-#-#####-#-#-#####-#-#-#####-#-#-#####-#
##--------##--------##--------##--------##--------##--------##--------##--------##--------##--------
#---------#---------#---------#---------#---------#---------#---------#---------#---------#---------
--------#---------#---------#---------#---------#---------#---------#---------#---------#---------#-
#-#--#-#--#-#--#-#--#-#--#-#--#-#--#-#--#-#--#-#--#-#--#-#--#-#--#-#--#-#--#-#--#-#--#-#--#-#--#-#--
#---------#---------#---------#---------#---------#---------#---------#---------#---------#---------
---##----#---##----#---##----#---##----#---##----#---##----#---##----#---##----#---##----#---##----#
---##--##----##--##----##--##----##--##----##--##----##--##----##--##----##--##----##--##----##--##-
--#------#--#------#--#------#--#------#--#------#--#------#--#------#--#------#--#------#--#------#
###---#---###---#---###---#---###---#---###---#---###---#---###---#---###---#---###---#---###---#---
-#-#####-#-#-#####-#-#-#####-#-#-#####-#-#-#####-#-#-#####-#-#-#####-#-#-#####-#-#-#####-#-#-#####-#
##--------##--------##--------##--------##--------##--------##--------##--------##--------##--------
#---------#---------#---------#---------#---------#---------#---------#---------#---------#---------
--------#---------#---------#---------#---------#---------#---------#---------#---------#---------#-
#-#--#-#--#-#--#-#--#-#--#-#--#-#--#-#--#-#--#-#--#-#--#-#--#-#--#-#--#-#--#-#--#-#--#-#--#-#--#-#--
#---------#---------#---------#---------#---------#---------#---------#---------#---------#---------
