#-----#-#-#-----#-#-#-----#-#-#-----#-#-#-----#-#-#-----#-#-#-----#-#-#-----#-#-#-----#-#-#-----#-#-
------##--------##--------##--------##--------##--------##--------##--------##--------##--------##--
---#---------#---------#---------#---------#---------#---------#---------#---------#---------#------
-###-#--#--###-#--#--###-#--#--###-#--#--###-#--#--###-#--#--###-#--#--###-#--#--###-#--#--###-#--#-
#--------##--------##--------##--------##--------##--------##--------##--------##--------##--------#
-#--#------#--#------#--#------#--#------#--#------#--#------#--#------#--#------#--#------#--#-----
-----#-#-#-----#-#-#-----#-#-#-----#-#-#-----#-#-#-----#-#-#-----#-#-#-----#-#-#-----#-#-#-----#-#-#
-------#---------#---------#---------#---------#---------#---------#---------#---------#---------#--
-#------#--#------#--#------#--#------#--#------#--#------#--#------#--#------#--#------#--#------#-
-----#-#-------#-#-------#-#-------#-#-------#-#-------#-#-------#-#-------#-#-------#-#-------#-#--
#-----#-#-#-----#-#-#-----#-#-#-----#-#-#-----#-#-#-----#-#-#-----#-#-#-----#-#-#-----#-#-#-----#-#-
------##--------##--------##--------##--------##--------##--------##--------##--------##--------##--
---#---------#---------#---------#---------#---------#---------#---------#---------#---------#------
-###-#--#--###-#--#--###-#--#--###-#--#--###-#--#--###-#--#--###-#--#--###-#--#--###-#--#--###-#--#-
#--------##--------##--------##--------##--------##--------##--------##--------##--------##--------#
-#--#------#--#------#--#------#--#------#--#------#--#------#--#------#--#------#--#------#--#-----
-----#-#-#-----#-#-#-----#-#-#-----#-#-#-----#-#-#-----#-#-#-----#-#-#-----#-#-#-----#-#-#-----#-#-#
-------#---------#---------#---------#---------#---------#---------#---------#---------#---------#--
-#------#--#------#--#------#--#------#--#------#--#------#--#------#--#------#--#------#--#------#-
-----#-#-------#-#-------#-#-------#-#-------#-#-------#-#-------#-#-------#-#-------#-#-------#-#--
#-----#-#-#-----#-#-#-----#-#-#-----#-#-#-----#-#-#-----#-#-#-----#-#-#-----#-#-#-----#-#-#-----#-#-
------##--------##--------##--------##--------##--------##--------##--------##--------##--------##--
---#---------#---------#---------#---------#---------#---------#---------#---------#---------#------
-###-#--#--###-#--#--###-#--#--###-#--#--###-#--#--###-#--#--###-#--#--###-#--#--###-#--#--###-#--#-
#--------##--------##--------##--------##--------##--------##--------##--------##--------##--------#
-#--#------#--#------#--#------#--#------#--#------#--#------#--#------#--#------#--#------#--#-----
-----#-#-#-----#-#-#-----#-#-#-----#-#-#-----#-#-#-----#-#-#-----#-#-#-----#-#-#-----#-#-#-----#-#-#
-------#---------#---------#---------#---------#---------#---------#---------#---------#---------#--
-#------#--#------#--#------#--#------#--#------#--#------#--#------#--#------#--#------#--#------#-
-----#-#-------#-#-------#-#-------#-#-------#-#-------#-#-------#-#-------#-#-------#-#-------#-#--
#-----#-#-#-----#-#-#-----#-#-#-----#-#-#-----#-#-#-----#-#-#-----#-#-#-----#-#-#-----#-#-#-----#-#-
------##--------##--------##--------##--------##--------##--------##--------##--------##--------##--
---#---------#---------#---------#---------#---------#---------#---------#---------#---------#------
-###-#--#--###-#--#--###-#--#--###-#--#--###-#--#--###-#--#--###-#--#--###-#--#--###-#--#--###-#--#-
#--------##--------##--------##--------##--------##--------##--------##--------##--------##--------#
-#--#------#--#------#--#------#--#------#--#------#--#------#--#------#--#------#--#------#--#-----
-----#-#-#-----#-#-#-----#-#-#-----#-#-#-----#-#-#-----#-#-#-----#-#-#-----#-#-#-----#-#-#-----#-#-#
-------#---------#---------#---------#---------#---------#---------#---------#---------#---------#--
-#------#--#------#--#------#--#------#--#------#--#------#--#------#--#------#--#------#--#------#-
-----#-#-------#-#-------#-#-------#-#-------#-#-------#-#-------#-#-------#-#-------#-#-------#-#--
#-----#-#-#-----#-#-#-----#-#-#-----#-#-#-----#-#-#-----#-#-#-----#-#-#-----#-#-#-----#-#-#-----#-#-
------##--------##--------##--------##--------##--------##--------##--------##--------##--------##--
---#---------#---------#---------#---------#---------#---------#---------#---------#---------#------
-###-#--#--###-#--#--###-#--#--###-#--#--###-#--#--###-#--#--###-#--#--###-#--#--###-#--#--###-#--#-
#--------##--------##--------##--------##--------##--------##--------##--------##--------##--------#
-#--#------#--#------#--#------#--#-----E#--#------#--#------#--#------#--#------#--#------#--#-----
-----#-#-#-----#-#-#-----#-#-#-----#-#-#-----#-#-#-----#-#-#-----#-#-#-----#-#-#-----#-#-#-----#-#-#
-------#---------#---------#---------#---------#---------#---------#---------#---------#---------#--
-#------#--#------#--#------#--#------#--#------#--#------#--#------#--#------#--#------#--#------#-
-----#-#-------#-#-------#-#-------#-#-------#-#-------#-#-------#-#-------#-#-------#-#-------#-#--
#-----#-#-#-----#-#-#-----#-#-#-----#-#-#-----#-#-#-----#-#-#-----#-#-#-----#-#-#-----#-#-#-----#-#-
------##--------##--------##--------##--------##--------##--------##--------##--------##--------##--
---#---------#---------#---------#---------#---------#---------#---------#---------#---------#------
-###-#--#--###-#--#--###-#--#--###-#-S#--###-#--#--###-#--#--###-#--#--###-#--#--###-#--#--###-#--#-
#--------##--------##--------##--------##--------##--------##--------##--------##--------##--------#
-#--#------#--#------#--#------#--#------#--#------#--#------#--#------#--#------#--#------#--#-----
-----#-#-#-----#-#-#-----#-#-#-----#-#-#-----#-#-#-----#-#-#-----#-#-#-----#-#-#-----#-#-#-----#-#-#
-------#---------#---------#---------#---------#---------#---------#---------#---------#---------#--
-#------#--#------#--#------#--#------#--#------#--#------#--#------#--#------#--#------#--#------#-
-----#-#-------#-#-------#-#-------#-#-------#-#-------#-#-------#-#-------#-#-------#-#-------#-#--
#-----#-#-#-----#-#-#-----#-#-#-----#-#-#-----#-#-#-----#-#-#-----#-#-#-----#-#-#-----#-#-#-----#-#-
------##--------##--------##--------##--------##--------##--------##--------##--------##--------##--
---#---------#---------#---------#---------#---------#---------#---------#---------#---------#------
-###-#--#--###-#--#--###-#--#--###-#--#--###-#--#--###-#--#--###-#--#--###-#--#--###-#--#--###-#--#-
#--------##--------##--------##--------##--------##--------##--------##--------##--------##--------#
-#--#------#--#------#--#------#--#------#--#------#--#------#--#------#--#------#--#------#--#-----
-----#-#-#-----#-#-#-----#-#-#-----#-#-#-----#-#-#-----#-#-#-----#-#-#-----#-#-#-----#-#-#-----#-#-#
-------#---------#---------#---------#---------#---------#---------#---------#---------#---------#--
-#------#--#------#--#------#--#------#--#------#--#------#--#------#--#------#--#------#--#------#-
-----#-#-------#-#-------#-#-------#-#-------#-#-------#-#-------#-#-------#-#-------#-#-------#-#--
#-----#-#-#-----#-#-#-----#-#-#-----#-#-#-----#-#-#-----#-#-#-----#-#-#-----#-#-#-----#-#-#-----#-#-
------##--------##--------##--------##--------##--------##--------##--------##--------##--------##--
---#---------#---------#---------#---------#---------#---------#---------#---------#---------#------
-###-#--#--###-#--#--###-#--#--###-#--#--###-#--#--###-#--#--###-#--#--###-#--#--###-#--#--###-#--#-
#--------##--------##--------##--------##--------##--------##--------##--------##--------##--------#
-#--#------#--#------#--#------#--#------#--#------#--#------#--#------#--#------#--#------#--#-----
-----#-#-#-----#-#-#-----#-#-#-----#-#-#-----#-#-#-----#-#-#-----#-#-#-----#-#-#-----#-#-#-----#-#-#
-------#---------#---------#---------#---------#---------#---------#---------#---------#---------#--
-#------#--#------#--#------#--#------#--#------#--#------#--#------#--#------#--#------#--#------#-
-----#-#-------#-#-------#-#-------#-#-------#-#-------#-#-------#-#-------#-#-------#-#-------#-#--
#-----#-#-#-----#-#-#-----#-#-#-----#-#-#-----#-#-#-----#-#-#-----#-#-#-----#-#-#-----#-#-#-----#-#-
------##--------##--------##--------##--------##--------##--------##--------##--------##--------##--
---#---------#---------#---------#---------#---------#---------#---------#---------#---------#------
-###-#--#--###-#--#--###-#--#--###-#--#--###-#--#--###-#--#--###-#--#--###-#--#--###-#--#--###-#--#-
#--------##--------##--------##--------##--------##--------##--------##--------##--------##--------#
-#--#------#--#------#--#------#--#------#--#------#--#------#--#------#--#------#--#------#--#-----
-----#-#-#-----#-#-#-----#-#-#-----#-#-#-----#-#-#-----#-#-#-----#-#-#-----#-#-#-----#-#-#-----#-#-#
-------#---------#---------#---------#---------#---------#---------#---------#---------#---------#--
-#------#--#------#--#------#--#------#--#------#--#------#--#------#--#------#--#------#--#------#-
-----#-#-------#-#-------#-#-------#-#-------#-#-------#-#-------#-#-------#-#-------#-#-------#-#--
#-----#-#-#-----#-#-#-----#-#-#-----#-#-#-----#-#-#-----#-#-#-----#-#-#-----#-#-#-----#-#-#-----#-#-
------##--------##--------##--------##--------##--------##--------##--------##--------##--------##--
---#---------#---------#---------#---------#---------#---------#---------#---------#---------#------
-###-#--#--###-#--#--###-#--#--###-#--#--###-#--#--###-#--#--###-#--#--###-#--#--###-#--#--###-#--#-
#--------##--------##--------##--------##--------##--------##--------##--------##--------##--------#
-#--#------#--#------#--#------#--#------#--#------#--#------#--#------#--#------#--#------#--#-----
-----#-#-#-----#-#-#-----#-#-#-----#-#-#-----#-#-#-----#-#-#-----#-#-#-----#-#-#-----#-#-#-----#-#-#
-------#---------#---------#---------#---------#---------#---------#---------#---------#---------#--
-#------#--#------#--#------#--#------#--#------#--#------#--#------#--#------#--#------#--#------#-
-----#-#-------#-#-------#-#-------#-#-------#-#-------#-#-------#-#-------#-#-------#-#-------#-#--
