----##--------##--------##--------##--------##--------##--------##--------##--------##--------##----
-###-------###-------###-------###-------###-------###-------###-------###-------###-------###------
--#--#------#--#------#--#------#--#------#--#------#--#------#--#------#--#------#--#------#--#----
#-#----#-##-#----#-##-#----#-##-#----#-##-#----#-##-#----#-##-#----#-##-#----#-##-#----#-##-#----#-#
----------------------------------------------------------------------------------------------------
-----#---------#---------#---------#---------#---------#---------#---------#---------#---------#----
#-##-#--#-#-##-#--#-#-##-#--#-#-##-#--#-#E##-#--#-#-##-#--#-#-##-#--#-#-##-#--#-#-##-#--#-#-##-#--#-
--#---------#---------#---------#---------#---------#---------#---------#---------#---------#-------
-#---------#---------#---------#---------#---------#---------#---------#---------#---------#--------
##----#-####----#-####----#-####----#-####----#-####----#-####----#-####----#-####----#-####----#-##
----##--------##--------##--------##--------##--------##--------##--------##--------##--------##----
-###-------###-------###-------###-------###-------###-------###-------###-------###-------###------
--#--#------#--#------#--#------#--#------#--#------#--#------#--#------#--#------#--#------#--#----
#-#----#-##-#----#-##-#----#-##-#----#-##-#----#-##-#----#-##-#----#-##-#----#-##-#----#-##-#----#-#
----------------------------------------------------------------------------------------------------
-----#---------#---------#---------#---------#---------#---------#---------#---------#---------#----
#-##-#--#-#-##-#--#-#-##-#--#-#-##-#--#-#-##-#--#-#-##-#--#-#-##-#--#-#-##-#--#-#-##-#--#-#-##-#--#-
--#---------#---------#---------#---------#---------#---------#---------#---------#---------#-------
-#---------#---------#---------#---------#---------#---------#---------#---------#---------#--------
##----#-####----#-####----#-####----#-####----#-####----#-####----#-####----#-####----#-####----#-##
----##--------##--------##--------##--------##--------##--------##--------##--------##--------##----
-###-------###-------###-------###-------###-------###-------###-------###-------###-------###------
--#--#------#--#------#--#------#--#------#--#------#--#------#--#------#--#------#--#------#--#----
#-#----#-##-#----#-##-#----#-##-#----#-##-#----#-##-#----#-##-#----#-##-#----#-##-#----#-##-#----#-#
----------------------------------------------------------------------------------------------------
-----#---------#---------#---------#---------#---------#---------#---------#---------#---------#----
#-##-#--#-#-##-#--#-#-##-#--#-#-##-#--#-#-##-#--#-#-##-#--#-#-##-#--#-#-##-#--#-#-##-#--#-#-##-#--#-
--#---------#---------#---------#---------#---------#---------#---------#---------#---------#-------
-#---------#---------#---------#---------#---------#---------#---------#---------#---------#--------
##----#-####----#-####----#-####----#-####----#-####----#-####----#-####----#-####----#-####----#-##
----##--------##--------##--------##--------##--------##--------##--------##--------##--------##----
-###-------###-------###-------###-------###-------###-------###-------###-------###-------###------
--#--#------#--#------#--#------#--#------#--#------#--#------#--#------#--#------#--#------#--#----
#-#----#-##-#----#-##-#----#-##-#----#-##-#----#-##-#----#-##-#----#-##-#----#-##-#----#-##-#----#-#
----------------------------------------------------------------------------------------------------
-----#---------#---------#---------#---------#---------#---------#---------#---------#---------#----
#-##-#--#-#-##-#--#-#-##-#--#-#-##-#--#-#-##-#--#-#-##-#--#-#-##-#--#-#-##-#--#-#-##-#--#-#-##-#--#-
--#---------#---------#---------#---------#---------#---------#---------#---------#---------#-------
-#---------#---------#---------#---------#---------#---------#---------#---------#---------#--------
##----#-####----#-####----#-####----#-####----#-####----#-####----#-####----#-####----#-####----#-##
----##--------##--------##--------##--------##--------##--------##--------##--------##--------##----
-###-------###-------###-------###-------###-------###-------###-------###-------###-------###------
--#--#------#--#------#--#------#--#------#--#------#--#------#--#------#--#------#--#------#--#----
#-#----#-##-#----#-##-#----#-##-#----#-##-#----#-##-#----#-##-#----#-##-#----#-##-#----#-##-#----#-#
----------------------------------------------------------------------------------------------------
-----#---------#---------#---------#---------#---------#---------#---------#---------#---------#----
#-##-#--#-#-##-#--#-#-##-#--#-#-##-#--#-#-##-#--#-#-##-#--#-#-##-#--#-#-##-#--#-#-##-#--#-#-##-#--#-
--#---------#---------#---------#---------#---------#---------#---------#---------#---------#-------
-#---------#---------#---------#---------#---------#---------#---------#---------#---------#--------
##----#-####----#-####----#-####----#-####----#-####----#-####----#-####----#-####----#-####----#-##
----##--------##--------##--------##--------##--------##--------##--------##--------##--------##----
-###-------###-------###-------###-------###-------###-------###-------###-------###-------###------
--#--#------#--#------#--#------#--#------#--#------#--#------#--#------#--#------#--#------#--#----
#-#----#-##-#----#-##-#----#-##-#----#-##-#----#-##-#----#-##-#----#-##-#----#-##-#----#-##-#----#-#
----------------------------------------------------------------------------------------------------
-----#---------#---------#---------#---------#---------#---------#---------#---------#---------#----
#-##-#--#-#-##-#--#-#-##-#--#-#-##-#--#-#-##-#--#-#-##-#--#-#-##-#--#-#-##-#--#-#-##-#--#-#-##-#--#-
--#---------#---------#---------#---------#---------#---------#---------#---------#---------#-------
-#---------#---------#---------#---------#---------#---------#---------#---------#---------#--------
##----#-####----#-####----#-####----#-####----#-####----#-####----#-####----#-####----#-####----#-##
----##--------##--------##--------##--------##--------##--------##--------##--------##--------##----
-###-------###-------###-------###-------###-------###-------###-------###-------###-------###------
--#--#------#--#------#--#------#--#------#--#------#--#------#--#------#--#------#--#------#--#----
#-#----#-##-#----#-##-#----#-##-#----#-##-#----#-##-#----#-##-#----#-##-#----#-##-#----#-##-#----#-#
----------------------------------------------------------------------------------------------------
-----#---------#---------#-------S-#---------#---------#---------#---------#---------#---------#----
#-##-#--#-#-##-#--#-#-##-#--#-#-##-#--#-#-##-#--#-#-##-#--#-#-##-#--#-#-##-#--#-#-##-#--#-#-##-#--#-
--#---------#---------#---------#---------#---------#---------#---------#---------#---------#-------
-#---------#---------#---------#---------#---------#---------#---------#---------#---------#--------
##----#-####----#-####----#-####----#-####----#-####----#-####----#-####----#-####----#-####----#-##
----##--------##--------##--------##--------##--------##--------##--------##--------##--------##----
-###-------###-------###-------###-------###-------###-------###-------###-------###-------###------
--#--#------#--#------#--#------#--#------#--#------#--#------#--#------#--#------#--#------#--#----
#-#----#-##-#----#-##-#----#-##-#----#-##-#----#-##-#----#-##-#----#-##-#----#-##-#----#-##-#----#-#
----------------------------------------------------------------------------------------------------
-----#---------#---------#---------#---------#---------#---------#---------#---------#---------#----
#-##-#--#-#-##-#--#-#-##-#--#-#-##-#--#-#-##-#--#-#-##-#--#-#-##-#--#-#-##-#--#-#-##-#--#-#-##-#--#-
--#---------#---------#---------#---------#---------#---------#---------#---------#---------#-------
-#---------#---------#---------#---------#---------#---------#---------#---------#---------#--------
##----#-####----#-####----#-####----#-####----#-####----#-####----#-####----#-####----#-####----#-##
----##--------##--------##--------##--------##--------##--------##--------##--------##--------##----
-###-------###-------###-------###-------###-------###-------###-------###-------###-------###------
--#--#------#--#------#--#------#--#------#--#------#--#------#--#------#--#------#--#------#--#----
#-#----#-##-#----#-##-#----#-##-#----#-##-#----#-##-#----#-##-#----#-##-#----#-##-#----#-##-#----#-#
----------------------------------------------------------------------------------------------------
-----#---------#---------#---------#---------#---------#---------#---------#---------#---------#----
#-##-#--#-#-##-#--#-#-##-#--#-#-##-#--#-#-##-#--#-#-##-#--#-#-##-#--#-#-##-#--#-#-##-#--#-#-##-#--#-
--#---------#---------#---------#---------#---------#---------#---------#---------#---------#-------
-#---------#---------#---------#---------#---------#---------#---------#---------#---------#--------
##----#-####----#-####----#-####----#-####----#-####----#-####----#-####----#-####----#-####----#-##
----##--------##--------##--------##--------##--------##--------##--------##--------##--------##----
-###-------###-------###-------###-------###-------###-------###-------###-------###-------###------
--#--#------#--#------#--#------#--#------#--#------#--#------#--#------#--#------#--#------#--#----
#-#----#-##-#----#-##-#----#-##-#----#-##-#----#-##-#----#-##-#----#-##-#----#-##-#----#-##-#----#-#
----------------------------------------------------------------------------------------------------
-----#---------#---------#---------#---------#---------#---------#---------#---------#---------#----
#-##-#--#-#-##-#--#-#-##-#--#-#-##-#--#-#-##-#--#-#-##-#--#-#-##-#--#-#-##-#--#-#-##-#--#-#-##-#--#-
--#---------#---------#---------#---------#---------#---------#---------#---------#---------#-------
-#---------#---------#---------#---------#---------#---------#---------#---------#---------#--------
##----#-####----#-####----#-####----#-####----#-####----#-####----#-####----#-####----#-####----#-##
