--###---#---###---#---###---#---###---#---###---#---###---#---###---#---###---#---###---#---###---#-
----------------------------------------------------------------------------------------------------
-----#---------#---------#---------#---------#---------#---------#---------#---------#---------#----
#---##----#---##----#---##----#---##----#---##----#---##----#---##----#---##----#---##----#---##----
-#---#-----#---#-----#---#-----#---#-----#---#-----#---#-----#---#-----#---#-----#---#-----#---#----
#--#--#--##--#--#--##--#--#--##--#--#--##--#--#--##--#--#--##--#--#--##--#--#--##--#--#--##--#--#--#
-#--#------#--#------#--#------#--#------#--#------#--#------#--#------#--#------#--#------#--#-----
--#----##---#----##---#----##---#----##---#----##---#----##---#----##---#----##---#----##---#----##-
-#---#-#---#---#-#---#---#-#---#---#-#---#---#-#---#---#-#---#---#-#---#---#-#---#---#-#---#---#-#--
--------##--------##--------##--------##--------##--------##--------##--------##--------##--------##
--###---#---###---#---###---#---###---#---###---#---###---#---###---#---###---#---###---#---###---#-
----------------------------------------------------------------------------------------------------
-----#---------#---------#---------#---------#---------#---------#---------#---------#---------#----
#---##----#---##----#---##----#---##----#---##----#---##----#---##----#---##----#---##----#---##----
-#---#-----#---#-----#---#-----#---#-----#---#-----#---#-----#---#-----#---#-----#---#-----#---#----
#--#--#--##--#--#--##--#--#--##--#--#--##--#--#--##--#--#--##--#--#--##--#--#--##--#--#--##--#--#--#
-#--#------#--#------#--#------#--#------#--#------#--#------#--#------#--#------#--#------#--#-----
--#----##---#----##---#----##---#----##---#----##---#----##---#----##---#----##---#----##---#----##-
-#---#-#---#---#-#---#---#-#---#---#-#---#---#-#---#---#-#---#---#-#---#---#-#---#---#-#---#---#-#--
--------##--------##--------##--------##--------##--------##--------##--------##--------##--------##
--###---#---###---#---###---#---###---#---###---#---###---#---###---#---###---#---###---#---###---#-
----------------------------------------------------------------------------------------------------
-----#--------E#---------#---------#---------#---------#---------#---------#---------#---------#----
#---##----#---##----#---##----#---##----#---##----#---##----#---##----#---##----#---##----#---##----
-#---#-----#---#-----#---#-----#---#-----#---#-----#---#-----#---#-----#---#-----#---#-----#---#----
#--#--#--##--#--#--##--#--#--##--#--#--##--#--#--##--#--#--##--#--#--##--#--#--##--#--#--##--#--#--#
-#--#------#--#------#--#------#--#------#--#------#--#------#--#------#--#------#--#------#--#-----
--#----##---#----##---#----##---#----##---#----##---#----##---#----##---#----##---#----##---#----##-
-#---#-#---#---#-#---#---#-#---#---#-#---#---#-#---#---#-#---#---#-#---#---#-#---#---#-#---#---#-#--
--------##--------##--------##--------##--------##--------##--------##--------##--------##--------##
--###---#---###---#---###---#---###---#---###---#---###---#---###---#---###---#---###---#---###---#-
----------------------------------------------------------------------------------------------------
-----#---------#---------#---------#---------#---------#---------#---------#---------#---------#----
#---##----#---##----#---##----#---##----#---##----#---##----#---##----#---##----#---##----#---##----
-#---#-----#---#-----#---#-----#---#-----#---#-----#---#-----#---#-----#---#-----#---#-----#---#----
#--#--#--##--#--#--##--#--#--##--#--#--##--#--#--##--#--#--##--#--#--##--#--#--##--#--#--##--#--#--#
-#--#------#--#------#--#------#--#------#--#------#--#------#--#------#--#------#--#------#--#-----
--#----##---#----##---#----##---#----##---#----##---#----##---#----##---#----##---#----##---#----##-
-#---#-#---#---#-#---#---#-#---#---#-#---#---#-#---#---#-#---#---#-#---#---#-#---#---#-#---#---#-#--
--------##--------##--------##--------##--------##--------##--------##--------##--------##--------##
--###---#---###---#---###---#---###---#---###---#---###---#---###---#---###---#---###---#---###---#-
----------------------------------------------------------------------------------------------------
-----#---------#---------#---------#---------#---------#---------#---------#---------#---------#----
#---##----#---##----#---##----#---##----#---##----#---##----#---##----#---##----#---##----#---##----
-#---#-----#---#-----#---#-----#---#-----#---#-----#---#-----#---#-----#---#-----#---#-----#---#----
#--#--#--##--#--#--##--#--#--##--#--#--##--#--#--##--#--#--##--#--#--##--#--#--##--#--#--##--#--#--#
-#--#------#--#------#--#------#--#------#--#------#--#------#--#------#--#------#--#------#--#-----
--#----##---#----##---#----##---#----##---#----##---#----##---#----##---#----##---#----##---#----##-
-#---#-#---#---#-#---#---#-#---#---#-#---#---#-#---#---#-#---#---#-#---#---#-#---#---#-#---#---#-#--
--------##--------##--------##--------##--------##--------##--------##--------##--------##--------##
--###---#---###---#---###---#---###---#---###---#---###---#---###---#---###---#---###---#---###---#-
----------------------------------------------------------------------------------------------------
-----#---------#---------#---------#---------#---------#---------#---------#---------#---------#----
#---##----#---##----#---##----#---##----#---##----#---##----#---##----#---##----#---##----#---##----
-#---#-----#---#-----#---#-----#---#-----#---#-----#---#-----#---#-----#---#-----#---#-----#---#----
#--#--#--##--#--#--##--#--#--##--#--#--##--#--#--##--#--#--##--#--#--##--#--#--##--#--#--##--#--#--#
-#--#------#--#------#--#------#--#------#--#------#--#------#--#------#--#------#--#------#--#-----
--#----##---#----##---#----##---#----##---#----##---#----##---#----##---#----##---#----##---#----##-
-#---#-#---#---#-#---#---#-#---#---#-#---#---#-#---#---#-#---#---#-#---#---#-#---#---#-#---#---#-#--
--------##--------##--------##--------##--------##--------##--------##--------##--------##--------##
--###---#---###---#---###---#---###---#---###---#---###---#---###---#---###---#---###---#---###---#-
----------------------------------------------------------------------------------------------------
-----#---------#---------#---------#---------#---------#---------#---------#---------#---------#----
#---##----#---##----#---##----#---##----#---##----#---##----#---##----#---##----#---##----#---##----
-#---#-----#---#-----#---#-----#---#-----#---#-----#---#-----#---#-----#---#-----#---#-----#---#----
#--#--#--##--#--#--##--#--#--##--#--#--##--#--#--##--#--#--##--#--#--##--#--#--##--#--#--##--#--#--#
-#--#------#--#------#--#------#--#------#--#------#--#------#--#------#--#------#--#------#--#-----
--#----##---#----##---#----##---#----##---#----##---#----##---#----##---#----##---#----##---#----##-
-#---#-#---#---#-#---#---#-#---#---#-#---#---#-#---#---#-#---#---#-#---#---#-#---#---#-#---#---#-#--
--------##--------##--------##--------##--------##--------##--------##--------##--------##--------##
--###---#---###---#---###---#---###---#---###---#---###---#---###---#---###---#---###---#---###---#-
----------------------------------------------------------------------------------------------------
-----#---------#---------#---------#---------#---------#---------#---------#---------#---------#----
#---##----#---##----#---##----#---##----#---##----#---##----#---##----#---##----#---##----#---##----
-#---#-----#---#-----#---#-----#---#-----#---#-----#---#-----#---#-----#---#-----#---#-----#---#----
#--#--#--##--#--#--##--#--#--##--#--#--##--#--#--##--#--#--##--#--#--##--#--#--##--#--#--##--#--#--#
-#--#------#--#------#--#------#--#------#--#------#--#------#--#------#--#------#--#------#--#-----
--#----##---#----##---#----##---#----##---#----##---#----##---#----##---#-S--##---#----##---#----##-
-#---#-#---#---#-#---#---#-#---#---#-#---#---#-#---#---#-#---#---#-#---#---#-#---#---#-#---#---#-#--
--------##--------##--------##--------##--------##--------##--------##--------##--------##--------##
--###---#---###---#---###---#---###---#---###---#---###---#---###---#---###---#---###---#---###---#-
----------------------------------------------------------------------------------------------------
-----#---------#---------#---------#---------#---------#---------#---------#---------#---------#----
#---##----#---##----#---##----#---##----#---##----#---##----#---##----#---##----#---##----#---##----
-#---#-----#---#-----#---#-----#---#-----#---#-----#---#-----#---#-----#---#-----#---#-----#---#----
#--#--#--##--#--#--##--#--#--##--#--#--##--#--#--##--#--#--##--#--#--##--#--#--##--#--#--##--#--#--#
-#--#------#--#------#--#------#--#------#--#------#--#------#--#------#--#------#--#------#--#-----
--#----##---#----##---#----##---#----##---#----##---#----##---#----##---#----##---#----##---#----##-
-#---#-#---#---#-#---#---#-#---#---#-#---#---#-#---#---#-#---#---#-#---#---#-#---#---#-#---#---#-#--
--------##--------##--------##--------##--------##--------##--------##--------##--------##--------##
--###---#---###---#---###---#---###---#---###---#---###---#---###---#---###---#---###---#---###---#-
----------------------------------------------------------------------------------------------------
-----#---------#---------#---------#---------#---------#---------#---------#---------#---------#----
#---##----#---##----#---##----#---##----#---##----#---##----#---##----#---##----#---##----#---##----
-#---#-----#---#-----#---#-----#---#-----#---#-----#---#-----#---#-----#---#-----#---#-----#---#----
#--#--#--##--#--#--##--#--#--##--#--#--##--#--#--##--#--#--##--#--#--##--#--#--##--#--#--##--#--#--#
-#--#------#--#------#--#------#--#------#--#------#--#------#--#------#--#------#--#------#--#-----
--#----##---#----##---#----##---#----##---#----##---#----##---#----##---#----##---#----##---#----##-
-#---#-#---#---#-#---#---#-#---#---#-#---#---#-#---#---#-#---#---#-#---#---#-#---#---#-#---#---#-#--
--------##--------##--------##--------##--------##--------##--------##--------##--------##--------##
