#----#--#-#----#--#-#----#--#-#----#--#-#----#--#-#----#--#-#----#--#-#----#--#-#----#--#-#----#--#-
------##-#------##-#------##-#------##-#------##-#------##-#------##-#------##-#------##-#------##-#
#--#--#-###--#--#-###--#--#-###--#--#-###--#--#-###--#--#-###--#--#-###--#--#-###--#--#-###--#--#-##
---##--------##--------##--------##--------##----S---##--------##--------##--------##--------##-----
-#---------#---------#---------#---------#---------#---------#---------#---------#---------#--------
-#---------#---------#---------#---------#---------#---------#---------#---------#---------#--------
-#--#--#-#-#--#--#-#-#--#--#-#-#--#--#-#-#--#--#-#-#--#--#-#-#--#--#-#-#--#--#-#-#--#--#-#-#--#--#-#
---#-##------#-##------#-##------#-##------#-##------#-##------#-##------#-##------#-##------#-##---
---#-#-------#-#-------#-#-------#-#-------#-#-------#-#-------#-#-------#-#-------#-#-------#-#----
--#---#-##--#---#-##--#---#-##--#---#-##--#---#-##--#---#-##--#---#-##--#---#-##--#---#-##--#---#-##
#----#--#-#----#--#-#----#--#-#----#--#-#----#--#-#----#--#-#----#--#-#----#--#-#----#--#-#----#--#-
------##-#------##-#------##-#------##-#------##-#------##-#------##-#------##-#------##-#------##-#
#--#--#-###--#--#-###--#--#-###--#--#-###--#--#-###--#--#-###--#--#-###--#--#-###--#--#-###--#--#-##
---##--------##--------##--------##--------##--------##--------##--------##--------##--------##-----
-#---------#---------#---------#---------#---------#---------#---------#---------#---------#--------
-#---------#---------#---------#---------#---------#---------#---------#---------#---------#--------
-#--#--#-#-#--#--#-#-#--#--#-#-#--#--#-#-#--#--#-#-#--#--#-#-#--#--#-#-#--#--#-#-#--#--#-#-#--#--#-#
---#-##------#-##------#-##------#-##------#-##------#-##------#-##------#-##------#-##------#-##---
---#-#-------#-#-------#-#-------#-#-------#-#-------#-#-------#-#-------#-#-------#-#-------#-#----
--#---#-##--#---#-##--#---#-##--#---#-##--#---#-##--#---#-##--#---#-##--#---#-##--#---#-##--#---#-##
#----#--#-#----#--#-#----#--#-#----#--#-#----#--#-#----#--#-#----#--#-#----#--#-#----#--#-#----#--#-
------##-#------##-#------##-#------##-#------##-#------##-#------##-#------##-#------##-#------##-#
#--#--#-###--#--#-###--#--#-###--#--#-###--#--#-###--#--#-###--#--#-###--#--#-###--#--#-###--#--#-##
---##--------##--------##--------##--------##--------##--------##--------##--------##--------##-----
-#---------#---------#---------#---------#---------#---------#---------#---------#---------#--------
-#---------#---------#---------#---------#---------#---------#---------#---------#---------#--------
-#--#--#-#-#--#--#-#-#--#--#-#-#--#--#-#-#--#--#-#-#--#--#-#-#--#--#-#-#--#--#-#-#--#--#-#-#--#--#-#
---#-##------#-##------#-##------#-##------#-##------#-##------#-##------#-##------#-##------#-##---
---#-#-------#-#-------#-#-------#-#-------#-#-------#-#-------#-#-------#-#-------#-#-------#-#----
--#---#-##--#---#-##--#---#-##--#---#-##--#---#-##--#---#-##--#---#-##--#---#-##--#---#-##--#---#-##
#----#--#-#----#--#-#----#--#-#----#--#-#----#--#-#----#--#-#----#--#-#----#--#-#----#--#-#----#--#-
------##-#------##-#------##-#------##-#------##-#------##-#------##-#------##-#------##-#------##-#
#--#--#-###--#--#-###--#--#-###--#--#-###--#--#-###--#--#-###--#--#-###--#--#-###--#--#-###--#--#-##
---##--------##--------##--------##--------##--------##--------##--------##--------##--------##-----
-#---------#---------#---------#---------#---------#---------#---------#---------#---------#--------
-#---------#---------#---------#---------#---------#---------#---------#---------#---------#--------
-#--#--#-#-#--#--#-#-#--#--#-#-#--#--#-#-#--#--#-#-#--#--#-#-#--#--#-#-#--#--#-#-#--#--#-#-#--#--#-#
---#-##------#-##------#-##------#-##------#-##------#-##------#-##------#-##------#-##------#-##---
---#-#-------#-#-------#-#-------#-#-------#-#-----E-#-#-------#-#-------#-#-------#-#-------#-#----
--#---#-##--#---#-##--#---#-##--#---#-##--#---#-##--#---#-##--#---#-##--#---#-##--#---#-##--#---#-##
#----#--#-#----#--#-#----#--#-#----#--#-#----#--#-#----#--#-#----#--#-#----#--#-#----#--#-#----#--#-
------##-#------##-#------##-#------##-#------##-#------##-#------##-#------##-#------##-#------##-#
#--#--#-###--#--#-###--#--#-###--#--#-###--#--#-###--#--#-###--#--#-###--#--#-###--#--#-###--#--#-##
---##--------##--------##--------##--------##--------##--------##--------##--------##--------##-----
-#---------#---------#---------#---------#---------#---------#---------#---------#---------#--------
-#---------#---------#---------#---------#---------#---------#---------#---------#---------#--------
-#--#--#-#-#--#--#-#-#--#--#-#-#--#--#-#-#--#--#-#-#--#--#-#-#--#--#-#-#--#--#-#-#--#--#-#-#--#--#-#
---#-##------#-##------#-##------#-##------#-##------#-##------#-##------#-##------#-##------#-##---
---#-#-------#-#-------#-#-------#-#-------#-#-------#-#-------#-#-------#-#-------#-#-------#-#----
--#---#-##--#---#-##--#---#-##--#---#-##--#---#-##--#---#-##--#---#-##--#---#-##--#---#-##--#---#-##
#----#--#-#----#--#-#----#--#-#----#--#-#----#--#-#----#--#-#----#--#-#----#--#-#----#--#-#----#--#-
------##-#------##-#------##-#------##-#------##-#------##-#------##-#------##-#------##-#------##-#
#--#--#-###--#--#-###--#--#-###--#--#-###--#--#-###--#--#-###--#--#-###--#--#-###--#--#-###--#--#-##
---##--------##--------##--------##--------##--------##--------##--------##--------##--------##-----
-#---------#---------#---------#---------#---------#---------#---------#---------#---------#--------
-#---------#---------#---------#---------#---------#---------#---------#---------#---------#--------
-#--#--#-#-#--#--#-#-#--#--#-#-#--#--#-#-#--#--#-#-#--#--#-#-#--#--#-#-#--#--#-#-#--#--#-#-#--#--#-#
---#-##------#-##------#-##------#-##------#-##------#-##------#-##------#-##------#-##------#-##---
---#-#-------#-#-------#-#-------#-#-------#-#-------#-#-------#-#-------#-#-------#-#-------#-#----
--#---#-##--#---#-##--#---#-##--#---#-##--#---#-##--#---#-##--#---#-##--#---#-##--#---#-##--#---#-##
#----#--#-#----#--#-#----#--#-#----#--#-#----#--#-#----#--#-#----#--#-#----#--#-#----#--#-#----#--#-
------##-#------##-#------##-#------##-#------##-#------##-#------##-#------##-#------##-#------##-#
#--#--#-###--#--#-###--#--#-###--#--#-###--#--#-###--#--#-###--#--#-###--#--#-###--#--#-###--#--#-##
---##--------##--------##--------##--------##--------##--------##--------##--------##--------##-----
-#---------#---------#---------#---------#---------#---------#---------#---------#---------#--------
-#---------#---------#---------#---------#---------#---------#---------#---------#---------#--------
-#--#--#-#-#--#--#-#-#--#--#-#-#--#--#-#-#--#--#-#-#--#--#-#-#--#--#-#-#--#--#-#-#--#--#-#-#--#--#-#
---#-##------#-##------#-##------#-##------#-##------#-##------#-##------#-##------#-##------#-##---
---#-#-------#-#-------#-#-------#-#-------#-#-------#-#-------#-#-------#-#-------#-#-------#-#----
--#---#-##--#---#-##--#---#-##--#---#-##--#---#-##--#---#-##--#---#-##--#---#-##--#---#-##--#---#-##
#----#--#-#----#--#-#----#--#-#----#--#-#----#--#-#----#--#-#----#--#-#----#--#-#----#--#-#----#--#-
------##-#------##-#------##-#------##-#------##-#------##-#------##-#------##-#------##-#------##-#
#--#--#-###--#--#-###--#--#-###--#--#-###--#--#-###--#--#-###--#--#-###--#--#-###--#--#-###--#--#-##
---##--------##--------##--------##--------##--------##--------##--------##--------##--------##-----
-#---------#---------#---------#---------#---------#---------#---------#---------#---------#--------
-#---------#---------#---------#---------#---------#---------#---------#---------#---------#--------
-#--#--#-#-#--#--#-#-#--#--#-#-#--#--#-#-#--#--#-#-#--#--#-#-#--#--#-#-#--#--#-#-#--#--#-#-#--#--#-#
---#-##------#-##------#-##------#-##------#-##------#-##------#-##------#-##------#-##------#-##---
---#-#-------#-#-------#-#-------#-#-------#-#-------#-#-------#-#-------#-#-------#-#-------#-#----
--#---#-##--#---#-##--#---#-##--#---#-##--#---#-##--#---#-##--#---#-##--#---#-##--#---#-##--#---#-##
#----#--#-#----#--#-#----#--#-#----#--#-#----#--#-#----#--#-#----#--#-#----#--#-#----#--#-#----#--#-
------##-#------##-#------##-#------##-#------##-#------##-#------##-#------##-#------##-#------##-#
#--#--#-###--#--#-###--#--#-###--#--#-###--#--#-###--#--#-###--#--#-###--#--#-###--#--#-###--#--#-##
---##--------##--------##--------##--------##--------##--------##--------##--------##--------##-----
-#---------#---------#---------#---------#---------#---------#---------#---------#---------#--------
-#---------#---------#---------#---------#---------#---------#---------#---------#---------#--------
-#--#--#-#-#--#--#-#-#--#--#-#-#--#--#-#-#--#--#-#-#--#--#-#-#--#--#-#-#--#--#-#-#--#--#-#-#--#--#-#
---#-##------#-##------#-##------#-##------#-##------#-##------#-##------#-##------#-##------#-##---
---#-#-------#-#-------#-#-------#-#-------#-#-------#-#-------#-#-------#-#-------#-#-------#-#----
--#---#-##--#---#-##--#---#-##--#---#-##--#---#-##--#---#-##--#---#-##--#---#-##--#---#-##--#---#-##
#----#--#-#----#--#-#----#--#-#----#--#-#----#--#-#----#--#-#----#--#-#----#--#-#----#--#-#----#--#-
------##-#------##-#------##-#------##-#------##-#------##-#------##-#------##-#------##-#------##-#
#--#--#-###--#--#-###--#--#-###--#--#-###--#--#-###--#--#-###--#--#-###--#--#-###--#--#-###--#--#-##
---##--------##--------##--------##--------##--------##--------##--------##--------##--------##-----
-#---------#---------#---------#---------#---------#---------#---------#---------#---------#--------
-#---------#---------#---------#---------#---------#---------#---------#---------#---------#--------
-#--#--#-#-#--#--#-#-#--#--#-#-#--#--#-#-#--#--#-#-#--#--#-#-#--#--#-#-#--#--#-#-#--#--#-#-#--#--#-#
---#-##------#-##------#-##------#-##------#-##------#-##------#-##------#-##------#-##------#-##---
---#-#-------#-#-------#-#-------#-#-------#-#-------#-#-------#-#-------#-#-------#-#-------#-#----
--#---#-##--#---#-##--#---#-##--#---#-##--#---#-##--#---#-##--#---#-##--#---#-##--#---#-##--#---#-##
