--##----#---##----#---##----#---##----#---##----#---##----#---##----#---##----#---##----#---##----#-
--###---#---###---#---###---#---###---#---###---#---###---#---###---#---###---#---###---#---###---#-
----------------------------------------------------------------------------------------------------
##--#--#-###--#--#-###--#--#-###--#--#-###--#--#-###--#--#-###--#--#-###--#--#-###--#--#-###--#--#-#
-----#---#-----#---#-----#---#-----#---#-----#---#-----#---#-----#---#-----#---#-----#---#-----#---#
---##--------##--------##--------##--------##--------##--------##--------##--------##--------##-----
-----#---------#---------#---------#---------#---------#---------#---------#---------#---------#----
-#--##-----#--##-----#--##-----#--##-----#--##-----#--##-----#--##-----#--##-----#--##-----#--##----
-#-##----#-#-##----#-#-##----#-#-##----#-#-##----#-#-##----#-#-##----#-#-##----#-#-##----#-#-##----#
--#---#-----#---#-----#---#-----#---#-----#---#-----#---#-----#---#-----#---#-----#---#-----#---#---
--##----#---##----#---##----#---##----#---##----#---##----#---##----#---##----#---##----#---##----#-
--###---#---###---#---###---#---###---#---###---#---###---#---###---#---###---#---###---#---###---#-
----------------------------------------------------------------------------------------------------
##--#--#-###--#--#-###--#--#-###--#--#-###--#--#-###--#--#-###--#--#-###--#--#-###--#--#-###--#--#-#
-----#---#-----#---#-----#---#-----#---#-----#---#-----#---#-----#---#-----#---#-----#---#-----#---#
---##--------##--------##--------##--------##--------##--------##--------##--------##--------##-----
-----#---------#---------#---------#---------#---------#---------#---------#---------#---------#----
-#--##-----#--##-----#--##-----#--##-----#--##-----#--##-----#--##-----#--##-----#--##-----#--##----
-#-##----#-#-##----#-#-##----#-#-##----#-#-##----#-#-##----#-#-##----#-#-##----#-#-##----#-#-##----#
--#---#-----#---#-----#---#-----#---#-----#---#-----#---#-----#---#-----#---#-----#---#-----#---#---
--##----#---##----#---##----#---##----#---##----#---##----#---##----#---##----#---##----#---##----#-
--###---#---###---#---###---#---###---#---###---#---###---#---###---#---###---#---###---#---###---#-
----------------------------------------------------------------------------------------------------
##--#--#-###--#--#-###--#--#-###--#--#-###--#--#-###--#--#-###--#--#-###--#--#-###--#--#-###--#--#-#
-----#---#-----#---#-----#---#-----#---#-----#---#-----#---#-----#---#-----#---#-----#---#-----#---#
---##--------##--------##--------##--------##--------##--------##--------##--------##--------##-----
-----#---------#---------#---------#---------#---------#---------#---------#---------#---------#----
-#--##-----#--##-----#--##-----#--##-----#--##-----#--##-----#--##-----#--##-----#--##-----#--##----
-#-##----#-#-##----#-#-##----#-#-##----#-#-##----#-#-##----#-#-##----#-#-##----#-#-##----#-#-##----#
--#---#-----#---#-----#---#-----#---#-----#---#-----#---#-----#---#-----#---#-----#---#-----#---#---
--##----#---##----#---##----#---##----#---##----#---##----#---##----#---##----#---##----#---##----#-
--###---#---###---#---###---#---###---#---###---#---###---#---###---#---###---#---###---#---###---#-
----------------------------------------------------------------------------------------------------
##--#--#-###--#--#-###--#--#-###--#--#-###--#--#-###--#--#-###--#--#-###--#--#-###--#--#-###--#--#-#
-----#---#-----#---#-----#---#-----#---#-----#---#-----#---#-----#---#-----#---#-----#---#-----#---#
---##--------##--------##--------##--------##--------##--------##--------##--------##--------##-----
-----#---------#---------#---------#---------#---------#---------#---------#---------#---------#----
-#--##-----#--##-----#--##-----#--##-----#--##-----#--##-----#--##-----#--##-----#--##-----#--##----
-#-##----#-#-##----#-#-##----#-#-##----#-#-##----#-#-##----#-#-##----#-#-##----#-#-##----#-#-##----#
--#---#-----#---#-----#---#-----#---#-----#---#-----#---#-----#---#-----#---#-----#---#-----#---#---
--##----#---##----#---##----#---##----#---##----#---##----#---##----#---##----#---##----#---##----#-
--###---#---###---#---###---#---###---#---###---#---###---#---###---#---###---#---###---#---###---#-
----------------------------------------------------------------------------------------------------
##--#--#-###--#--#-###--#--#-###--#--#-###--#--#-###--#--#-###--#--#-###--#--#-###--#--#-###--#--#-#
-----#---#-----#---#-----#---#-----#---#-----#---#-----#---#-----#---#-----#---#-----#---#-----#---#
---##--------##--------##--------##--------##--------##--------##--------##--------##--------##-----
-----#---------#---------#---------#---------#---------#---------#---------#---------#---------#----
-#--##-----#--##-----#--##-----#--##-----#--##-----#--##-----#--##-----#--##-----#--##-----#--##----
-#-##----#-#-##----#-#-##----#-#-##----#-#-##----#-#-##----#-#-##----#-#-##----#-#-##----#-#-##----#
--#---#-----#---#-----#---#-----#---#-----#---#-----#---#-----#---#-----#---#-----#---#-----#---#---
--##----#---##----#---##----#---##----#---##----#---##----#---##----#---##----#---##----#---##----#-
--###---#---###---#---###---#---###---#---###---#---###---#---###---#---###---#---###---#---###---#-
----------------------------------------------------------------------------------------------------
##--#--#-###--#--#-###--#--#-###--#--#-###--#--#-###--#--#-###--#--#-###--#--#-###--#--#-###--#--#-#
-----#---#-----#---#-----#---#-----#---#-----#---#-----#---#-----#---#-----#---#-----#---#-----#---#
---##--------##--------##--------##--------##--------##--------##--------##--------##--------##-----
-----#---------#---------#---------#---------#---------#---------#---------#---------#---------#----
-#--##-----#--##-----#--##-----#--##-----#--##-----#--##-----#--##-----#--##-----#--##-----#--##----
-#-##----#-#-##----#-#-##----#-#-##----#-#-##----#-#-##----#-#-##----#-#-##----#-#-##----#-#-##----#
--#---#-----#---#-----#---#-----#---#-----#---#-----#---#-----#---#-----#---#-----#---#-----#---#---
--##----#---##----#---##----#---##----#---##----#---##----#---##----#---##----#---##----#---##----#-
--###---#---###---#---###---#---###---#---###---#---###---#---###---#---###---#---###---#---###---#-
----------------------------------------------------------------------------------------------------
##--#--#-###--#--#-###--#--#-###--#--#-###--#--#-###--#--#-###--#--#-###--#--#-###--#--#-###--#--#-#
-----#---#-----#---#-----#---#-----#---#-----#---#-----#---#-----#---#-----#---#-----#---#-----#---#
---##--------##--------##--------##--------##--------##--------##--------##--------##--------##-----
-----#---------#---------#---------#---------#---------#---------#---------#---------#---------#----
-#--##-----#--##-----#--##-----#--##-----#--##-----#--##-----#--##-----#--##-----#--##-----#--##----
-#-##----#-#-##----#-#-##----#-#-##----#-#-##----#-#-##----#-#-##----#-#-##----#-#-##----#-#-##----#
--#---#-----#---#-----#---#-----#---#-----#---#-----#---#-----#---#-----#---#-----#---#-----#---#---
--##----#---##----#---##----#---##----#---##----#---##----#---##----#---##----#---##----#---##----#-
--###---#---###---#---###---#---###---#---###---#---###---#---###---#---###---#---###---#---###---#-
----------------------------------------------------------------------------------------------------
##--#--#-###--#--#-###--#--#-###--#--#-###--#--#-###--#--#-###--#--#-###--#--#-###--#--#-###--#--#-#
-----#---#-----#---#-----#---#-----#---#-----#---#-----#---#-----#---#-----#---#-----#---#-----#---#
---##--------##--------##--------##--------##--------##--------##--------##--------##--------##-----
-----#---------#---------#---------#---------#---------#---------#---------#---------#---------#----
-#--##-----#--##-----#--##-----#--##-----#--##-----#--##-----#--##-----#--##-----#--##-----#--##----
-#-##----#-#-##----#-#-##----#-#-##----#-#-##----#-#-##----#-#-##----#-#-##----#-#-##----#-#-##----#
--#---#-----#---#-----#---#-----#---#-----#---#-----#---#-----#---#-----#---#-----#---#-----#---#---
--##----#---##----#---##----#---##----#---##----#---##----#---##----#---##----#---##----#---##----#-
--###---#---###---#---###---#---###---#---###---#---###---#---###---#---###---#---###---#---###---#-
----------------------------------------------------------------------------------------------------
##--#--#-###--#--#-###--#--#-###--#--#-###--#--#-###--#--#-###--#--#-###--#--#-###--#--#-###--#--#-#
-----#---#-----#---#-----#---#-----#---#-----#---#-----#---#-----#---#-----#---#-----#---#-----#---#
---##--------##--------##--------##--------##--------##----S---##--------##--------##--------##-----
-----#---------#---------#---------#---------#---------#---------#---------#---------#---------#----
-#--##-----#--##-----#--##-----#--##-----#--##-----#--##-----#--##-----#--##-----#--##-----#--##----
-#-##----#-#-##----#-#-##----#-#-##----#-#-##----#-#-##----#-#-##----#-#-##----#-#-##----#-#-##----#
--#---#-----#---#-----#---#-----#---#-----#---#-----#---#-----#---#-----#---#-----#---#-----#---#---
--##----#---##----#---##----#---##----#---##----#---##----#---##----#---##----#---##----#---##----#-
--###---#---###---#---###---#---###---#---###---#---###---#---###---#---###---#---###---#---###---#-
-----------------------------------------------------------------------------------E----------------
##--#--#-###--#--#-###--#--#-###--#--#-###--#--#-###--#--#-###--#--#-###--#--#-###--#--#-###--#--#-#
-----#---#-----#---#-----#---#-----#---#-----#---#-----#---#-----#---#-----#---#-----#---#-----#---#
---##--------##--------##--------##--------##--------##--------##--------##--------##--------##-----
-----#---------#---------#---------#---------#---------#---------#---------#---------#---------#----
-#--##-----#--##-----#--##-----#--##-----#--##-----#--##-----#--##-----#--##-----#--##-----#--##----
-#-##----#-#-##----#-#-##----#-#-##----#-#-##----#-#-##----#-#-##----#-#-##----#-#-##----#-#-##----#
--#---#-----#---#-----#---#-----#---#-----#---#-----#---#-----#---#-----#---#-----#---#-----#---#---
