#---#-##--#---#-##--#---#-##--#---#-##--#---#-##--#---#-##--#---#-##--#---#-##--#---#-##--#---#-##--
---------#---------#---------#---------#---------#---------#---------#---------#---------#---------#
------#---------#---------#---------#---------#---------#---------#---------#---------#---------#---
-#-----#---#-----#---#-----#---#-----#---#-----#---#-----#---#-----#---#-----#---#-----#---#-----#--
----#-#-------#-#-------#-#-------#-#-------#-#-------#-#-------#-#-------#-#-------#-#-------#-#---
#------####------####------####------####------####------####------####------####------####------###
--##-----#--##-----#--##-----#--##-----#--##-----#--##-----#--##-----#--##-----#--##-----#--##-----#
##-#--##-###-#--##-###-#--##-###-#--##-###-#-S##-###-#--##-###-#--##-###-#--##-###-#--##-###-#--##-#
-------##--------##--------##--------##--------##--------##--------##--------##--------##--------##-
---#--#-##---#--#-##---#--#-##---#--#-##---#--#-##---#--#-##---#--#-##---#--#-##---#--#-##---#--#-##
#---#-##--#---#-##--#---#-##--#---#-##--#---#-##--#---#-##--#---#-##--#---#-##--#---#-##--#---#-##--
---------#---------#---------#---------#---------#---------#---------#---------#---------#---------#
------#---------#---------#---------#---------#---------#---------#---------#---------#---------#---
-#-----#---#-----#---#-----#---#-----#---#-----#---#-----#---#-----#---#-----#---#-----#---#-----#--
----#-#-------#-#-------#-#-------#-#-------#-#-------#-#-------#-#-------#-#-------#-#-------#-#---
#------####------####------####------####------####------####------####------####------####------###
--##-----#--##-----#--##-----#--##-----#--##-----#--##-----#--##-----#--##-----#--##-----#--##-----#
##-#--##-###-#--##-###-#--##-###-#--##-###-#--##-###-#--##-###-#--##-###-#--##-###-#--##-###-#--##-#
-------##--------##--------##--------##--------##--------##--------##--------##--------##--------##-
---#--#-##---#--#-##---#--#-##---#--#-##---#--#-##---#--#-##---#--#-##---#--#-##---#--#-##---#--#-##
#---#-##--#---#-##--#---#-##--#---#-##--#---#-##--#---#-##--#---#-##--#---#-##--#---#-##--#---#-##--
---------#---------#---------#---------#---------#---------#---------#---------#---------#---------#
------#---------#---------#---------#---------#---------#---------#---------#---------#---------#---
-#-----#---#-----#---#-----#---#-----#---#-----#---#-----#---#-----#---#-----#---#-----#---#-----#--
----#-#-------#-#-------#-#-------#-#-------#-#-------#-#-------#-#-------#-#-------#-#-------#-#---
#------####------####------####------####------####------####------####------####------####------###
--##-----#--##-----#--##-----#--##-----#--##-----#--##-----#--##-----#--##-----#--##-----#--##-----#
##-#--##-###-#--##-###-#--##-###-#--##-###-#--##-###-#--##-###-#--##-###-#--##-###-#--##-###-#--##-#
-------##--------##--------##--------##--------##--------##--------##--------##--------##--------##-
---#--#-##---#--#-##---#--#-##---#--#-##---#--#-##---#--#-##---#--#-##---#--#-##---#--#-##---#--#-##
#---#-##--#---#-##--#---#-##--#---#-##--#---#-##--#---#-##--#---#-##--#---#-##--#---#-##--#---#-##--
---------#---------#---------#---------#---------#---------#---------#---------#---------#---------#
------#---------#---------#---------#---------#---------#---------#---------#---------#---------#---
-#-----#---#-----#---#-----#---#-----#---#-----#---#-----#---#-----#---#-----#---#-----#---#-----#--
----#-#-------#-#-------#-#-------#-#-------#-#-------#-#-------#-#-------#-#-------#-#-------#-#---
#------####------####------####------####------####------####------####------####------####------###
--##-----#--##-----#--##-----#--##-----#--##-----#--##-----#--##-----#--##-----#--##-----#--##-----#
##-#--##-###-#--##-###-#--##-###-#--##-###-#--##-###-#--##-###-#--##-###-#--##-###-#--##-###-#--##-#
-------##--------##--------##--------##--------##--------##--------##--------##--------##--------##-
---#--#-##---#--#-##---#--#-##---#--#-##---#--#-##---#--#-##---#--#-##---#--#-##---#--#-##---#--#-##
#---#-##--#---#-##--#---#-##--#---#-##--#---#-##--#---#-##--#---#-##--#---#-##--#---#-##--#---#-##--
---------#---------#---------#---------#---------#---------#---------#---------#---------#---------#
------#---------#---------#---------#---------#---------#---------#---------#---------#---------#---
-#-----#---#-----#---#-----#---#-----#---#-----#---#-----#---#-----#---#-----#---#-----#---#-----#--
----#-#-------#-#-------#-#-------#-#-------#-#-------#-#-------#-#-------#-#-------#-#-------#-#---
#------####------####------####------####------####------####------####------####------####------###
--##-----#--##-----#--##-----#--##-----#--##-----#--##-----#--##-----#--##-----#--##-----#--##-----#
##-#--##-###-#--##-###-#--##-###-#--##-###-#--##-###-#--##-###-#--##-###-#--##-###-#--##-###-#--##-#
-------##--------##--------##--------##--------##--------##--------##--------##--------##--------##-
---#--#-##---#--#-##---#--#-##---#--#-##---#--#-##---#--#-##---#--#-##---#--#-##---#--#-##---#--#-##
#---#-##--#---#-##--#---#-##--#---#-##--#---#-##--#---#-##--#---#-##--#---#-##--#---#-##--#---#-##--
---------#---------#---------#---------#---------#---------#---------#---------#---------#---------#
------#---------#---------#---------#---------#---------#---------#---------#---------#---------#---
-#-----#---#-----#---#-----#---#-----#---#-----#---#-----#---#-----#---#-----#---#-----#---#-----#--
----#-#-------#-#-------#-#-------#-#-------#-#-------#-#-------#-#-------#-#-------#-#-------#-#---
#------####------####------####------####------####------####------####------####------####------###
--##-----#--##-----#--##-----#--##-----#--##-----#--##-----#--##-----#--##-----#--##-----#--##-----#
##-#--##-###-#--##-###-#--##-###-#--##-###-#--##-###-#--##-###-#--##-###-#--##-###-#--##-###-#--##-#
-------##--------##--------##--------##--------##--------##--------##--------##--------##--------##-
---#--#-##---#--#-##---#--#-##---#--#-##---#--#-##---#--#-##---#--#-##---#--#-##---#--#-##---#--#-##
#---#-##--#---#-##--#---#-##--#---#-##--#---#-##--#---#-##--#---#-##--#---#-##--#---#-##--#---#-##--
---------#---------#---------#---------#---------#---------#---------#---------#---------#---------#
------#---------#---------#---------#---------#---------#---------#---------#---------#---------#---
-#-----#---#-----#---#-----#---#-----#---#-----#---#-----#---#-----#---#-----#---#-----#---#-----#--
----#-#-------#-#-------#-#-------#-#-------#-#-------#-#-------#-#-------#-#-------#-#-------#-#---
#------####------####------####------####------####------####------####------####------####------###
--##-----#--##-----#--##-----#--##-----#--##-----#--##-----#--##-----#--##-----#--##-----#--##-----#
##-#--##-###-#--##-###-#--##-###-#--##-###-#--##-###-#--##-###-#--##-###-#--##-###-#--##-###-#--##-#
-------##--------##--------##--------##--------##--------##--------##--------##--------##--------##-
---#--#-##---#--#-##---#--#-##---#--#-##---#--#-##---#--#-##---#--#-##---#--#-##---#--#-##---#--#-##
#---#-##--#---#-##--#---#-##--#---#-##--#---#-##--#---#-##--#---#-##--#---#-##--#---#-##--#---#-##--
---------#---------#---------#---------#---------#---------#---------#---------#---------#---------#
------#---------#---------#---------#---------#---------#---------#---------#---------#---------#---
-#-----#---#-----#---#-----#---#-----#---#-----#---#-----#---#-----#---#-----#---#-----#---#-----#--
----#-#-------#-#-------#-#-------#-#-------#-#-------#-#-------#-#-------#-#-------#-#-------#-#---
#------####------####------####------####------####------####------####------####------####------###
--##-----#--##-----#--##-----#--##-----#--##-----#--##-----#--##-----#--##-----#--##-----#--##-----#
##-#--##-###-#--##-###-#--##-###-#--##-###-#--##-###-#--##-###-#--##-###-#--##-###-#--##-###-#--##-#
-------##--------##--------##--------##--------##--------##--------##-----E--##--------##--------##-
---#--#-##---#--#-##---#--#-##---#--#-##---#--#-##---#--#-##---#--#-##---#--#-##---#--#-##---#--#-##
#---#-##--#---#-##--#---#-##--#---#-##--#---#-##--#---#-##--#---#-##--#---#-##--#---#-##--#---#-##--
---------#---------#---------#---------#---------#---------#---------#---------#---------#---------#
------#---------#---------#---------#---------#---------#---------#---------#---------#---------#---
-#-----#---#-----#---#-----#---#-----#---#-----#---#-----#---#-----#---#-----#---#-----#---#-----#--
----#-#-------#-#-------#-#-------#-#-------#-#-------#-#-------#-#-------#-#-------#-#-------#-#---
#------####------####------####------####------####------####------####------####------####------###
--##-----#--##-----#--##-----#--##-----#--##-----#--##-----#--##-----#--##-----#--##-----#--##-----#
##-#--##-###-#--##-###-#--##-###-#--##-###-#--##-###-#--##-###-#--##-###-#--##-###-#--##-###-#--##-#
-------##--------##--------##--------##--------##--------##--------##--------##--------##--------##-
---#--#-##---#--#-##---#--#-##---#--#-##---#--#-##---#--#-##---#--#-##---#--#-##---#--#-##---#--#-##
#---#-##--#---#-##--#---#-##--#---#-##--#---#-##--#---#-##--#---#-##--#---#-##--#---#-##--#---#-##--
---------#---------#---------#---------#---------#---------#---------#---------#---------#---------#
------#---------#---------#---------#---------#---------#---------#---------#---------#---------#---
-#-----#---#-----#---#-----#---#-----#---#-----#---#-----#---#-----#---#-----#---#-----#---#-----#--
----#-#-------#-#-------#-#-------#-#-------#-#-------#-#-------#-#-------#-#-------#-#-------#-#---
#------####------####------####------####------####------####------####------####------####------###
--##-----#--##-----#--##-----#--##-----#--##-----#--##-----#--##-----#--##-----#--##-----#--##-----#
##-#--##-###-#--##-###-#--##-###-#--##-###-#--##-###-#--##-###-#--##-###-#--##-###-#--##-###-#--##-#
-------##--------##--------##--------##--------##--------##--------##--------##--------##--------##-
---#--#-##---#--#-##---#--#-##---#--#-##---#--#-##---#--#-##---#--#-##---#--#-##---#--#-##---#--#-##
