----------------------------------------------------------------------------------------------------
---#-#---#---#-#---#---#-#---#---#-#---#---#-#---#---#-#---#---#-#---#---#-#---#---#-#---#---#-#---#
-#-------#-#-------#-#-------#-#-------#-#-------#-#-------#-#-------#-#-------#-#-------#-#-------#
---#----#----#----#----#----#----#----#----#----#----#----#----#----#----#----#----#----#----#----#-
----#----#----#----#----#----#----#----#----#----#----#----#----#----#----#----#----#----#----#----#
----#-#-------#-#-------#-#-------#-#-------#-#-------#-#-------#-#-------#-#-------#-#-------#-#---
#-------#-#-------#-#-------#-#-------#-#-------#-#-------#-#-------#-#-------#-#-------#-#-------#-
#----#---##----#---##----#---##----#---##----#---##----#---##----#---##----#---##----#---##----#---#
-#----#----#----#----#----#----#----#----#----#----#----#----#----#----#----#----#----#----#----#---
--#-#-#--#--#-#-#--#--#-#-#--#--#-#-#--#--#-#-#--#--#-#-#--#--#-#-#--#--#-#-#--#--#-#-#--#--#-#-#--#
----------------------------------------------------------------------------------------------------
---#-#---#---#-#---#---#-#---#---#-#---#---#-#---#---#-#---#---#-#---#---#-#---#---#-#---#---#-#---#
-#-------#-#-------#-#-------#-#-------#-#-------#-#-------#-#-------#-#-------#-#-------#-#-------#
---#----#----#----#----#----#----#----#----#----#----#----#----#----#----#----#----#----#----#----#-
----#----#----#----#----#----#----#----#----#----#----#----#----#----#----#----#----#----#----#----#
----#-#-------#-#-------#-#-------#-#-------#-#-------#-#-------#-#-------#-#-------#-#-------#-#---
#-------#-#-------#-#-------#-#-------#-#-------#-#-------#-#-------#-#-------#-#-------#-#-------#-
#----#---##----#---##----#---##----#---##----#---##----#---##----#---##----#---##----#---##----#---#
-#----#----#----#----#----#----#----#----#----#----#----#----#----#----#----#----#----#----#----#---
--#-#-#--#--#-#-#--#--#-#-#--#--#-#-#--#--#-#-#--#--#-#-#--#--#-#-#--#--#-#-#--#--#-#-#--#--#-#-#--#
----------------------------------------------------------------------------------------------------
---#-#---#---#-#---#---#-#---#---#-#---#---#-#---#---#-#---#---#-#---#---#-#---#---#-#---#---#-#---#
-#-------#-#-------#-#-------#-#-------#-#-------#-#-------#-#-------#-#-------#-#-------#-#-------#
---#----#----#----#----#----#----#----#----#----#----#----#----#----#----#----#----#----#----#----#-
----#----#----#----#----#----#----#----#----#----#----#----#----#----#----#----#----#----#----#----#
----#-#-------#-#-------#-#-------#-#-------#-#-------#-#---E---#-#-------#-#-------#-#-------#-#---
#-------#-#-------#-#-------#-#-------#-#-------#-#-------#-#-------#-#-------#-#-------#-#-------#-
#----#---##----#---##----#---##----#---##----#---##----#---##----#---##----#---##----#---##----#---#
-#----#----#----#----#----#----#----#----#----#----#----#----#----#----#----#----#----#----#----#---
--#-#-#--#--#-#-#--#--#-#-#--#--#-#-#--#--#-#-#--#--#-#-#--#--#-#-#--#--#-#-#--#--#-#-#--#--#-#-#--#
----------------------------------------------------------------------------------------------------
---#-#---#---#-#---#---#-#---#---#-#---#---#-#---#---#-#---#---#-#---#---#-#---#---#-#---#---#-#---#
-#-------#-#-------#-#-------#-#-------#-#-------#-#-------#-#-------#-#-------#-#-------#-#-------#
---#----#----#----#----#----#----#----#----#----#----#----#----#----#----#----#----#----#----#----#-
----#----#----#----#----#----#----#----#----#----#----#----#----#----#----#----#----#----#----#----#
----#-#-------#-#-------#-#-------#-#-------#-#-------#-#-------#-#-------#-#-------#-#-------#-#---
#-------#-#-------#-#-------#-#-------#-#-------#-#-------#-#-------#-#-------#-#-------#-#-------#-
#----#---##----#---##----#---##----#---##----#---##----#---##----#---##----#---##----#---##----#---#
-#----#----#----#----#----#----#----#----#----#----#----#----#----#----#----#----#----#----#----#---
--#-#-#--#--#-#-#--#--#-#-#--#--#-#-#--#--#-#-#--#--#-#-#--#--#-#-#--#--#-#-#--#--#-#-#--#--#-#-#--#
----------------------------------------------------------------------------------------------------
---#-#---#---#-#---#---#-#---#---#-#---#---#-#---#---#-#---#---#-#---#---#-#---#---#-#---#---#-#---#
-#-------#-#-------#-#-------#-#-------#-#-------#-#-------#-#-------#-#-------#-#-------#-#-------#
---#----#----#----#----#----#----#----#----#----#----#----#----#----#----#----#----#----#----#----#-
----#----#----#----#----#----#----#----#----#----#----#----#----#----#----#----#----#----#----#----#
----#-#-------#-#-------#-#-------#-#-------#-#-------#-#-------#-#-------#-#-------#-#-------#-#---
#-------#-#-------#-#-------#-#-------#-#-------#-#-------#-#-------#-#-------#-#-------#-#-------#-
#----#---##----#---##----#---##----#---##----#---##----#---##----#---##----#---##----#---##----#---#
-#----#----#----#----#----#----#----#----#----#----#----#----#----#----#----#----#----#----#----#---
--#-#-#--#--#-#-#--#--#-#-#--#--#-#-#--#--#-#-#--#--#-#-#--#--#-#-#--#--#-#-#--#--#-#-#--#--#-#-#--#
----------------------------------------------------------------------------------------------------
---#-#---#---#-#---#---#-#---#---#-#---#---#-#---#---#-#---#---#-#---#---#-#---#---#-#---#---#-#---#
-#-------#-#-------#-#-------#-#-------#-#-------#-#-------#-#-------#-#-------#-#-------#-#-------#
---#----#----#----#----#----#----#----#----#----#----#----#----#----#----#----#----#----#----#----#-
----#----#----#----#----#----#----#----#----#----#----#----#----#----#----#----#----#----#----#----#
----#-#-------#-#-------#-#-------#-#-------#-#-------#-#-------#-#-------#-#-------#-#-------#-#---
#-------#-#-------#-#-------#-#-------#-#-------#-#-------#-#-------#-#-------#-#-------#-#-------#-
#----#---##----#---##----#---##----#---##----#---##----#---##----#---##----#---##----#---##----#---#
-#----#----#----#----#----#----#----#----#----#----#----#----#----#----#----#----#----#----#----#---
--#-#-#--#--#-#-#--#--#-#-#--#--#-#-#--#--#-#-#--#--#-#-#--#--#-#-#--#--#-#-#--#--#-#-#--#--#-#-#--#
----------------------------------------------------------------------------------------------------
---#-#---#---#-#---#---#-#---#---#-#---#---#-#---#---#-#---#---#-#---#---#-#---#---#-#---#---#-#---#
-#-------#-#-------#-#-------#-#-------#-#-------#-#-------#-#-------#-#-------#-#-------#-#-------#
---#----#----#----#----#----#----#----#----#----#----#----#----#----#----#----#----#----#----#----#-
----#----#----#----#----#----#----#----#----#----#----#----#----#----#----#----#----#----#----#----#
----#-#-------#-#-------#-#-------#-#-------#-#-------#-#-------#-#-------#-#-------#-#-------#-#---
#-------#-#-------#-#-------#-#-------#-#-------#-#-------#-#-------#-#-------#-#-------#-#-------#-
#----#---##----#---##----#---##----#---##----#---##----#---##----#---##----#---##----#---##----#---#
-#----#----#----#----#----#----#----#----#----#----#----#----#----#----#----#----#----#----#----#---
--#-#-#--#--#-#-#--#--#-#-#--#--#-#-#--#--#-#-#--#--#-#-#--#--#-#-#--#--#-#-#--#--#-#-#--#--#-#-#--#
----------------------------------------------------------------------------------------------------
---#-#---#---#-#---#---#-#---#---#-#---#---#-#---#---#-#---#---#-#---#---#-#---#---#-#---#---#-#---#
-#-------#-#-------#-#-------#-#-------#-#-------#-#-------#-#-------#-#-------#-#-------#-#-------#
---#----#----#----#----#----#----#----#----#----#----#----#----#----#----#----#----#----#----#----#-
----#----#----#----#----#----#----#----#----#----#----#----#----#----#----#----#----#----#----#----#
----#-#-------#-#-------#-#-------#-#-------#-#-------#-#-------#-#-------#-#-------#-#-------#-#---
#-------#-#-------#-#-------#-#-------#-#-------#-#-------#-#-------#-#-------#-#-------#-#-------#-
#----#---##----#---##----#---##----#---##----#---##----#---##----#---##----#---##----#---##----#---#
-#----#----#----#----#----#----#----#----#----#----#----#----#----#----#----#----#----#----#----#---
--#-#-#--#--#-#-#--#--#-#-#--#--#-#-#--#--#-#-#--#--#-#-#--#--#-#-#--#--#-#-#--#--#-#-#--#--#-#-#--#
----------------------------------------------------------------------------------------------------
---#-#---#---#-#---#---#-#---#---#-#---#---#-#---#---#-#---#---#-#---#---#-#---#---#-#---#---#-#---#
-#-------#-#-------#-#-------#-#-------#-#-------#-#-------#-#-------#-#-------#-#-------#-#-------#
---#----#----#----#----#----#----#----#----#----#----#----#----#----#----#----#----#----#----#----#-
----#----#----#----#----#----#----#----#----#----#----#----#----#----#----#----#----#----#----#----#
----#-#-------#-#-------#-#-------#-#-------#-#-------#-#-------#-#-------#-#-------#-#-------#-#---
#-------#-#-------#-#-------#-#-------#-#-------#-#-------#-#-------#-#-------#-#-------#-#-------#-
#----#---##----#---##----#---##----#---##----#---##----#---##----#---##----#---##----#---##----#---#
-#----#----#----#----#----#----#----#----#----#----#----#----#----#----#----#----#----#----#----#---
--#-#-#--#--#-#-#--#--#-#-#--#--#-#-#--#--#-#-#--#--#-#-#--#--#-#-#--#--#-#-#--#--#-#-#--#--#-#-#--#
----------------------------------------------------------------------------------------------------
---#-#---#---#-#---#---#-#---#---#-#---#---#-#---#---#-#---#---#-#---#---#-#---#---#-#---#---#-#---#
-#-------#-#-------#-#-------#-#-------#-#-------#-#-------#-#-------#-#-------#-#-------#-#-------#
---#----#----#----#----#----#----#----#----#----#----#----#----#----#----#----#----#----#----#----#-
----#----#----#----#----#----#----#----#----#----#----#----#S---#----#----#----#----#----#----#----#
----#-#-------#-#-------#-#-------#-#-------#-#-------#-#-------#-#-------#-#-------#-#-------#-#---
#-------#-#-------#-#-------#-#-------#-#-------#-#-------#-#-------#-#-------#-#-------#-#-------#-
#----#---##----#---##----#---##----#---##----#---##----#---##----#---##----#---##----#---##----#---#
-#----#----#----#----#----#----#----#----#----#----#----#----#----#----#----#----#----#----#----#---
--#-#-#--#--#-#-#--#--#-#-#--#--#-#-#--#--#-#-#--#--#-#-#--#--#-#-#--#--#-#-#--#--#-#-#--#--#-#-#--#
