--#--#------#--#------#--#------#--#------#--#------#--#------#--#------#--#------#--#------#--#----
#----#----#----#----#----#----#----#----#----#----#----#----#----#----#----#----#----#----#----#----
---##--------##--------##--------##--------##--------##--------##--------##--------##--------##-----
--##---#----##---#----##---#----##---#----##---#----##---#----##---#----##---#----##---#----##---#--
--#-######--#-######--#-######--#-######--#-######--#-######--#-######--#-######--#-######--#-######
--#-#-------#-#-------#-#-------#-#-------#-#-------#-#-------#-#-------#-#-------#-#-------#-#-----
---##-#------##-#------##-#------##-#------##-#------##-#------##-#------##-#------##-#------##-#---
#-#---#---#-#---#---#-#---#---#-#---#---#-#---#---#-#---#---#-#---#---#-#---#---#-#---#---#-#---#---
--#---------#---------#---------#---------#---------#---------#---------#---------#---------#-------
---#-#--#----#-#--#----#-#--#----#-#--#----#-#--#----#-#--#----#-#--#----#-#--#----#-#--#----#-#--#-
--#--#------#--#------#--#------#--#------#--#------#--#------#--#------#--#------#--#------#--#----
#----#----#----#----#----#----#----#----#----#----#----#----#----#----#----#----#----#----#----#----
---##--------##--------##--------##--------##--------##--------##--------##--------##--------##-----
--##---#----##---#----##---#----##---#----##---#----##---#----##---#----##---#----##---#----##---#--
--#-######--#-######--#-######--#-######--#-######--#-######--#-######--#-######--#-######--#-######
--#-#-------#-#-------#-#-------#-#-------#-#-------#-#-------#-#-------#-#-------#-#-------#-#-----
---##-#------##-#------##-#------##-#------##-#------##-#------##-#------##-#------##-#------##-#---
#-#---#---#-#---#---#-#---#---#-#---#---#-#---#---#-#---#---#-#---#---#-#---#---#-#---#---#-#---#---
--#---------#---------#---------#---------#---------#---------#---------#---------#---------#-------
---#-#--#----#-#--#----#-#--#----#-#--#----#-#--#----#-#--#----#-#--#----#-#--#----#-#--#----#-#--#-
--#--#------#--#------#--#------#--#------#--#------#--#------#--#------#--#------#--#------#--#----
#----#----#----#----#----#----#----#----#----#----#----#----#----#----#----#----#----#----#----#----
---##--------##--------##--------##--------##--------##--------##--------##--------##--------##-----
--##---#----##---#----##---#----##---#----##---#----##---#----##---#----##---#----##---#----##---#--
--#-######--#-######--#-######--#-######--#-######--#-######--#-######--#-######--#-######--#-######
--#-#-------#-#-------#-#-------#-#-------#-#-------#-#-------#-#-------#-#-------#-#-------#-#-----
---##-#------##-#------##-#------##-#------##-#------##-#------##-#------##-#------##-#------##-#---
#-#---#---#-#---#---#-#---#---#-#---#---#-#---#---#-#---#---#-#---#---#-#---#---#-#---#---#-#---#---
--#---------#---------#---------#---------#---------#---------#---------#---------#---------#-------
---#-#--#----#-#--#----#-#--#----#-#--#----#-#--#----#-#--#----#-#--#----#-#--#----#-#--#----#-#--#-
--#--#------#--#------#--#------#--#------#--#------#--#------#--#------#--#------#--#------#--#----
#----#----#----#----#----#----#----#----#----#----#----#----#----#----#----#----#----#----#----#----
---##--------##--------##--------##--------##--------##--------##--------##--------##--------##-----
--##---#----##---#----##---#----##---#----##---#----##---#----##---#----##---#----##---#----##---#--
--#-######--#-######--#-######--#-######--#-######--#-######--#-######--#-######--#-######--#-######
--#-#-------#-#-------#-#-------#-#-------#-#-------#-#-------#-#-------#-#-------#-#-------#-#-----
---##-#------##-#------##-#------##-#------##-#------##-#------##-#------##-#------##-#------##-#---
#-#---#---#-#---#---#-#---#---#-#---#---#-#---#---#-#---#---#-#---#---#-#---#---#-#---#---#-#---#---
--#---------#---------#---------#---------#---------#---------#---------#---------#---------#-------
---#-#--#----#-#--#----#-#--#----#-#--#----#-#--#----#-#--#----#-#--#----#-#--#----#-#--#----#-#--#-
--#--#------#--#------#--#------#--#------#--#------#--#------#--#------#--#------#--#------#--#----
#----#----#----#----#----#----#----#----#----#----#----#----#----#----#----#----#----#----#----#----
---##--------##--------##--------##--------##--------##--------##--------##--------##--------##-----
--##---#----##---#----##---#----##---#----##---#----##---#----##---#----##---#----##---#----##---#--
--#-######--#-######--#-######--#-######--#-######--#-######--#-######--#-######--#-######--#-######
--#-#-------#-#-------#-#-------#-#-------#-#-------#-#-------#-#-------#-#-------#-#-------#-#-----
---##-#------##-#------##-#------##-#------##-#------##-#------##-#------##-#------##-#------##-#---
#-#---#---#-#---#---#-#---#---#-#---#---#-#---#---#-#---#---#-#---#---#-#---#---#-#---#---#-#---#---
--#---------#---------#---------#---------#---------#---------#---------#---------#---------#-------
---#-#--#----#-#--#----#-#--#----#-#--#----#-#--#----#-#--#----#-#--#----#-#--#----#-#--#----#-#--#-
--#--#------#--#------#--#------#--#------#--#------#--#------#--#------#--#------#--#------#--#----
#----#----#----#----#----#----#----#----#----#----#----#----#----#----#----#----#----#----#----#----
---##--------##--------##--------##--------##--------##--------##--------##--------##--------##-----
--##---#----##---#----##---#----##---#----##---#----##---#----##---#----##---#----##---#----##---#--
--#-######--#-######--#-######--#-######--#-######--#-######--#-######--#-######--#-######--#-######
--#-#-------#-#-------#-#-------#-#-------#-#-------#-#-------#-#-------#-#-------#-#-------#-#-----
---##-#------##-#------##-#------##-#------##-#------##-#------##-#------##-#------##-#------##-#---
#-#---#---#-#---#---#-#---#---#-#---#---#-#---#---#-#---#---#-#---#---#-#---#---#-#---#---#-#---#---
--#---------#---------#---------#---------#---------#---------#---------#---------#---------#-------
---#-#--#----#-#--#----#-#--#----#-#--#----#-#--#----#-#--#----#-#--#----#-#--#----#-#--#----#-#--#-
--#--#------#--#------#--#------#--#------#--#------#--#------#--#------#--#------#--#------#--#----
#----#----#----#----#----#----#----#----#----#----#----#----#----#----#----#----#----#----#----#----
---##--------##--------##--------##--------##--------##--------##--------##--------##--------##-----
--##---#----##---#----##---#----##---#----##---#----##---#----##---#----##---#----##---#----##---#--
--#-######--#-######--#-######--#-######--#-######--#-######--#-######--#-######--#-######--#-######
--#-#-------#-#-------#-#-------#-#-------#-#-------#-#-------#-#-------#-#-------#-#-------#-#-----
---##-#------##-#------##-#------##-#------##-#------##-#------##-#------##-#------##-#------##-#---
#-#---#---#-#---#---#-#---#---#-#---#---#-#---#---#-#---#---#-#---#---#-#---#---#-#---#---#-#---#---
--#---------#---------#---------#---------#---------#---------#---------#---------#---------#-------
---#-#--#----#-#--#----#-#--#----#-#--#----#-#--#----#-#--#----#-#--#----#-#--#----#-#--#----#-#--#-
--#--#------#--#------#--#------#--#------#--#------#--#------#--#------#--#------#--#------#--#----
#----#----#----#----#----#----#----#----#----#----#----#----#----#----#----#----#----#----#----#----
---##--------##--------##--------##--------##--------##--------##--------##--------##--------##-----
--##---#----##---#----##---#----##---#----##---#----##---#----##---#----##---#----##---#----##---#--
--#-######--#-######--#-######--#-######--#-######--#-######--#-######--#-######--#-######--#-######
--#-#-------#-#-------#-#-------#-#-------#-#-------#-#-------#-#-------#-#-------#-#-------#-#-----
---##-#------##-#------##-#------##-#------##-#------##-#------##-#------##-#------##-#------##-#---
#-#---#---#-#---#---#-#---#---#-#---#---#-#---#---#-#---#---#-#---#---#-#---#---#-#---#---#-#---#---
--#---------#---------#---------#---------#---------#---------#---------#---------#---------#-------
---#-#--#----#-#--#----#-#--#----#-#--#----#-#--#----#-#--#----#-#--#----#-#--#----#-#--#----#-#--#-
--#--#------#--#--S---#--#------#--#------#--#------#--#------#--#------#--#------#--#------#--#----
#----#----#----#----#----#----#----#----#----#----#----#----#----#----#----#----#----#----#----#----
---##--------##--------##--------##--------##--------##--------##--------##--------##--------##-----
--##---#----##---#----##---#----##---#----##---#----##---#----##---#----##---#----##---#----##---#--
--#-######--#-######--#-######--#-######--#-######--#-######--#-######--#-######--#-######--#-######
--#-#-------#-#-------#-#-------#-#-------#-#-------#-#-------#-#-------#-#-------#-#-------#-#-----
---##-#------##-#------##-#------##-#------##-#------##-#------##-#------##-#------##-#------##-#---
#-#---#---#-#---#---#-#---#---#-#---#---#-#---#---#-#---#---#-#---#---#-#---#---#-#---#---#-#---#--E
--#---------#---------#---------#---------#---------#---------#---------#---------#---------#-------
---#-#--#----#-#--#----#-#--#----#-#--#----#-#--#----#-#--#----#-#--#----#-#--#----#-#--#----#-#--#-
--#--#------#--#------#--#------#--#------#--#------#--#------#--#------#--#------#--#------#--#----
#----#----#----#----#----#----#----#----#----#----#----#----#----#----#----#----#----#----#----#----
---##--------##--------##--------##--------##--------##--------##--------##--------##--------##-----
--##---#----##---#----##---#----##---#----##---#----##---#----##---#----##---#----##---#----##---#--
--#-######--#-######--#-######--#-######--#-######--#-######--#-######--#-######--#-######--#-######
--#-#-------#-#-------#-#-------#-#-------#-#-------#-#-------#-#-------#-#-------#-#-------#-#-----
---##-#------##-#------##-#------##-#------##-#------##-#------##-#------##-#------##-#------##-#---
#-#---#---#-#---#---#-#---#---#-#---#---#-#---#---#-#---#---#-#---#---#-#---#---#-#---#---#-#---#---
--#---------#---------#---------#---------#---------#---------#---------#---------#---------#-------
---#-#--#----#-#--#----#-#--#----#-#--#----#-#--#----#-#--#----#-#--#----#-#--#----#-#--#----#-#--#-
