-##--#-----##--#-----##--#-----##--#-----##--#-----##--#-----##--#-----##--#-----##--#-----##--#----
------#-#-------#-#-------#-#-------#-#-------#-#-------#-#-------#-#-------#-#-------#-#-------#-#-
----#---##----#---##----#---##----#---##----#---##----#---##----#---##----#---##----#---##----#---##
---###-#-----###-#-----###-#-----###-#-----###-#-----###-#-----###-#-----###-#-----###-#-----###-#--
#----##---#----##---#----##---#----##---#----##---#----##---#----##---#----##---#----##---#----##---
------#---------#---------#---------#E--------#---------#---------#---------#---------#---------#---
----#---#-----#---#-----#---#-----#---#-----#---#-----#---#-----#---#-----#---#-----#---#-----#---#-
#--#---#--#--#---#--#--#---#--#--#---#--#--#---#--#--#---#--#--#---#--#--#---#--#--#---#--#--#---#--
----------------------------------------------------------------------------------------------------
#----#--###----#--###----#--###----#--###----#--###----#--###----#--###----#--###----#--###----#--##
-##--#-----##--#-----##--#-----##--#-----##--#-----##--#-----##--#-----##--#-----##--#-----##--#----
------#-#-------#-#-------#-#-------#-#-------#-#-------#-#-------#-#-------#-#-------#-#-------#-#-
----#---##----#---##----#---##----#---##----#---##----#---##----#---##----#---##----#---##----#---##
---###-#-----###-#-----###-#-----###-#-----###-#-----###-#-----###-#-----###-#-----###-#-----###-#--
#----##---#----##---#----##---#----##---#----##---#----##---#----##---#----##---#----##---#----##---
------#---------#---------#---------#---------#---------#---------#---------#---------#---------#---
----#---#-----#---#-----#---#-----#---#-----#---#-----#---#-----#---#-----#---#-----#---#-----#---#-
#--#---#--#--#---#--#--#---#--#--#---#--#--#---#--#--#---#--#--#---#--#--#---#--#--#---#--#--#---#--
----------------------------------------------------------------------------------------------------
#----#--###----#--###----#--###----#--###----#--###----#--###----#--###----#--###----#--###----#--##
-##--#-----##--#-----##--#-----##--#-----##--#-----##--#-----##--#-----##--#-----##--#-----##--#----
------#-#-------#-#-------#-#-------#-#-------#-#-------#-#-------#-#-------#-#-------#-#-------#-#-
----#---##----#---##----#---##----#---##----#---##----#---##----#---##----#---##----#---##----#---##
---###-#-----###-#-----###-#-----###-#-----###-#-----###-#-----###-#-----###-#-----###-#-----###-#--
#----##---#----##---#----##---#----##---#----##---#----##---#----##---#----##---#----##---#----##---
------#---------#---------#---------#---------#---------#---------#---------#---------#---------#---
----#---#-----#---#-----#---#-----#---#-----#---#-----#---#-----#---#-----#---#-----#---#-----#---#-
#--#---#--#--#---#--#--#---#--#--#---#--#--#---#--#--#---#--#--#---#--#--#---#--#--#---#--#--#---#--
----------------------------------------------------------------------------------------------------
#----#--###----#--###----#--###----#--###----#--###----#--###----#--###----#--###----#--###----#--##
-##--#-----##--#-----##--#-----##--#-----##--#-----##--#-----##--#-----##--#-----##--#-----##--#----
------#-#-------#-#-------#-#-------#-#-------#-#-------#-#-------#-#-------#-#-------#-#-------#-#-
----#---##----#---##----#---##----#---##----#---##----#---##----#---##----#---##----#---##----#---##
---###-#-----###-#-----###-#-----###-#-----###-#-----###-#-----###-#-----###-#-----###-#-----###-#--
#----##---#----##---#----##---#----##---#----##---#----##---#----##---#----##---#----##---#----##---
------#---------#---------#---------#---------#---------#---------#---------#---------#---------#---
----#---#-----#---#-----#---#-----#---#-----#---#-----#---#-----#---#-----#---#-----#---#-----#---#-
#--#---#--#--#---#--#--#---#--#--#---#--#--#---#--#--#---#--#--#---#--#--#---#--#--#---#--#--#---#--
--------------------------S-------------------------------------------------------------------------
#----#--###----#--###----#--###----#--###----#--###----#--###----#--###----#--###----#--###----#--##
-##--#-----##--#-----##--#-----##--#-----##--#-----##--#-----##--#-----##--#-----##--#-----##--#----
------#-#-------#-#-------#-#-------#-#-------#-#-------#-#-------#-#-------#-#-------#-#-------#-#-
----#---##----#---##----#---##----#---##----#---##----#---##----#---##----#---##----#---##----#---##
---###-#-----###-#-----###-#-----###-#-----###-#-----###-#-----###-#-----###-#-----###-#-----###-#--
#----##---#----##---#----##---#----##---#----##---#----##---#----##---#----##---#----##---#----##---
------#---------#---------#---------#---------#---------#---------#---------#---------#---------#---
----#---#-----#---#-----#---#-----#---#-----#---#-----#---#-----#---#-----#---#-----#---#-----#---#-
#--#---#--#--#---#--#--#---#--#--#---#--#--#---#--#--#---#--#--#---#--#--#---#--#--#---#--#--#---#--
----------------------------------------------------------------------------------------------------
#----#--###----#--###----#--###----#--###----#--###----#--###----#--###----#--###----#--###----#--##
-##--#-----##--#-----##--#-----##--#-----##--#-----##--#-----##--#-----##--#-----##--#-----##--#----
------#-#-------#-#-------#-#-------#-#-------#-#-------#-#-------#-#-------#-#-------#-#-------#-#-
----#---##----#---##----#---##----#---##----#---##----#---##----#---##----#---##----#---##----#---##
---###-#-----###-#-----###-#-----###-#-----###-#-----###-#-----###-#-----###-#-----###-#-----###-#--
#----##---#----##---#----##---#----##---#----##---#----##---#----##---#----##---#----##---#----##---
------#---------#---------#---------#---------#---------#---------#---------#---------#---------#---
----#---#-----#---#-----#---#-----#---#-----#---#-----#---#-----#---#-----#---#-----#---#-----#---#-
#--#---#--#--#---#--#--#---#--#--#---#--#--#---#--#--#---#--#--#---#--#--#---#--#--#---#--#--#---#--
----------------------------------------------------------------------------------------------------
#----#--###----#--###----#--###----#--###----#--###----#--###----#--###----#--###----#--###----#--##
-##--#-----##--#-----##--#-----##--#-----##--#-----##--#-----##--#-----##--#-----##--#-----##--#----
------#-#-------#-#-------#-#-------#-#-------#-#-------#-#-------#-#-------#-#-------#-#-------#-#-
----#---##----#---##----#---##----#---##----#---##----#---##----#---##----#---##----#---##----#---##
---###-#-----###-#-----###-#-----###-#-----###-#-----###-#-----###-#-----###-#-----###-#-----###-#--
#----##---#----##---#----##---#----##---#----##---#----##---#----##---#----##---#----##---#----##---
------#---------#---------#---------#---------#---------#---------#---------#---------#---------#---
----#---#-----#---#-----#---#-----#---#-----#---#-----#---#-----#---#-----#---#-----#---#-----#---#-
#--#---#--#--#---#--#--#---#--#--#---#--#--#---#--#--#---#--#--#---#--#--#---#--#--#---#--#--#---#--
----------------------------------------------------------------------------------------------------
#----#--###----#--###----#--###----#--###----#--###----#--###----#--###----#--###----#--###----#--##
-##--#-----##--#-----##--#-----##--#-----##--#-----##--#-----##--#-----##--#-----##--#-----##--#----
------#-#-------#-#-------#-#-------#-#-------#-#-------#-#-------#-#-------#-#-------#-#-------#-#-
----#---##----#---##----#---##----#---##----#---##----#---##----#---##----#---##----#---##----#---##
---###-#-----###-#-----###-#-----###-#-----###-#-----###-#-----###-#-----###-#-----###-#-----###-#--
#----##---#----##---#----##---#----##---#----##---#----##---#----##---#----##---#----##---#----##---
------#---------#---------#---------#---------#---------#---------#---------#---------#---------#---
----#---#-----#---#-----#---#-----#---#-----#---#-----#---#-----#---#-----#---#-----#---#-----#---#-
#--#---#--#--#---#--#--#---#--#--#---#--#--#---#--#--#---#--#--#---#--#--#---#--#--#---#--#--#---#--
----------------------------------------------------------------------------------------------------
#----#--###----#--###----#--###----#--###----#--###----#--###----#--###----#--###----#--###----#--##
-##--#-----##--#-----##--#-----##--#-----##--#-----##--#-----##--#-----##--#-----##--#-----##--#----
------#-#-------#-#-------#-#-------#-#-------#-#-------#-#-------#-#-------#-#-------#-#-------#-#-
----#---##----#---##----#---##----#---##----#---##----#---##----#---##----#---##----#---##----#---##
---###-#-----###-#-----###-#-----###-#-----###-#-----###-#-----###-#-----###-#-----###-#-----###-#--
#----##---#----##---#----##---#----##---#----##---#----##---#----##---#----##---#----##---#----##---
------#---------#---------#---------#---------#---------#---------#---------#---------#---------#---
----#---#-----#---#-----#---#-----#---#-----#---#-----#---#-----#---#-----#---#-----#---#-----#---#-
#--#---#--#--#---#--#--#---#--#--#---#--#--#---#--#--#---#--#--#---#--#--#---#--#--#---#--#--#---#--
----------------------------------------------------------------------------------------------------
#----#--###----#--###----#--###----#--###----#--###----#--###----#--###----#--###----#--###----#--##
-##--#-----##--#-----##--#-----##--#-----##--#-----##--#-----##--#-----##--#-----##--#-----##--#----
------#-#-------#-#-------#-#-------#-#-------#-#-------#-#-------#-#-------#-#-------#-#-------#-#-
----#---##----#---##----#---##----#---##----#---##----#---##----#---##----#---##----#---##----#---##
---###-#-----###-#-----###-#-----###-#-----###-#-----###-#-----###-#-----###-#-----###-#-----###-#--
#----##---#----##---#----##---#----##---#----##---#----##---#----##---#----##---#----##---#----##---
------#---------#---------#---------#---------#---------#---------#---------#---------#---------#---
----#---#-----#---#-----#---#-----#---#-----#---#-----#---#-----#---#-----#---#-----#---#-----#---#-
#--#---#--#--#---#--#--#---#--#--#---#--#--#---#--#--#---#--#--#---#--#--#---#--#--#---#--#--#---#--
----------------------------------------------------------------------------------------------------
#----#--###----#--###----#--###----#--###----#--###----#--###----#--###----#--###----#--###----#--##
